l_FullName,r_FullName,w_FullName,FightDate,l_win,r_win,l_seniority,r_seniority,l_w/l_ratio,r_w/l_ratio,l_height_dif_cm,r_height_dif_cm,l_weight_dif_lb,r_weight_dif_lb,l_reach_dif_cm,r_reach_dif_cm,l_ctrl_time_sec,r_ctrl_time_sec,l_total_fights,r_total_fights,l_total_fights_dif,r_total_fights_dif,l_win_difference,r_win_difference,l_WinStreak,r_WinStreak,l_TKOReceived,r_TKOReceived,l_WinStreak_dif,r_WinStreak_dif,l_TKOReceived_dif,r_TKOReceived_dif,l_rust_ring,r_rust_ring,l_rustRing_dif,r_rustRing_dif
Spike Carlyle,Aalon Cruz,Spike Carlyle,2020-02-29,1,0,-4,4,3,2,-10.16,10.16,0,0,-17.78,17.78,7,5,12,12,0,0,1,-1,0,0,0,0,0,0,0,0,0,0,0,0
Andrei Arlovski,Aaron Brink,Andrei Arlovski,2000-11-17,1,0,-5,5,1.545455,1,0,0,35,-35,2.580002,-2.580002,13,4,56,52,4,-4,0.545454502105713,-0.545454502105713,0,0,0,0,0,0,0,0,0,0,0,0
Matt Hobar,Aaron Phillips,Matt Hobar,2014-08-23,1,0,2,-2,3,2.4,2.540009,-2.540009,0,0,-2.539993,2.539993,775,0,12,17,-5,5,0.599999904632568,-0.599999904632568,0,0,1,0,0,0,1,-1,84,0,84,-84
Gaston Bolanos,Aaron Phillips,Gaston Bolanos,2023-04-15,1,0,-3,3,2.333333,2.4,-5.080002,5.080002,0,0,-5.080002,5.080002,96,361,10,17,-7,7,-6.6666841506958e-02,6.6666841506958e-02,0,0,0,0,0,0,0,0,0,3157,-3157,3157
Robbie Lawler,Aaron Riley,Robbie Lawler,2002-05-10,1,0,-1,1,1.875,2.142857,7.619995,-7.619995,15,-15,12.70001,-12.70001,269,86,46,44,2,-2,-0.267857074737549,0.267857074737549,0,0,0,0,0,0,0,0,0,0,0,0
Spencer Fisher,Aaron Riley,Spencer Fisher,2006-01-16,1,0,4,-4,2.666667,2.142857,-2.540009,2.540009,0,0,-2.539993,2.539993,0,89,33,44,-11,11,0.523809671401978,-0.523809671401978,0,0,0,0,0,0,0,0,0,1347,-1347,1347
Jorge Gurgel,Aaron Riley,Aaron Riley,2008-11-15,0,1,4,-4,1.4,2.142857,-2.540009,2.540009,0,0,0,0,12,147,24,44,-20,20,-0.742857098579407,0.742857098579407,0,0,0,1,0,0,-1,1,133,1034,-901,901
Shane Nelson,Aaron Riley,Shane Nelson,2009-03-07,1,0,-4,4,2.285714,2.142857,2.539993,-2.539993,0,0,2.540009,-2.540009,6,2,23,44,-21,21,0.142857313156128,-0.142857313156128,1,1,0,1,0,0,-1,1,84,112,-28,28
Shane Nelson,Aaron Riley,Aaron Riley,2009-08-08,0,1,-4,4,2.285714,2.142857,2.539993,-2.539993,0,0,2.540009,-2.540009,1,468,23,44,-21,21,0.142857313156128,-0.142857313156128,2,0,0,2,2,-2,-2,2,154,154,0,0
Ross Pearson,Aaron Riley,Ross Pearson,2009-11-14,1,0,-3,3,1.25,2.142857,0,0,0,0,0,0,53,19,36,44,-8,8,-0.892857074737549,0.892857074737549,1,1,0,2,0,0,-2,2,147,98,49,-49
Joe Brammer,Aaron Riley,Aaron Riley,2010-05-29,0,1,-3,3,2.333333,2.142857,0,0,0,0,-0.2599945,0.2599945,33,306,10,44,-34,34,0.190476179122925,-0.190476179122925,0,0,0,3,0,0,-3,3,0,196,-196,196
Tony Ferguson,Aaron Riley,Tony Ferguson,2011-09-24,1,0,-3,3,2.888889,2.142857,7.619995,-7.619995,0,0,17.78,-17.78,2,0,35,44,-9,9,0.746031761169434,-0.746031761169434,1,1,0,3,0,0,-3,3,112,483,-371,371
Joey Beltran,Aaron Rosa,Joey Beltran,2011-06-11,1,0,1,-1,1.214286,3,-7.619995,7.619995,-20,20,-5.080002,5.080002,320,8,31,24,7,-7,-1.78571426868439,1.78571426868439,0,0,0,0,0,0,0,0,259,0,259,-259
Matt Lucas,Aaron Rosa,Aaron Rosa,2011-11-12,0,1,,,5,3,-7.619995,7.619995,0,0,-9.580002,9.580002,412,52,18,24,-6,6,2,-2,0,0,0,1,0,0,-1,1,0,154,-154,154
Tim McKenzie,Aaron Simpson,Aaron Simpson,2009-04-01,0,1,-8,8,1.555556,2.4,0,0,15,-15,2.540009,-2.540009,0,66,23,17,6,-6,-0.844444513320923,0.844444513320923,0,0,0,0,0,0,0,0,0,0,0,0
Ed Herman,Aaron Simpson,Aaron Simpson,2009-08-29,0,1,-7,7,1.6875,2.4,2.539993,-2.539993,35,-35,10.16,-10.16,0,186,43,17,26,-26,-0.712500095367432,0.712500095367432,1,1,0,0,0,0,0,0,133,150,-17,17
Tom Lawlor,Aaron Simpson,Aaron Simpson,2010-01-11,0,1,-9,9,1.666667,2.4,0,0,35,-35,2.540009,-2.540009,157,268,16,17,-1,1,-0.733333468437195,0.733333468437195,0,2,0,0,-2,2,0,0,0,135,-135,135
Chris Leben,Aaron Simpson,Chris Leben,2010-06-19,1,0,-6,6,2,2.4,-2.540009,2.540009,15,-15,0,0,44,224,33,17,16,-16,-0.400000095367432,0.400000095367432,1,3,1,0,-2,2,1,-1,159,159,0,0
Mark Munoz,Aaron Simpson,Mark Munoz,2010-11-20,1,0,-4,4,2.333333,2.4,0,0,15,-15,-5.080002,5.080002,177,194,20,17,3,-3,-6.6666841506958e-02,6.6666841506958e-02,0,0,0,1,0,0,-1,1,111,154,-43,43
Mario Miranda,Aaron Simpson,Aaron Simpson,2011-03-26,0,1,-5,5,2,2.4,7.619995,-7.619995,15,-15,2.540009,-2.540009,69,761,21,17,4,-4,-0.400000095367432,0.400000095367432,0,0,0,1,0,0,-1,1,0,126,-126,126
Eric Schafer,Aaron Simpson,Aaron Simpson,2011-10-08,0,1,-3,3,1.75,2.4,7.619995,-7.619995,15,-15,7.619995,-7.619995,0,30,22,17,5,-5,-0.650000095367432,0.650000095367432,0,1,0,1,-1,1,-1,1,0,196,-196,196
Ronny Markes,Aaron Simpson,Ronny Markes,2012-02-15,1,0,-14,14,3.4,2.4,2.539993,-2.539993,15,-15,5.080002,-5.080002,319,148,22,17,5,-5,1,-1,1,2,0,1,-1,1,-1,1,185,130,55,-55
Kenny Robertson,Aaron Simpson,Aaron Simpson,2012-07-11,0,1,-9,9,3,2.4,-5.080002,5.080002,0,0,2.540009,-2.540009,82,625,20,17,3,-3,0.599999904632568,-0.599999904632568,0,0,0,1,0,0,-1,1,0,147,-147,147
Mike Pierce,Aaron Simpson,Mike Pierce,2012-10-05,1,0,-6,6,2.428571,2.4,-10.16,10.16,0,0,-5.080002,5.080002,69,47,24,17,7,-7,2.85713672637939e-02,-2.85713672637939e-02,1,1,0,1,0,0,-1,1,608,86,522,-522
Cody McKenzie,Aaron Wilkinson,Cody McKenzie,2010-12-04,1,0,-1,1,1.6,1.571429,5.080002,-5.080002,0,0,2.880005,-2.880005,52,64,26,18,8,-8,2.85714864730835e-02,-2.85714864730835e-02,0,0,0,0,0,0,0,0,0,0,0,0
Omari Akhmedov,Abdul Razak Alhassan,Omari Akhmedov,2017-05-28,1,0,-2,2,3.5,2.4,5.080002,-5.080002,0,0,0,0,340,1,27,17,10,-10,1.09999990463257,-1.09999990463257,1,0,2,0,1,-1,2,-2,183,0,183,-183
Sabah Homasi,Abdul Razak Alhassan,Abdul Razak Alhassan,2017-12-02,0,1,-3,3,1.375,2.4,5.080002,-5.080002,-15,15,-2.539993,2.539993,11,137,19,17,2,-2,-1.02500009536743,1.02500009536743,0,0,1,0,0,0,1,-1,469,188,281,-281
Sabah Homasi,Abdul Razak Alhassan,Abdul Razak Alhassan,2018-01-20,0,1,-3,3,1.375,2.4,5.080002,-5.080002,-15,15,-2.539993,2.539993,64,2,19,17,2,-2,-1.02500009536743,1.02500009536743,0,1,2,0,-1,1,2,-2,49,49,0,0
Niko Price,Abdul Razak Alhassan,Abdul Razak Alhassan,2018-09-08,0,1,-5,5,2.142857,2.4,5.080002,-5.080002,-15,15,7.619995,-7.619995,0,2,22,17,5,-5,-0.257143020629883,0.257143020629883,2,2,0,0,0,0,0,0,224,231,-7,7
Mounir Lazzez,Abdul Razak Alhassan,Mounir Lazzez,2020-07-15,1,0,-2,2,3.666667,2.4,7.619995,-7.619995,-15,15,7.619995,-7.619995,292,91,14,17,-3,3,1.26666665077209,-1.26666665077209,0,3,0,0,-3,3,0,0,0,676,-676,676
Jacob Malkoun,Abdul Razak Alhassan,Jacob Malkoun,2021-04-17,1,0,-10,10,2.333333,2.4,-2.540009,2.540009,0,0,0,0,701,2,10,17,-7,7,-6.6666841506958e-02,6.6666841506958e-02,0,0,0,0,0,0,0,0,0,276,-276,276
Alessio Di Chirico,Abdul Razak Alhassan,Abdul Razak Alhassan,2021-08-28,0,1,-5,5,1.857143,2.4,5.080002,-5.080002,0,0,2.540009,-2.540009,0,0,20,17,3,-3,-0.54285728931427,0.54285728931427,0,0,0,0,0,0,0,0,700,133,567,-567
Joaquin Buckley,Abdul Razak Alhassan,Joaquin Buckley,2022-02-19,1,0,-9,9,2.666667,2.4,0,0,-15,15,7.619995,-7.619995,125,214,22,17,5,-5,0.266666650772095,-0.266666650772095,0,1,2,0,-1,1,2,-2,399,175,224,-224
Marcus LeVesseur,Abel Trujillo,Abel Trujillo,2012-12-08,0,1,1,-1,3.142857,1.875,2.539993,-2.539993,0,0,0,0,248,183,29,23,6,-6,1.26785707473755,-1.26785707473755,1,0,0,0,1,-1,0,0,64,0,64,-64
Khabib Nurmagomedov,Abel Trujillo,Khabib Nurmagomedov,2013-05-25,1,0,-5,5,29,1.875,5.080002,-5.080002,0,0,0,0,629,97,29,23,6,-6,27.125,-27.125,3,1,0,0,2,-2,0,0,126,168,-42,42
Roger Bowling,Abel Trujillo,Abel Trujillo,2013-12-14,0,1,1,-1,2,1.875,2.539993,-2.539993,0,0,-5.080002,5.080002,42,132,18,23,-5,5,0.125,-0.125,0,0,1,0,0,0,1,-1,238,203,35,-35
Tony Ferguson,Abel Trujillo,Tony Ferguson,2014-12-06,1,0,-1,1,2.888889,1.875,7.619995,-7.619995,0,0,15.23999,-15.23999,122,122,35,23,12,-12,1.01388883590698,-1.01388883590698,2,1,0,0,1,-1,0,0,196,357,-161,161
Gleison Tibau,Abel Trujillo,Abel Trujillo,2015-11-07,0,1,0,0,2.357143,1.875,5.080002,-5.080002,0,0,2.539993,-2.539993,87,2,47,23,24,-24,0.482142925262451,-0.482142925262451,3,0,0,0,3,-3,0,0,798,336,462,-462
Tony Sims,Abel Trujillo,Abel Trujillo,2016-01-02,0,1,-2,2,3,1.875,7.619995,-7.619995,0,0,0,0,12,17,16,23,-7,7,1.125,-1.125,0,1,0,0,-1,1,0,0,0,56,-56,56
Jordan Rinaldi,Abel Trujillo,Abel Trujillo,2016-05-29,0,1,-4,4,2,1.875,5.080002,-5.080002,-10,10,5.080002,-5.080002,232,244,21,23,-2,2,0.125,-0.125,0,2,0,0,-2,2,0,0,0,148,-148,148
John Makdessi,Abel Trujillo,John Makdessi,2017-12-16,1,0,-2,2,2,1.875,0,0,0,0,-5.080002,5.080002,0,97,27,23,4,-4,0.125,-0.125,0,3,1,0,-3,3,1,-1,371,566,-195,195
Chris Gruetzemacher,Abner Lloveras,Chris Gruetzemacher,2015-12-11,1,0,-4,4,3,2.222222,-7.619995,7.619995,0,0,-10.28,10.28,30,171,20,29,-9,9,0.777777671813965,-0.777777671813965,0,0,0,0,0,0,0,0,0,0,0,0
Jared Gooden,Abubakar Nurmagomedov,Abubakar Nurmagomedov,2021-03-27,0,1,-4,4,2.444444,4.25,2.540009,-2.540009,0,0,12.7,-12.7,0,258,31,21,10,-10,-1.80555558204651,1.80555558204651,0,0,0,0,0,0,0,0,126,0,126,-126
Chris de la Rocha,Adam Milstead,Adam Milstead,2016-05-29,0,1,9,-9,1.666667,2,0,0,45,-45,10.16,-10.16,178,20,8,12,-4,4,-0.333333373069763,0.333333373069763,0,0,1,0,0,0,1,-1,316,0,316,-316
Jordan Johnson,Adam Milstead,Jordan Johnson,2018-03-03,1,0,-1,1,10,2,-2.539993,2.539993,0,0,7.62001,-7.62001,433,0,10,12,-2,2,8,-8,0,1,0,0,-1,1,0,0,0,643,-643,643
Anthony Hamilton,Adam Wieczorek,Adam Wieczorek,2017-11-18,0,1,12,-12,1.666667,5,0,0,10,-10,-12.70001,12.70001,419,131,24,12,12,-12,-3.33333337306976,3.33333337306976,0,0,1,0,0,0,1,-1,63,0,63,-63
Arjan Bhullar,Adam Wieczorek,Adam Wieczorek,2018-04-14,0,1,5,-5,9,5,-10.16,10.16,-5,5,-15.24001,15.24001,318,0,10,12,-2,2,4,-4,1,1,0,0,0,0,0,0,217,147,70,-70
Marcos Rogerio de Lima,Adam Wieczorek,Marcos Rogerio de Lima,2018-11-03,1,0,7,-7,2.1,5,-10.16,10.16,3,-3,-15.24001,15.24001,501,135,31,12,19,-19,-2.90000009536743,2.90000009536743,0,2,0,0,-2,2,0,0,560,203,357,-357
Jordan Johnson,Adam Yandiev,Jordan Johnson,2018-09-15,1,0,-1,1,10,9,12.70001,-12.70001,20,-20,12.7,-12.7,215,0,10,10,0,0,1,-1,1,0,0,0,1,-1,0,0,196,0,196,-196
Shonie Carter,Adrian Serrano,Shonie Carter,2000-06-09,1,0,-8,8,1.645161,1.931034,5.080002,-5.080002,0,0,3,-3,120,187,82,85,-3,3,-0.285873174667358,0.285873174667358,1,0,0,0,1,-1,0,0,91,0,91,-91
Victor Rodriguez,Adrian Yanez,Adrian Yanez,2020-10-31,0,1,2,-2,1.75,4,-5.079987,5.079987,-10,10,-7.62001,7.62001,54,5,11,20,-9,9,-2.25,2.25,0,0,0,0,0,0,0,0,0,0,0,0
Gustavo Lopez,Adrian Yanez,Adrian Yanez,2021-03-20,0,1,4,-4,2,4,-5.079987,5.079987,0,0,-7.62001,7.62001,0,3,18,20,-2,2,-2,2,0,1,0,0,-1,1,0,0,0,140,-140,140
Randy Costa,Adrian Yanez,Adrian Yanez,2021-07-24,0,1,0,0,1.5,4,5.080002,-5.080002,0,0,7.619995,-7.619995,0,4,10,20,-10,10,-2.5,2.5,2,2,0,0,0,0,0,0,308,126,182,-182
Davey Grant,Adrian Yanez,Adrian Yanez,2021-11-20,0,1,8,-8,2.142857,4,2.540009,-2.540009,0,0,-2.540009,2.540009,10,0,22,20,2,-2,-1.85714292526245,1.85714292526245,0,3,0,0,-3,3,0,0,154,119,35,-35
Tony Kelley,Adrian Yanez,Adrian Yanez,2022-06-18,0,1,7,-7,2.666667,4,5.080002,-5.080002,0,0,0,0,2,4,11,20,-9,9,-1.33333325386047,1.33333325386047,0,4,0,0,-4,4,0,0,0,210,-210,210
Rob Font,Adrian Yanez,Rob Font,2023-04-08,1,0,6,-6,2.857143,4,2.540009,-2.540009,0,0,2.539993,-2.539993,4,0,27,20,7,-7,-1.14285707473755,1.14285707473755,0,5,0,0,-5,5,0,0,343,294,49,-49
Daron Cruickshank,Adriano Martins,Adriano Martins,2013-11-09,0,1,-2,2,1.8,3.111111,-5.080002,5.080002,0,0,0,0,0,244,28,37,-9,9,-1.31111121177673,1.31111121177673,1,0,0,0,1,-1,0,0,105,0,105,-105
Donald Cerrone,Adriano Martins,Donald Cerrone,2014-01-25,1,0,-1,1,2.117647,3.111111,7.619995,-7.619995,0,0,2.539993,-2.539993,6,0,53,37,16,-16,-0.99346399307251,0.99346399307251,1,1,1,0,0,0,1,-1,70,77,-7,7
Juan Manuel Puig,Adriano Martins,Adriano Martins,2014-07-06,0,1,-6,6,2.75,3.111111,-2.540009,2.540009,-10,10,-4.880005,4.880005,0,3,15,37,-22,22,-0.361111164093018,0.361111164093018,0,0,0,1,0,0,-1,1,0,162,-162,162
Rustam Khabilov,Adriano Martins,Adriano Martins,2015-02-22,0,1,-4,4,6,3.111111,-5.080002,5.080002,0,0,2.539993,-2.539993,7,118,28,37,-9,9,2.88888883590698,-2.88888883590698,3,1,0,1,2,-2,-1,1,473,231,242,-242
Islam Makhachev,Adriano Martins,Adriano Martins,2015-10-03,0,1,-9,9,24,3.111111,0,0,0,0,-5.080002,5.080002,2,0,25,37,-12,12,20.888888835907,-20.888888835907,0,2,0,1,-2,2,-1,1,0,223,-223,223
Kajan Johnson,Adriano Martins,Kajan Johnson,2017-09-09,1,0,-1,1,1.769231,3.111111,2.539993,-2.539993,0,0,7.619995,-7.619995,1,10,36,37,-1,1,-1.34188044071198,1.34188044071198,2,3,0,1,-1,1,-1,1,714,707,7,-7
Tulio Palhares,Adriano Santos,Tulio Palhares,1998-10-16,1,0,,,0.125,0,,,,,-10,10,0,0,18,1,17,-17,0.125,-0.125,0,0,0,0,0,0,0,0,0,0,0,0
Reginaldo Vieira,Aiemann Zahabi,Aiemann Zahabi,2017-02-19,0,1,5,-5,2.6,5,-2.540009,2.540009,0,0,-7.619995,7.619995,143,12,18,12,6,-6,-2.40000009536743,2.40000009536743,0,0,0,0,0,0,0,0,0,0,0,0
Ricardo Ramos,Aiemann Zahabi,Ricardo Ramos,2017-11-04,1,0,-7,7,3.2,5,2.539993,-2.539993,10,-10,10.16,-10.16,37,100,21,12,9,-9,-1.79999995231628,1.79999995231628,1,1,0,0,0,0,0,0,273,258,15,-15
Vince Morales,Aiemann Zahabi,Vince Morales,2019-05-04,1,0,-3,3,1.571429,5,2.539993,-2.539993,0,0,5.080002,-5.080002,0,38,18,12,6,-6,-3.42857146263123,3.42857146263123,0,0,0,1,0,0,-1,1,161,546,-385,385
Drako Rodriguez,Aiemann Zahabi,Aiemann Zahabi,2021-02-20,0,1,-9,9,2.333333,5,0,0,0,0,2.539993,-2.539993,0,10,10,12,-2,2,-2.66666674613953,2.66666674613953,0,0,0,1,0,0,-1,1,0,658,-658,658
Ricky Turcios,Aiemann Zahabi,Aiemann Zahabi,2022-07-09,0,1,-5,5,4.333333,5,2.539993,-2.539993,0,0,7.619995,-7.619995,0,0,16,12,4,-4,-0.666666507720947,0.666666507720947,0,1,0,1,-1,1,-1,1,0,504,-504,504
Stephanie Egger,Ailin Perez,Stephanie Egger,2022-09-03,1,0,7,-7,2,4,2.539993,-2.539993,-10,10,5.080002,-5.080002,419,93,12,10,2,-2,-2,2,1,0,0,0,1,-1,0,0,336,0,336,-336
Ashlee Evans-Smith,Ailin Perez,Ailin Perez,2023-07-15,0,1,8,-8,1,4,7.619995,-7.619995,0,0,2.539993,-2.539993,8,696,12,10,2,-2,-3,3,0,0,0,0,0,0,0,0,1609,315,1294,-1294
Alex Chambers,Aisling Daly,Aisling Daly,2014-12-12,0,1,10,-10,1,2.666667,2.540009,-2.540009,0,0,-2.539993,2.539993,74,185,10,22,-12,12,-1.66666674613953,1.66666674613953,0,0,0,0,0,0,0,0,0,0,0,0
Ericka Almeida,Aisling Daly,Aisling Daly,2015-10-24,0,1,-1,1,2.333333,2.666667,10.16,-10.16,0,0,8.440002,-8.440002,180,668,10,22,-12,12,-0.333333492279053,0.333333492279053,0,1,0,0,-1,1,0,0,147,316,-169,169
Bryan Battle,AJ Fletcher,Bryan Battle,2023-09-23,1,0,3,-3,5.5,3.333333,7.619995,-7.619995,0,0,25.40001,-25.40001,210,33,13,13,0,0,2.16666674613953,-2.16666674613953,1,0,0,0,1,-1,0,0,133,0,133,-133
Jon Fitch,Akihiro Gono,Jon Fitch,2009-01-31,1,0,-4,4,4.285714,1.666667,12.70001,-12.70001,0,0,15.24001,-15.24001,608,121,37,56,-19,19,2.61904752254486,-2.61904752254486,0,0,0,0,0,0,0,0,175,0,175,-175
Maximo Blanco,Akira Corassani,Akira Corassani,2013-11-30,0,1,-1,1,1.5,2,0,0,0,0,7.619995,-7.619995,14,0,20,18,2,-2,-0.5,0.5,1,0,0,0,1,-1,0,0,231,0,231,-231
Michael Chiesa,Al Iaquinta,Michael Chiesa,2012-06-01,1,0,-1,1,2.571429,2,7.619995,-7.619995,15,-15,12.7,-12.7,65,0,25,21,4,-4,0.571428537368774,-0.571428537368774,0,0,0,0,0,0,0,0,0,0,0,0
Ryan Couture,Al Iaquinta,Al Iaquinta,2013-08-31,0,1,5,-5,2.2,2,0,0,0,0,7.619995,-7.619995,68,53,16,21,-5,5,0.200000047683716,-0.200000047683716,0,0,1,0,0,0,1,-1,147,456,-309,309
Piotr Hallmann,Al Iaquinta,Al Iaquinta,2013-10-26,0,1,0,0,3,2,-2.540009,2.540009,0,0,2.539993,-2.539993,24,174,24,21,3,-3,1,-1,1,1,0,0,0,0,0,0,52,56,-4,4
Mitch Clarke,Al Iaquinta,Mitch Clarke,2014-05-24,1,0,1,-1,2.2,2,0,0,0,0,7.619995,-7.619995,10,271,16,21,-5,5,0.200000047683716,-0.200000047683716,1,2,0,0,-1,1,0,0,343,210,133,-133
Rodrigo Damm,Al Iaquinta,Al Iaquinta,2014-09-05,0,1,7,-7,1.444444,2,-7.62001,7.62001,0,0,2.539993,-2.539993,10,6,22,21,1,-1,-0.555555582046509,0.555555582046509,0,0,0,0,0,0,0,0,97,104,-7,7
Donald Cerrone,Al Iaquinta,Donald Cerrone,2019-05-04,1,0,4,-4,2.117647,2,7.619995,-7.619995,0,0,7.619995,-7.619995,22,0,53,21,32,-32,0.117647171020508,-0.117647171020508,2,1,4,0,1,-1,4,-4,105,1702,-1597,1597
Dan Hooker,Al Iaquinta,Dan Hooker,2019-10-05,1,0,-3,3,1.916667,2,5.080002,-5.080002,0,0,12.7,-12.7,149,24,35,21,14,-14,-8.33333730697632e-02,8.33333730697632e-02,3,0,0,0,3,-3,0,0,77,154,-77,77
Bobby Green,Al Iaquinta,Bobby Green,2021-11-06,1,0,1,-1,2.142857,2,0,0,0,0,2.539993,-2.539993,15,0,44,21,23,-23,0.142857074737549,-0.142857074737549,0,0,1,0,0,0,1,-1,371,763,-392,392
Tom Aspinall,Alan Baudot,Tom Aspinall,2020-10-10,1,0,-5,5,4.333333,2.666667,5.080002,-5.080002,13,-13,-2.540009,2.540009,30,0,16,11,5,-5,1.66666674613953,-1.66666674613953,1,0,0,0,1,-1,0,0,77,0,77,-77
Yoshihiro Akiyama,Alan Belcher,Yoshihiro Akiyama,2009-07-11,1,0,8,-8,2.333333,2.25,-10.16,10.16,-15,15,0,0,191,44,20,26,-6,6,8.33332538604736e-02,-8.33332538604736e-02,0,0,0,0,0,0,0,0,0,0,0,0
Seth Baczynski,Alan Jouban,Alan Jouban,2014-08-16,0,1,0,0,1.428571,2.428571,7.619995,-7.619995,0,0,5.080002,-5.080002,43,17,34,24,10,-10,-1,1,1,0,1,0,1,-1,1,-1,283,0,283,-283
Warlley Alves,Alan Jouban,Warlley Alves,2014-11-08,1,0,-9,9,2.5,2.428571,-2.540009,2.540009,0,0,-2.539993,2.539993,240,35,21,24,-3,3,7.14285373687744e-02,-7.14285373687744e-02,0,1,0,0,-1,1,0,0,0,84,-84,84
Matt Dwyer,Alan Jouban,Alan Jouban,2015-07-15,0,1,-8,8,2.25,2.428571,10.15999,-10.15999,0,0,7.619995,-7.619995,14,173,13,24,-11,11,-0.178571462631226,0.178571462631226,1,0,1,0,1,-1,1,-1,143,249,-106,106
Dwight Grant,Alan Jouban,Dwight Grant,2019-04-13,1,0,-3,3,1.833333,2.428571,2.539993,-2.539993,15,-15,7.619995,-7.619995,0,29,17,24,-7,7,-0.595238089561462,0.595238089561462,1,1,0,0,0,0,0,0,49,1368,-1319,1319
Jared Gooden,Alan Jouban,Alan Jouban,2020-11-21,0,1,-12,12,2.444444,2.428571,0,0,0,0,10.16,-10.16,66,10,31,24,7,-7,1.58729553222656e-02,-1.58729553222656e-02,0,0,0,0,0,0,0,0,0,588,-588,588
Jim Alers,Alan Omer,Jim Alers,2014-04-11,1,0,2,-2,4.333333,4,-2.540009,2.540009,0,0,20.34,-20.34,386,181,16,25,-9,9,0.333333492279053,-0.333333492279053,0,0,0,0,0,0,0,0,0,0,0,0
Arnold Allen,Alan Omer,Arnold Allen,2015-06-20,1,0,-5,5,9.5,4,-5.080002,5.080002,0,0,17.8,-17.8,133,207,21,25,-4,4,5.5,-5.5,0,0,0,0,0,0,0,0,0,435,-435,435
John Makdessi,Alan Patrick,Alan Patrick,2014-02-01,0,1,-2,2,2,3.75,-7.619995,7.619995,0,0,-15.24001,15.24001,1,100,27,19,8,-8,-1.75,1.75,1,0,0,0,1,-1,0,0,441,0,441,-441
Damien Brown,Alan Patrick,Alan Patrick,2016-03-19,0,1,-1,1,1.416667,3.75,-2.539993,2.539993,0,0,-15.24001,15.24001,36,741,29,19,10,-10,-2.33333337306976,2.33333337306976,0,1,0,0,-1,1,0,0,0,777,-777,777
Damir Hadzovic,Alan Patrick,Alan Patrick,2018-02-03,0,1,-3,3,2,3.75,-5.080002,5.080002,0,0,-10.16,10.16,48,746,21,19,2,-2,-1.75,1.75,1,2,1,0,-1,1,1,-1,251,686,-435,435
Scott Holtzman,Alan Patrick,Scott Holtzman,2018-10-06,1,0,0,0,2.333333,3.75,-5.080002,5.080002,0,0,-12.70001,12.70001,336,13,20,19,1,-1,-1.41666674613953,1.41666674613953,3,3,0,0,0,0,0,0,301,245,56,-56
Bobby Green,Alan Patrick,Bobby Green,2020-09-12,1,0,-3,3,2.142857,3.75,-2.539993,2.539993,0,0,-7.62001,7.62001,451,103,44,19,25,-25,-1.60714292526245,1.60714292526245,2,0,1,1,2,-2,0,0,42,707,-665,665
Michael Johnson,Alan Patrick,Michael Johnson,2022-05-14,1,0,-3,3,1.157895,3.75,-2.539993,2.539993,0,0,-2.540009,2.540009,121,12,41,19,22,-22,-2.59210526943207,2.59210526943207,0,0,0,1,0,0,-1,1,731,609,122,-122
Joaquin Buckley,Albert Duraev,Joaquin Buckley,2022-06-18,1,0,-5,5,2.666667,3.2,-2.539993,2.539993,-15,15,2.539993,-2.539993,22,108,22,21,1,-1,-0.533333301544189,0.533333301544189,1,0,2,0,1,-1,2,-2,119,0,119,-119
Thomas Almeida,Albert Morales,Thomas Almeida,2016-11-19,1,0,0,0,4.4,1.75,-5.080002,5.080002,10,-10,-5.080002,5.080002,6,36,27,11,16,-16,2.65000009536743,-2.65000009536743,0,0,1,0,0,0,1,-1,174,0,174,-174
Brett Johns,Albert Morales,Brett Johns,2017-07-16,1,0,-1,1,8.5,1.75,-5.080002,5.080002,0,0,-2.540009,2.540009,693,0,19,11,8,-8,6.75,-6.75,0,0,0,1,0,0,-1,1,0,239,-239,239
Benito Lopez,Albert Morales,Benito Lopez,2017-12-09,1,0,-3,3,5,1.75,2.540009,-2.540009,0,0,2.539993,-2.539993,53,182,12,11,1,-1,3.25,-3.25,0,0,0,1,0,0,-1,1,0,146,-146,146
Manny Bermudez,Albert Morales,Manny Bermudez,2018-02-24,1,0,-3,3,7,1.75,2.540009,-2.540009,10,-10,-2.540009,2.540009,116,220,16,11,5,-5,5.25,-5.25,0,0,0,1,0,0,-1,1,0,77,-77,77
Ildemar Alcantara,Albert Tumenov,Ildemar Alcantara,2014-02-15,1,0,9,-9,1.909091,4.5,7.62001,-7.62001,15,-15,12.7,-12.7,321,135,32,22,10,-10,-2.59090912342072,2.59090912342072,0,0,0,0,0,0,0,0,129,0,129,-129
Anthony Lapsley,Albert Tumenov,Albert Tumenov,2014-05-10,0,1,12,-12,3.285714,4.5,-5.080002,5.080002,0,0,-7.419998,7.419998,2,1,30,22,8,-8,-1.21428561210632,1.21428561210632,0,0,0,0,0,0,0,0,0,84,-84,84
Matt Dwyer,Albert Tumenov,Albert Tumenov,2014-10-04,0,1,2,-2,2.25,4.5,12.7,-12.7,0,0,7.619995,-7.619995,5,2,13,22,-9,9,-2.25,2.25,0,1,0,0,-1,1,0,0,0,147,-147,147
Nicholas Musoke,Albert Tumenov,Albert Tumenov,2015-01-24,0,1,5,-5,2.6,4.5,2.540009,-2.540009,0,0,5.080002,-5.080002,76,7,18,22,-4,4,-1.90000009536743,1.90000009536743,2,2,0,0,0,0,0,0,112,112,0,0
Alan Jouban,Albert Tumenov,Albert Tumenov,2015-10-03,0,1,10,-10,2.428571,4.5,2.540009,-2.540009,0,0,0,0,0,2,24,22,2,-2,-2.07142853736877,2.07142853736877,1,3,0,0,-2,2,0,0,217,252,-35,35
Lorenz Larkin,Albert Tumenov,Albert Tumenov,2016-01-02,0,1,5,-5,3,4.5,0,0,0,0,-2.539993,2.539993,14,17,24,22,2,-2,-1.5,1.5,1,4,1,0,-3,3,1,-1,189,91,98,-98
Gunnar Nelson,Albert Tumenov,Gunnar Nelson,2016-05-08,1,0,3,-3,3.8,4.5,0,0,0,0,-2.539993,2.539993,257,0,24,22,2,-2,-0.700000047683716,0.700000047683716,1,5,0,0,-4,4,0,0,302,127,175,-175
Leon Edwards,Albert Tumenov,Leon Edwards,2016-10-08,1,0,1,-1,7,4.5,7.62001,-7.62001,0,0,2.540009,-2.540009,272,0,24,22,2,-2,2.5,-2.5,1,0,0,0,1,-1,0,0,153,153,0,0
Shinsho Anzai,Alberto Mina,Alberto Mina,2014-08-23,0,1,-4,4,3.333333,13,-12.70001,12.70001,0,0,-17.78,17.78,49,36,13,14,-1,1,-9.66666674613953,9.66666674613953,0,0,0,0,0,0,0,0,0,0,0,0
Yoshihiro Akiyama,Alberto Mina,Alberto Mina,2015-11-28,0,1,7,-7,2.333333,13,-5.080002,5.080002,0,0,-5.080002,5.080002,83,37,20,14,6,-6,-10.6666667461395,10.6666667461395,1,1,1,0,0,0,1,-1,434,462,-28,28
Ramazan Emeev,Alberto Mina,Ramazan Emeev,2018-05-12,1,0,-6,6,3.333333,13,-5.080002,5.080002,0,0,-2.540009,2.540009,306,5,26,14,12,-12,-9.66666674613953,9.66666674613953,0,2,0,0,-2,2,0,0,0,896,-896,896
Jake Collier,Alberto Uda,Jake Collier,2016-05-29,1,0,-4,4,1.3,6,0,0,45,-45,5.119995,-5.119995,156,83,23,14,9,-9,-4.70000004768372,4.70000004768372,0,0,2,0,0,0,2,-2,183,0,183,-183
Scott Jorgensen,Alejandro Perez,Alejandro Perez,2015-11-21,0,1,7,-7,1.25,2.555556,-2.539993,2.539993,0,0,-2.539993,2.539993,48,15,27,32,-5,5,-1.30555558204651,1.30555558204651,0,0,1,0,0,0,1,-1,392,0,392,-392
Ian Entwistle,Alejandro Perez,Alejandro Perez,2016-04-10,0,1,3,-3,3,2.555556,-2.539993,2.539993,0,0,-2.179993,2.179993,13,106,12,32,-20,20,0.444444417953491,-0.444444417953491,0,1,1,0,-1,1,1,-1,652,141,511,-511
Iuri Alcantara,Alejandro Perez,Alejandro Perez,2017-12-09,0,1,9,-9,3.5,2.555556,7.619995,-7.619995,0,0,10.16,-10.16,9,55,45,32,13,-13,0.944444417953491,-0.944444417953491,0,2,0,0,-2,2,0,0,189,608,-419,419
Matthew Lopez,Alejandro Perez,Alejandro Perez,2018-04-14,0,1,3,-3,2.5,2.555556,2.539993,-2.539993,0,0,5.080002,-5.080002,186,28,14,32,-18,18,-5.55555820465088e-02,5.55555820465088e-02,0,3,0,0,-3,3,0,0,640,126,514,-514
Johnny Eduardo,Alejandro Perez,Alejandro Perez,2021-10-02,0,1,11,-11,2.153846,2.555556,2.539993,-2.539993,0,0,10.16,-10.16,74,74,41,32,9,-9,-0.401709318161011,0.401709318161011,0,4,1,0,-4,4,1,-1,1219,1267,-48,48
Jonathan Martinez,Alejandro Perez,Jonathan Martinez,2022-02-26,1,0,-5,5,4.5,2.555556,5.080002,-5.080002,0,0,7.62001,-7.62001,0,2,22,32,-10,10,1.94444441795349,-1.94444441795349,1,5,0,0,-4,4,0,0,574,147,427,-427
Tanner Boser,Aleksa Camur,Tanner Boser,2023-08-05,1,0,5,-5,2.1,2,2.540009,-2.540009,0,0,2.539993,-2.539993,327,61,31,9,22,-22,9.99999046325684e-02,-9.99999046325684e-02,0,0,1,0,0,0,1,-1,112,0,112,-112
Francimar Barroso,Aleksandar Rakic,Aleksandar Rakic,2017-09-02,0,1,12,-12,2.714286,4.666667,-7.619995,7.619995,0,0,-7.619995,7.619995,96,13,26,17,9,-9,-1.95238089561462,1.95238089561462,1,0,0,0,1,-1,0,0,168,0,168,-168
Justin Ledet,Aleksandar Rakic,Aleksandar Rakic,2018-07-22,0,1,3,-3,2.25,4.666667,0,0,0,0,5.080002,-5.080002,0,740,13,17,-4,4,-2.41666650772095,2.41666650772095,1,1,0,0,0,0,0,0,715,323,392,-392
Devin Clark,Aleksandar Rakic,Aleksandar Rakic,2018-12-08,0,1,2,-2,1.75,4.666667,-10.15999,10.15999,0,0,-7.619995,7.619995,50,66,22,17,5,-5,-2.91666650772095,2.91666650772095,3,2,1,0,1,-1,1,-1,245,139,106,-106
Jimi Manuwa,Aleksandar Rakic,Aleksandar Rakic,2019-06-01,0,1,12,-12,2.833333,4.666667,-7.619995,7.619995,0,0,2.540009,-2.540009,0,1,23,17,6,-6,-1.83333325386047,1.83333325386047,0,3,2,0,-3,3,2,-2,175,175,0,0
Volkan Oezdemir,Aleksandar Rakic,Volkan Oezdemir,2019-12-21,1,0,3,-3,2.714286,4.666667,-5.079987,5.079987,0,0,-7.619995,7.619995,32,158,26,17,9,-9,-1.95238089561462,1.95238089561462,0,4,0,0,-4,4,0,0,280,203,77,-77
Jan Blachowicz,Aleksandar Rakic,Jan Blachowicz,2022-05-14,1,0,9,-9,2.9,4.666667,-5.079987,5.079987,0,0,0,0,1,273,39,17,22,-22,-1.76666641235352,1.76666641235352,0,0,1,0,0,0,1,-1,196,875,-679,679
Thiago Alves,Aleksei Kunchenko,Aleksei Kunchenko,2018-09-15,0,1,0,0,1.533333,10,2.539993,-2.539993,0,0,0,0,48,0,38,22,16,-16,-8.46666669845581,8.46666669845581,0,0,3,0,0,0,3,-3,209,0,209,-209
Gilbert Burns,Aleksei Kunchenko,Gilbert Burns,2019-08-10,1,0,-2,2,3.666667,10,5.080002,-5.080002,0,0,2.539993,-2.539993,418,28,28,22,6,-6,-6.33333325386047,6.33333325386047,1,1,1,0,0,0,1,-1,105,329,-224,224
Anthony Hamilton,Aleksei Oleinik,Aleksei Oleinik,2014-06-28,0,1,-3,3,1.666667,3.529412,7.619995,-7.619995,20,-20,-10.16,10.16,17,42,24,77,-53,53,-1.86274516582489,1.86274516582489,0,0,0,0,0,0,0,0,0,0,0,0
Travis Browne,Aleksei Oleinik,Aleksei Oleinik,2017-07-08,0,1,-6,6,2.571429,3.529412,10.15999,-10.15999,15,-15,-2.539993,2.539993,83,213,25,77,-52,52,-0.957983255386353,0.957983255386353,0,1,3,0,-1,1,3,-3,139,1106,-967,967
Curtis Blaydes,Aleksei Oleinik,Curtis Blaydes,2017-11-04,1,0,-14,14,4.25,3.529412,5.079987,-5.079987,25,-25,0,0,113,15,21,77,-56,56,0.720588207244873,-0.720588207244873,2,2,1,0,0,0,1,-1,119,119,0,0
Junior Albini,Aleksei Oleinik,Aleksei Oleinik,2018-05-12,0,1,-13,13,2.333333,3.529412,2.539993,-2.539993,24,-24,-15.23999,15.23999,12,15,20,77,-57,57,-1.19607853889465,1.19607853889465,0,0,0,1,0,0,-1,1,182,189,-7,7
Mark Hunt,Aleksei Oleinik,Aleksei Oleinik,2018-09-15,0,1,3,-3,0.9285714,3.529412,-10.16,10.16,25,-25,-20.31999,20.31999,0,42,27,77,-50,50,-2.60084038972855,2.60084038972855,1,1,3,1,0,0,2,-2,462,126,336,-336
Walt Harris,Aleksei Oleinik,Walt Harris,2019-07-20,1,0,-6,6,1.3,3.529412,7.619995,-7.619995,10,-10,-7.619995,7.619995,1,0,23,77,-54,54,-2.22941184043884,2.22941184043884,2,2,2,1,0,0,1,-1,77,308,-231,231
Maurice Greene,Aleksei Oleinik,Aleksei Oleinik,2020-01-18,0,1,-9,9,1.285714,3.529412,12.7,-12.7,18,-18,0,0,54,444,16,77,-61,61,-2.24369752407074,2.24369752407074,0,0,1,2,0,0,-1,1,84,182,-98,98
Derrick Lewis,Aleksei Oleinik,Derrick Lewis,2020-08-08,1,0,-8,8,2.454545,3.529412,2.539993,-2.539993,20,-20,-2.539993,2.539993,159,141,38,77,-39,39,-1.07486629486084,1.07486629486084,6,1,1,2,5,-5,-1,1,672,203,469,-469
Chris Daukaus,Aleksei Oleinik,Chris Daukaus,2021-02-20,1,0,-12,12,1.714286,3.529412,2.539993,-2.539993,-35,35,-10.16,10.16,19,24,19,77,-58,58,-1.81512606143951,1.81512606143951,2,0,0,3,2,-2,-3,3,133,196,-63,63
Ilir Latifi,Aleksei Oleinik,Ilir Latifi,2022-10-01,1,0,-5,5,1.888889,3.529412,-10.16,10.16,-10,10,-17.78,17.78,509,2,26,77,-51,51,-1.64052295684814,1.64052295684814,0,0,1,4,0,0,-3,3,966,588,378,-378
Amir Albazi,Alessandro Costa,Amir Albazi,2022-12-17,1,0,3,-3,17,4.333333,2.540009,-2.540009,0,0,2.540009,-2.540009,354,0,18,16,2,-2,12.6666665077209,-12.6666665077209,3,0,0,0,3,-3,0,0,119,0,119,-119
Oluwale Bamgbose,Alessio Di Chirico,Alessio Di Chirico,2017-12-16,0,1,2,-2,1.5,1.857143,-2.540009,2.540009,0,0,10.15999,-10.15999,0,2,10,20,-10,10,-0.357142806053162,0.357142806053162,0,0,2,0,0,0,2,-2,196,0,196,-196
Zak Cummings,Alessio Di Chirico,Zak Cummings,2020-08-29,1,0,6,-6,3.571429,1.857143,0,0,20,-20,2.539993,-2.539993,0,0,32,20,12,-12,1.71428573131561,-1.71428573131561,2,1,0,0,1,-1,0,0,469,987,-518,518
Joaquin Buckley,Alessio Di Chirico,Alessio Di Chirico,2021-01-16,0,1,-5,5,2.666667,1.857143,-5.080002,5.080002,-15,15,5.079987,-5.079987,0,1,22,20,2,-2,0.809523940086365,-0.809523940086365,2,0,1,0,2,-2,1,-1,56,140,-84,84
Dean Lister,Alessio Sakara,Dean Lister,2006-05-27,1,0,6,-6,1.857143,1.727273,2.539993,-2.539993,0,0,7.619995,-7.619995,0,110,20,30,-10,10,0.129870057106018,-0.129870057106018,0,0,0,0,0,0,0,0,0,0,0,0
Drew McFedries,Alessio Sakara,Drew McFedries,2006-11-18,1,0,3,-3,1.714286,1.727273,0,0,0,0,0,0,33,11,19,30,-11,11,-1.29870176315308e-02,1.29870176315308e-02,0,0,0,0,0,0,0,0,0,175,-175,175
Houston Alexander,Alessio Sakara,Houston Alexander,2007-09-08,1,0,9,-9,1.133333,1.727273,0,0,20,-20,0,0,14,9,32,30,2,-2,-0.593939423561096,0.593939423561096,1,0,0,1,1,-1,-1,1,105,294,-189,189
James Lee,Alessio Sakara,Alessio Sakara,2008-01-19,0,1,8,-8,5,1.727273,-2.540009,2.540009,20,-20,0.1199951,-0.1199951,42,8,18,30,-12,12,3.27272725105286,-3.27272725105286,0,0,0,2,0,0,-2,2,0,133,-133,133
Chris Leben,Alessio Sakara,Chris Leben,2008-03-01,1,0,1,-1,2,1.727273,-2.540009,2.540009,0,0,2.539993,-2.539993,26,0,33,30,3,-3,0.272727251052856,-0.272727251052856,1,1,1,2,0,0,-1,1,164,42,122,-122
Thales Leites,Alessio Sakara,Alessio Sakara,2009-08-08,0,1,0,0,3.111111,1.727273,2.539993,-2.539993,0,0,15.23999,-15.23999,161,33,37,30,7,-7,1.38383841514587,-1.38383841514587,0,0,0,3,0,0,-3,3,112,525,-413,413
James Irvin,Alessio Sakara,Alessio Sakara,2010-03-21,0,1,3,-3,1.7,1.727273,5.080002,-5.080002,20,-20,7.619995,-7.619995,0,1,27,30,-3,3,-2.72727012634277e-02,2.72727012634277e-02,0,1,3,3,-1,1,0,0,610,225,385,-385
Patrick Cote,Alessio Sakara,Patrick Cote,2012-11-17,1,0,1,-1,2.090909,1.727273,-2.540009,2.540009,-15,15,7.619995,-7.619995,0,13,34,30,4,-4,0.363636255264282,-0.363636255264282,0,2,1,3,-2,2,-2,2,133,972,-839,839
Nicholas Musoke,Alessio Sakara,Nicholas Musoke,2013-10-26,1,0,-5,5,2.6,1.727273,0,0,-15,15,7.619995,-7.619995,107,47,18,30,-12,12,0.872727155685425,-0.872727155685425,0,0,0,3,0,0,-3,3,0,343,-343,343
Martin Bravo,Alex Caceres,Alex Caceres,2018-07-06,0,1,-6,6,3.666667,1.5,-5.080002,5.080002,0,0,-5.080002,5.080002,221,43,14,35,-21,21,2.16666674613953,-2.16666674613953,1,0,0,0,1,-1,0,0,608,0,608,-608
Sam Fulton,Alex Hunter,Alex Hunter,1997-07-27,0,1,,,0,2,,,,,-5,5,0,0,2,2,0,0,-2,2,0,0,0,0,0,0,0,0,0,0,0,0
Kenny Florian,Alex Karalexis,Kenny Florian,2005-08-06,1,0,2,-2,2.333333,1.666667,5.080002,-5.080002,-10,10,20.32001,-20.32001,40,65,20,16,4,-4,0.666666626930237,-0.666666626930237,0,0,1,0,0,0,1,-1,119,0,119,-119
James Moontasri,Alex Morono,Alex Morono,2016-12-17,0,1,2,-2,1.8,2.875,-2.539993,2.539993,0,0,-2.540009,2.540009,19,54,14,31,-17,17,-1.07500004768372,1.07500004768372,0,0,0,0,0,0,0,0,147,0,147,-147
Joshua Burkman,Alex Morono,Alex Morono,2018-02-18,0,1,10,-10,1.75,2.875,-2.539993,2.539993,0,0,0,0,6,1,44,31,13,-13,-1.125,1.125,0,1,2,0,-1,1,2,-2,204,428,-224,224
Jordan Mein,Alex Morono,Jordan Mein,2018-07-28,1,0,1,-1,2.583333,2.875,2.540009,-2.540009,0,0,2.539993,-2.539993,543,106,43,31,12,-12,-0.291666746139526,0.291666746139526,1,2,0,0,-1,1,0,0,224,160,64,-64
Song Kenan,Alex Morono,Alex Morono,2018-11-24,0,1,0,0,2.857143,2.875,2.540009,-2.540009,0,0,-2.540009,2.540009,3,46,27,31,-4,4,-1.78570747375488e-02,1.78570747375488e-02,1,0,0,0,1,-1,0,0,364,119,245,-245
Max Griffin,Alex Morono,Alex Morono,2019-10-12,0,1,4,-4,1.9,2.875,0,0,0,0,10.15999,-10.15999,155,26,29,31,-2,2,-0.975000023841858,0.975000023841858,1,1,0,0,0,0,0,0,182,322,-140,140
Rhys McKee,Alex Morono,Alex Morono,2020-11-14,0,1,-5,5,2,2.875,7.62001,-7.62001,0,0,15.23999,-15.23999,12,154,15,31,-16,16,-0.875,0.875,0,2,0,0,-2,2,0,0,0,399,-399,399
Donald Cerrone,Alex Morono,Alex Morono,2021-05-08,0,1,8,-8,2.117647,2.875,5.080002,-5.080002,-15,15,2.539993,-2.539993,2,47,53,31,22,-22,-0.757352828979492,0.757352828979492,0,3,7,0,-3,3,7,-7,364,175,189,-189
Mickey Gall,Alex Morono,Alex Morono,2021-12-04,0,1,-2,2,1.4,2.875,7.62001,-7.62001,0,0,5.080002,-5.080002,8,83,12,31,-19,19,-1.47500002384186,1.47500002384186,1,4,1,0,-3,3,1,-1,133,210,-77,77
Tim Means,Alex Morono,Alex Morono,2023-05-13,0,1,7,-7,2.2,2.875,7.62001,-7.62001,0,0,7.619995,-7.619995,46,0,48,31,17,-17,-0.674999952316284,0.674999952316284,2,5,1,0,-3,3,1,-1,903,525,378,-378
Misha Cirkunov,Alex Nicholson,Misha Cirkunov,2016-02-06,1,0,3,-3,1.666667,1.75,-2.539993,2.539993,20,-20,0,0,128,0,24,11,13,-13,-8.33333730697632e-02,8.33333730697632e-02,1,0,0,0,1,-1,0,0,167,0,167,-167
Devin Clark,Alex Nicholson,Alex Nicholson,2016-07-13,0,1,0,0,1.75,1.75,-10.15999,10.15999,20,-20,-5.080002,5.080002,165,1,22,11,11,-11,0,0,0,0,0,0,0,0,0,0,0,158,-158,158
Sam Alvey,Alex Nicholson,Sam Alvey,2016-11-05,1,0,4,-4,1.833333,1.75,-5.079987,5.079987,0,0,-5.080002,5.080002,40,0,51,11,40,-40,8.33333730697632e-02,-8.33333730697632e-02,2,1,1,0,1,-1,1,-1,70,115,-45,45
Jack Hermansson,Alex Nicholson,Jack Hermansson,2017-05-28,1,0,1,-1,2.875,1.75,-7.619995,7.619995,0,0,0,0,98,0,31,11,20,-20,1.125,-1.125,0,0,0,0,0,0,0,0,0,204,-204,204
Gilbert Burns,Alex Oliveira,Gilbert Burns,2015-03-21,1,0,1,-1,3.666667,1.833333,-2.539993,2.539993,0,0,-12.7,12.7,241,201,28,34,-6,6,1.83333337306976,-1.83333337306976,2,0,0,0,2,-2,0,0,147,0,147,-147
KJ Noons,Alex Oliveira,Alex Oliveira,2015-05-30,0,1,5,-5,1.444444,1.833333,-2.539993,2.539993,-15,15,-15.23999,15.23999,0,80,22,34,-12,12,-0.388888955116272,0.388888955116272,2,0,0,0,2,-2,0,0,409,70,339,-339
Joe Merritt,Alex Oliveira,Alex Oliveira,2015-06-27,0,1,4,-4,3.5,1.833333,2.540009,-2.540009,0,0,-10.03999,10.03999,150,623,9,34,-25,25,1.66666662693024,-1.66666662693024,0,1,0,0,-1,1,0,0,0,28,-28,28
Piotr Hallmann,Alex Oliveira,Alex Oliveira,2015-11-07,0,1,1,-1,3,1.833333,-5.080002,5.080002,-15,15,-12.7,12.7,210,180,24,34,-10,10,1.16666662693024,-1.16666662693024,0,2,1,0,-2,2,1,-1,140,133,7,-7
Donald Cerrone,Alex Oliveira,Donald Cerrone,2016-02-21,1,0,4,-4,2.117647,1.833333,5.080002,-5.080002,-15,15,-7.619995,7.619995,33,51,53,34,19,-19,0.284313797950745,-0.284313797950745,0,3,2,0,-3,3,2,-2,64,106,-42,42
James Moontasri,Alex Oliveira,Alex Oliveira,2016-07-23,0,1,0,0,1.8,1.833333,-2.539993,2.539993,0,0,-12.7,12.7,79,680,14,34,-20,20,-3.3333420753479e-02,3.3333420753479e-02,2,0,0,0,2,-2,0,0,252,153,99,-99
Will Brooks,Alex Oliveira,Alex Oliveira,2016-10-01,0,1,1,-1,4.5,1.833333,-2.539993,2.539993,-15,15,-10.15999,10.15999,225,491,22,34,-12,12,2.66666662693024,-2.66666662693024,1,1,0,0,0,0,0,0,85,70,15,-15
Tim Means,Alex Oliveira,Alex Oliveira,2017-03-11,0,1,4,-4,2.2,1.833333,7.62001,-7.62001,0,0,-2.539993,2.539993,121,289,48,34,14,-14,0.366666674613953,-0.366666674613953,3,2,0,0,1,-1,0,0,693,161,532,-532
Ryan LaFlare,Alex Oliveira,Alex Oliveira,2017-07-22,0,1,4,-4,4.666667,1.833333,5.080002,-5.080002,0,0,-5.079987,5.079987,260,1,17,34,-17,17,2.83333313465118,-2.83333313465118,1,3,0,0,-2,2,0,0,589,133,456,-456
Yancy Medeiros,Alex Oliveira,Yancy Medeiros,2017-12-02,1,0,1,-1,1.875,1.833333,-2.539993,2.539993,-15,15,-2.539993,2.539993,67,185,23,34,-11,11,4.16666269302368e-02,-4.16666269302368e-02,2,4,1,0,-2,2,1,-1,182,133,49,-49
Carlos Condit,Alex Oliveira,Alex Oliveira,2018-04-14,0,1,3,-3,2.285714,1.833333,7.62001,-7.62001,0,0,-2.539993,2.539993,171,224,46,34,12,-12,0.452381014823914,-0.452381014823914,0,0,1,1,0,0,0,0,105,133,-28,28
Gunnar Nelson,Alex Oliveira,Gunnar Nelson,2018-12-08,1,0,0,0,3.8,1.833333,0,0,0,0,-10.15999,10.15999,282,186,24,34,-10,10,1.96666657924652,-1.96666657924652,0,1,1,1,-1,1,0,0,510,238,272,-272
Nicolas Dalby,Alex Oliveira,Nicolas Dalby,2019-09-28,1,0,3,-3,5.5,1.833333,0,0,0,0,-5.079987,5.079987,328,236,26,34,-8,8,3.66666662693024,-3.66666662693024,0,0,0,1,0,0,-1,1,1120,294,826,-826
Max Griffin,Alex Oliveira,Alex Oliveira,2020-03-07,0,1,2,-2,1.9,1.833333,0,0,0,0,0,0,333,210,29,34,-5,5,6.66666030883789e-02,-6.66666030883789e-02,0,0,0,1,0,0,-1,1,147,161,-14,14
Randy Brown,Alex Oliveira,Randy Brown,2021-04-24,1,0,-3,3,3.4,1.833333,10.16,-10.16,0,0,5.080002,-5.080002,83,0,22,34,-12,12,1.56666672229767,-1.56666672229767,0,1,2,1,-1,1,1,-1,266,413,-147,147
Kevin Holland,Alex Oliveira,Kevin Holland,2022-03-05,1,0,-5,5,2.5,1.833333,10.16,-10.16,0,0,12.70001,-12.70001,15,22,35,34,1,-1,0.666666626930237,-0.666666626930237,0,0,0,1,0,0,-1,1,329,315,14,-14
Andreas Michailidis,Alex Pereira,Alex Pereira,2021-11-06,0,1,-1,1,2.166667,4,-10.15999,10.15999,-35,35,-7.62001,7.62001,239,4,19,10,9,-9,-1.83333325386047,1.83333325386047,0,0,0,0,0,0,0,0,0,0,0,0
Israel Adesanya,Alex Pereira,Alex Pereira,2022-11-12,0,1,-2,2,8,4,0,0,-20,20,2.539993,-2.539993,394,31,27,10,17,-17,4,-4,3,1,0,0,2,-2,0,0,133,371,-238,238
Israel Adesanya,Alex Pereira,Israel Adesanya,2023-04-08,1,0,-2,2,8,4,0,0,-20,20,2.539993,-2.539993,3,0,27,10,17,-17,4,-4,0,2,1,0,-2,2,1,-1,147,147,0,0
Jan Blachowicz,Alex Pereira,Alex Pereira,2023-07-29,0,1,4,-4,2.9,4,-5.079987,5.079987,0,0,-2.540009,2.540009,452,6,39,10,29,-29,-1.09999990463257,1.09999990463257,1,0,1,1,1,-1,0,0,441,112,329,-329
Carls John De Tomas,Alex Perez,Alex Perez,2017-12-09,0,1,-4,4,3,3.428571,-2.539993,2.539993,0,0,15.23999,-15.23999,55,218,8,31,-23,23,-0.428571462631226,0.428571462631226,0,0,0,0,0,0,0,0,0,0,0,0
Joseph Benavidez,Alex Perez,Joseph Benavidez,2018-11-30,1,0,8,-8,3.5,3.428571,-5.080002,5.080002,0,0,0,0,75,3,36,31,5,-5,7.14285373687744e-02,-7.14285373687744e-02,0,1,1,0,-1,1,1,-1,174,356,-182,182
Mark De La Rosa,Alex Perez,Alex Perez,2019-03-30,0,1,-3,3,2.2,3.428571,0,0,10,-10,0,0,0,494,16,31,-15,15,-1.22857141494751,1.22857141494751,2,0,0,1,2,-2,-1,1,140,120,20,-20
Jordan Espinosa,Alex Perez,Alex Perez,2020-01-25,0,1,3,-3,1.666667,3.428571,0,0,0,0,10.15999,-10.15999,0,93,24,31,-7,7,-1.76190483570099,1.76190483570099,0,1,0,1,-1,1,-1,1,175,301,-126,126
Jussier Formiga,Alex Perez,Alex Perez,2020-06-06,0,1,7,-7,2.875,3.428571,-2.539993,2.539993,0,0,5.079987,-5.079987,0,4,31,31,0,0,-0.553571462631226,0.553571462631226,0,2,0,1,-2,2,-1,1,84,133,-49,49
Deiveson Figueiredo,Alex Perez,Deiveson Figueiredo,2020-11-21,1,0,4,-4,7,3.428571,-2.539993,2.539993,0,0,7.619995,-7.619995,0,37,24,31,-7,7,3.57142853736877,-3.57142853736877,1,3,0,1,-2,2,-1,1,483,168,315,-315
Alexandre Pantoja,Alex Perez,Alexandre Pantoja,2022-07-30,1,0,2,-2,5.2,3.428571,-2.539993,2.539993,0,0,5.079987,-5.079987,66,0,31,31,0,0,1.77142834663391,-1.77142834663391,6,0,0,1,6,-6,-1,1,343,616,-273,273
Mike Perry,Alex Reyes,Mike Perry,2017-09-16,1,0,-4,4,1.75,3.25,-2.539993,2.539993,15,-15,-5.080002,5.080002,2,18,22,17,5,-5,-1.5,1.5,1,0,0,0,1,-1,0,0,343,0,343,-343
Charlie Campbell,Alex Reyes,Charlie Campbell,2023-09-16,1,0,-8,8,4,3.25,2.540009,-2.540009,0,0,-2.539993,2.539993,2,1,10,17,-7,7,0.75,-0.75,0,0,0,1,0,0,-1,1,0,2191,-2191,2191
Jeremy Kennedy,Alex Ricci,Jeremy Kennedy,2016-08-27,1,0,-11,11,11,2,0,0,-10,10,-2.660004,2.660004,670,88,12,15,-3,3,9,-9,0,0,0,0,0,0,0,0,0,0,0,0
Paul Felder,Alex Ricci,Paul Felder,2017-02-19,1,0,-2,2,2.833333,2,0,0,0,0,-5.199997,5.199997,3,0,23,15,8,-8,0.833333253860474,-0.833333253860474,0,0,1,0,0,0,1,-1,148,176,-28,28
Michael McDonald,Alex Soto,Michael McDonald,2011-11-19,1,0,-7,7,4.25,2.666667,2.539993,-2.539993,0,0,2.800003,-2.800003,7,0,21,11,10,-10,1.58333325386047,-1.58333325386047,0,0,0,0,0,0,0,0,0,0,0,0
Francisco Rivera,Alex Soto,Francisco Rivera,2012-05-15,1,0,2,-2,1.571429,2.666667,0,0,0,0,2.800003,-2.800003,1,55,18,11,7,-7,-1.09523820877075,1.09523820877075,0,0,0,1,0,0,-1,1,0,178,-178,178
Mark Hughes,Alex Stiebling,Mark Hughes,2000-11-17,1,0,,,3,1.727273,-12.70001,12.70001,0,0,-11,11,564,0,8,30,-22,22,1.27272725105286,-1.27272725105286,0,0,0,0,0,0,0,0,0,0,0,0
Masio Fullen,Alex Torres,Masio Fullen,2015-02-28,1,0,2,-2,1.571429,1.25,0,0,0,0,-2.199997,2.199997,98,195,18,9,9,-9,0.321428537368774,-0.321428537368774,0,0,0,0,0,0,0,0,0,0,0,0
Estevan Payan,Alex White,Alex White,2014-04-19,0,1,7,-7,1.333333,2.166667,-5.080002,5.080002,-10,10,-2.339996,2.339996,0,3,28,19,9,-9,-0.833333373069763,0.833333373069763,0,0,1,0,0,0,1,-1,112,0,112,-112
Lucas Martins,Alex White,Lucas Martins,2014-07-16,1,0,0,0,6.333333,2.166667,0,0,-10,10,2.540009,-2.540009,16,0,22,19,3,-3,4.16666674613953,-4.16666674613953,0,1,0,0,-1,1,0,0,0,88,-88,88
Clay Collard,Alex White,Clay Collard,2014-12-06,1,0,-5,5,2,2.166667,-2.540009,2.540009,-10,10,5.080002,-5.080002,152,80,21,19,2,-2,-0.166666746139526,0.166666746139526,0,0,1,1,0,0,0,0,105,143,-38,38
Artem Lobov,Alex White,Alex White,2016-02-06,0,1,2,-2,0.8666667,2.166667,-7.62001,7.62001,-10,10,-15.23999,15.23999,201,68,28,19,9,-9,-1.30000007152557,1.30000007152557,0,0,0,1,0,0,-1,1,0,427,-427,427
Anthony Rocco Martin,Alex White,Anthony Rocco Martin,2017-01-15,1,0,-1,1,2.833333,2.166667,0,0,15,-15,5.080002,-5.080002,744,40,23,19,4,-4,0.666666507720947,-0.666666507720947,0,1,0,1,-1,1,-1,1,666,344,322,-322
Mitch Clarke,Alex White,Alex White,2017-09-09,0,1,3,-3,2.2,2.166667,-5.080002,5.080002,0,0,5.080002,-5.080002,26,15,16,19,-3,3,3.33333015441895e-02,-3.33333015441895e-02,0,0,0,1,0,0,-1,1,429,237,192,-192
James Krause,Alex White,James Krause,2018-01-14,1,0,2,-2,3.111111,2.166667,5.080002,-5.080002,15,-15,5.080002,-5.080002,609,53,37,19,18,-18,0.944444417953491,-0.944444417953491,0,1,0,1,-1,1,-1,1,1051,127,924,-924
Jim Miller,Alex White,Jim Miller,2018-09-08,1,0,6,-6,2.117647,2.166667,-10.16,10.16,0,0,0,0,19,0,53,19,34,-34,-4.90195751190186e-02,4.90195751190186e-02,0,0,0,1,0,0,-1,1,315,237,78,-78
Dan Moret,Alex White,Alex White,2019-03-09,0,1,2,-2,2.166667,2.166667,0,0,0,0,5.080002,-5.080002,455,207,19,19,0,0,0,0,0,0,0,1,0,0,-1,1,0,182,-182,182
Rafael Fiziev,Alex White,Rafael Fiziev,2019-10-26,1,0,-5,5,4,2.166667,-10.16,10.16,0,0,0,0,94,61,15,19,-4,4,1.83333325386047,-1.83333325386047,0,1,1,1,-1,1,0,0,189,231,-42,42
Heather Clark,Alexa Grasso,Alexa Grasso,2016-11-05,0,1,13,-13,1.166667,5.333333,2.539993,-2.539993,-10,10,-5.080002,5.080002,138,201,13,19,-6,6,-4.16666686534882,4.16666686534882,0,0,0,0,0,0,0,0,181,0,181,-181
Carla Esparza,Alexa Grasso,Carla Esparza,2019-09-21,1,0,5,-5,2.857143,5.333333,-10.16,10.16,-10,10,-7.619995,7.619995,431,18,27,19,8,-8,-2.4761905670166,2.4761905670166,1,1,2,0,0,0,2,-2,147,1050,-903,903
Maycee Barber,Alexa Grasso,Alexa Grasso,2021-02-13,0,1,-5,5,6.5,5.333333,0,0,0,0,-2.539993,2.539993,194,310,15,19,-4,4,1.16666650772095,-1.16666650772095,0,0,0,0,0,0,0,0,392,511,-119,119
Viviane Araujo,Alexa Grasso,Alexa Grasso,2022-10-15,0,1,6,-6,2.2,5.333333,-2.540009,2.540009,0,0,5.080002,-5.080002,209,0,16,19,-3,3,-3.13333344459534,3.13333344459534,1,1,0,0,0,0,0,0,154,609,-455,455
Phil Davis,Alexander Gustafsson,Phil Davis,2010-04-10,1,0,2,-2,4.25,2.25,-7.619995,7.619995,0,0,0,0,221,25,21,26,-5,5,2,-2,1,0,0,0,1,-1,0,0,63,0,63,-63
Cyrille Diabate,Alexander Gustafsson,Alexander Gustafsson,2010-10-16,0,1,14,-14,1.9,2.25,2.539993,-2.539993,0,0,5.080002,-5.080002,10,305,29,26,3,-3,-0.350000023841858,0.350000023841858,0,0,0,0,0,0,0,0,0,189,-189,189
Daniel Cormier,Alexander Gustafsson,Daniel Cormier,2015-10-03,1,0,8,-8,7.333333,2.25,-15.24001,15.24001,30,-30,-17.78,17.78,210,58,25,26,-1,1,5.08333349227905,-5.08333349227905,1,1,0,0,0,0,0,0,133,1813,-1680,1680
Jan Blachowicz,Alexander Gustafsson,Alexander Gustafsson,2016-09-03,0,1,4,-4,2.9,2.25,-7.619995,7.619995,0,0,-2.540009,2.540009,0,643,39,26,13,-13,0.650000095367432,-0.650000095367432,1,0,0,0,1,-1,0,0,146,336,-190,190
Beneil Dariush,Alexander Hernandez,Alexander Hernandez,2018-03-03,0,1,3,-3,4.4,2.333333,2.540009,-2.540009,10,-10,0,0,0,1,27,20,7,-7,2.06666684150696,-2.06666684150696,6,0,1,0,6,-6,1,-1,483,0,483,-483
Olivier Aubin-Mercier,Alexander Hernandez,Alexander Hernandez,2018-07-28,0,1,4,-4,2.2,2.333333,0,0,10,-10,-5.080002,5.080002,235,431,16,20,-4,4,-0.133333206176758,0.133333206176758,4,1,0,0,3,-3,0,0,112,147,-35,35
Donald Cerrone,Alexander Hernandez,Donald Cerrone,2019-01-19,1,0,9,-9,2.117647,2.333333,10.16,-10.16,10,-10,2.539993,-2.539993,29,22,53,20,33,-33,-0.215686082839966,0.215686082839966,1,2,4,0,-1,1,4,-4,70,175,-105,105
Drew Dober,Alexander Hernandez,Drew Dober,2020-05-13,1,0,4,-4,2.166667,2.333333,-2.539993,2.539993,10,-10,-5.080002,5.080002,11,67,38,20,18,-18,-0.166666507720947,0.166666507720947,5,0,0,1,5,-5,-1,1,116,480,-364,364
Chris Gruetzemacher,Alexander Hernandez,Alexander Hernandez,2020-10-31,0,1,6,-6,3,2.333333,-2.539993,2.539993,10,-10,-10.16,10.16,0,0,20,20,0,0,0.666666746139526,-0.666666746139526,1,0,0,2,1,-1,-2,2,938,171,767,-767
Mike Breeden,Alexander Hernandez,Alexander Hernandez,2021-10-02,0,1,3,-3,1.666667,2.333333,2.540009,-2.540009,10,-10,-5.080002,5.080002,0,0,16,20,-4,4,-0.666666626930237,0.666666626930237,0,1,0,2,-1,1,-2,2,0,336,-336,336
Nasrat Haqparast,Alexander Munoz,Nasrat Haqparast,2020-08-08,1,0,-6,6,3,3.5,2.540009,-2.540009,0,0,0,0,2,54,20,9,11,-11,-0.5,0.5,1,0,0,0,1,-1,0,0,371,0,371,-371
Carl Deaton,Alexander Munoz,Alexander Munoz,2023-07-15,0,1,0,0,2.428571,3.5,-5.080002,5.080002,0,0,-7.62001,7.62001,0,234,24,9,15,-15,-1.07142853736877,1.07142853736877,0,0,0,0,0,0,0,0,140,1071,-931,931
Yusuke Kasuya,Alexander Volkanovski,Alexander Volkanovski,2016-11-26,0,1,-1,1,3,13,2.539993,-2.539993,10,-10,-7.339996,7.339996,99,261,12,28,-16,16,-10,10,0,0,0,0,0,0,0,0,0,0,0,0
Mizuto Hirota,Alexander Volkanovski,Alexander Volkanovski,2017-06-10,0,1,8,-8,1.8,13,2.539993,-2.539993,10,-10,-10.16,10.16,23,318,28,28,0,0,-11.2000000476837,11.2000000476837,1,1,0,0,0,0,0,0,175,196,-21,21
Jeremy Kennedy,Alexander Volkanovski,Alexander Volkanovski,2018-02-10,0,1,-4,4,11,13,12.7,-12.7,0,0,0,0,28,475,12,28,-16,16,-2,2,1,2,0,0,-1,1,0,0,532,245,287,-287
Darren Elkins,Alexander Volkanovski,Alexander Volkanovski,2018-07-14,0,1,5,-5,2.454545,13,10.16,-10.16,0,0,0,0,59,207,38,28,10,-10,-10.5454545021057,10.5454545021057,5,3,1,0,2,-2,1,-1,181,154,27,-27
Chad Mendes,Alexander Volkanovski,Alexander Volkanovski,2018-12-29,0,1,3,-3,3.6,13,0,0,0,0,-12.7,12.7,45,8,23,28,-5,5,-9.40000009536743,9.40000009536743,3,4,0,0,-1,1,0,0,2206,168,2038,-2038
Jose Aldo,Alexander Volkanovski,Alexander Volkanovski,2019-05-11,0,1,2,-2,3.875,13,2.539993,-2.539993,-10,10,-2.539993,2.539993,7,265,39,28,11,-11,-9.125,9.125,2,5,3,0,-3,3,3,-3,98,133,-35,35
Max Holloway,Alexander Volkanovski,Alexander Volkanovski,2019-12-14,0,1,-3,3,3.571429,13,12.7,-12.7,0,0,-5.080002,5.080002,2,45,32,28,4,-4,-9.42857146263123,9.42857146263123,0,6,0,0,-6,6,0,0,245,217,28,-28
Max Holloway,Alexander Volkanovski,Alexander Volkanovski,2020-07-11,0,1,-3,3,3.571429,13,12.7,-12.7,0,0,-5.080002,5.080002,0,86,32,28,4,-4,-9.42857146263123,9.42857146263123,0,7,0,0,-7,7,0,0,210,210,0,0
Brian Ortega,Alexander Volkanovski,Alexander Volkanovski,2021-09-25,0,1,-2,2,5,13,5.080002,-5.080002,0,0,-5.080002,5.080002,54,231,18,28,-10,10,-8,8,3,8,0,0,-5,5,0,0,343,441,-98,98
Chan Sung Jung,Alexander Volkanovski,Alexander Volkanovski,2022-04-09,0,1,2,-2,2.125,13,2.539993,-2.539993,0,0,2.540009,-2.540009,0,172,25,28,-3,3,-10.875,10.875,0,9,0,0,-9,9,0,0,0,196,-196,196
Max Holloway,Alexander Volkanovski,Alexander Volkanovski,2022-07-02,0,1,-3,3,3.571429,13,12.7,-12.7,0,0,-5.080002,5.080002,16,117,32,28,4,-4,-9.42857146263123,9.42857146263123,2,10,0,0,-8,8,0,0,231,84,147,-147
Islam Makhachev,Alexander Volkanovski,Islam Makhachev,2023-02-11,1,0,-3,3,24,13,10.16,-10.16,10,-10,-2.539993,2.539993,457,175,25,28,-3,3,11,-11,6,11,1,0,-5,5,1,-1,112,224,-112,112
Yair Rodriguez,Alexander Volkanovski,Alexander Volkanovski,2023-07-08,0,1,-4,4,4,13,12.7,-12.7,0,0,0,0,0,433,20,28,-8,8,-9,9,3,0,0,0,3,-3,0,0,1359,147,1212,-1212
Timothy Johnson,Alexander Volkov,Alexander Volkov,2016-11-19,0,1,3,-3,3,3.7,-10.16,10.16,15,-15,-7.619995,7.619995,273,225,16,47,-31,31,-0.700000047683716,0.700000047683716,1,0,0,0,1,-1,0,0,223,0,223,-223
Roy Nelson,Alexander Volkov,Alexander Volkov,2017-04-15,0,1,12,-12,1.571429,3.7,-17.78,17.78,13,-13,-17.78,17.78,272,23,36,47,-11,11,-2.12857151031494,2.12857151031494,2,1,0,0,1,-1,0,0,203,147,56,-56
Stefan Struve,Alexander Volkov,Alexander Volkov,2017-09-02,0,1,1,-1,2.538461,3.7,10.16,-10.16,15,-15,10.16,-10.16,0,58,46,47,-1,1,-1.16153860092163,1.16153860092163,0,2,0,0,-2,2,0,0,0,140,-140,140
Derrick Lewis,Alexander Volkov,Derrick Lewis,2018-10-06,1,0,4,-4,2.454545,3.7,-10.16,10.16,10,-10,-2.539993,2.539993,43,106,38,47,-9,9,-1.24545454978943,1.24545454978943,5,3,1,0,2,-2,1,-1,91,399,-308,308
Greg Hardy,Alexander Volkov,Alexander Volkov,2019-11-09,0,1,0,0,1.4,3.7,-5.080002,5.080002,15,-15,0,0,0,0,12,47,-35,35,-2.30000007152557,2.30000007152557,1,0,0,1,1,-1,-1,1,196,399,-203,203
Curtis Blaydes,Alexander Volkov,Curtis Blaydes,2020-06-20,1,0,-2,2,4.25,3.7,-7.62001,7.62001,15,-15,0,0,1192,46,21,47,-26,26,0.549999952316284,-0.549999952316284,2,1,2,1,1,-1,1,-1,147,224,-77,77
Walt Harris,Alexander Volkov,Alexander Volkov,2020-10-24,0,1,5,-5,1.3,3.7,-5.080002,5.080002,0,0,-7.619995,7.619995,0,5,23,47,-24,24,-2.40000009536743,2.40000009536743,0,0,3,1,0,0,2,-2,161,126,35,-35
Alistair Overeem,Alexander Volkov,Alexander Volkov,2021-02-06,0,1,8,-8,2.473684,3.7,-7.62001,7.62001,15,-15,0,0,15,11,66,47,19,-19,-1.22631573677063,1.22631573677063,1,1,3,1,0,0,2,-2,154,105,49,-49
Ciryl Gane,Alexander Volkov,Ciryl Gane,2021-06-26,1,0,-1,1,6,3.7,-7.62001,7.62001,-5,5,2.540009,-2.540009,19,0,14,47,-33,33,2.29999995231628,-2.29999995231628,3,2,0,1,1,-1,-1,1,119,140,-21,21
Marcin Tybura,Alexander Volkov,Alexander Volkov,2021-10-30,0,1,2,-2,3,3.7,-10.16,10.16,-1,1,-5.080002,5.080002,121,120,32,47,-15,15,-0.700000047683716,0.700000047683716,0,0,0,1,0,0,-1,1,1442,126,1316,-1316
Tom Aspinall,Alexander Volkov,Tom Aspinall,2022-03-19,1,0,-5,5,4.333333,3.7,-5.080002,5.080002,6,-6,-5.080002,5.080002,114,0,16,47,-31,31,0.633333444595337,-0.633333444595337,3,1,0,1,2,-2,-1,1,196,140,56,-56
Jairzinho Rozenstruik,Alexander Volkov,Alexander Volkov,2022-06-04,0,1,1,-1,2.6,3.7,-12.7,12.7,-8,8,-5.080002,5.080002,0,0,18,47,-29,29,-1.10000014305115,1.10000014305115,1,0,0,1,1,-1,-1,1,364,77,287,-287
Alexandr Romanov,Alexander Volkov,Alexander Volkov,2023-03-11,0,1,-2,2,8.5,3.7,-12.7,12.7,12,-12,-12.7,12.7,38,63,19,47,-28,28,4.79999995231628,-4.79999995231628,0,1,0,1,-1,1,-1,1,203,280,-77,77
Tai Tuivasa,Alexander Volkov,Alexander Volkov,2023-09-09,0,1,-4,4,2.5,3.7,-12.7,12.7,14,-14,-12.7,12.7,0,155,21,47,-26,26,-1.20000004768372,1.20000004768372,0,2,0,1,-2,2,-1,1,0,182,-182,182
Demian Maia,Alexander Yakovlev,Demian Maia,2014-05-31,1,0,7,-7,2.545455,2.4,-5.080002,5.080002,15,-15,-5.080002,5.080002,488,88,39,34,5,-5,0.145454406738281,-0.145454406738281,0,0,1,0,0,0,1,-1,234,0,234,-234
Nicholas Musoke,Alexander Yakovlev,Nicholas Musoke,2014-10-04,1,0,-2,2,2.6,2.4,-7.619995,7.619995,15,-15,2.539993,-2.539993,407,6,18,34,-16,16,0.199999809265137,-0.199999809265137,1,0,0,0,1,-1,0,0,343,126,217,-217
Gray Maynard,Alexander Yakovlev,Alexander Yakovlev,2015-04-04,0,1,5,-5,1.857143,2.4,-15.24001,15.24001,0,0,-10.16,10.16,174,173,20,34,-14,14,-0.54285728931427,0.54285728931427,0,0,1,0,0,0,1,-1,231,182,49,-49
George Sullivan,Alexander Yakovlev,Alexander Yakovlev,2016-01-30,0,1,3,-3,2.428571,2.4,-7.619995,7.619995,15,-15,-2.540009,2.540009,102,0,24,34,-10,10,2.85713672637939e-02,-2.85713672637939e-02,1,1,0,0,0,0,0,0,202,301,-99,99
Kamaru Usman,Alexander Yakovlev,Kamaru Usman,2016-07-23,1,0,-3,3,6.666667,2.4,-7.619995,7.619995,15,-15,5.079987,-5.079987,782,0,23,34,-11,11,4.26666641235352,-4.26666641235352,0,2,0,0,-2,2,0,0,0,175,-175,175
Zak Cummings,Alexander Yakovlev,Zak Cummings,2016-11-19,1,0,0,0,3.571429,2.4,-7.619995,7.619995,50,-50,2.539993,-2.539993,70,2,32,34,-2,2,1.17142844200134,-1.17142844200134,0,0,0,0,0,0,0,0,105,119,-14,14
Alex Da Silva,Alexander Yakovlev,Alexander Yakovlev,2019-04-20,0,1,-11,11,5.25,2.4,-17.78,17.78,0,0,-2.540009,2.540009,269,133,25,34,-9,9,2.84999990463257,-2.84999990463257,0,0,0,0,0,0,0,0,0,882,-882,882
Roosevelt Roberts,Alexander Yakovlev,Roosevelt Roberts,2019-11-09,1,0,-10,10,3.333333,2.4,-2.539993,2.539993,0,0,-2.540009,2.540009,115,379,13,34,-21,21,0.933333158493042,-0.933333158493042,0,1,0,0,-1,1,0,0,0,203,-203,203
Joel Alvarez,Alexander Yakovlev,Joel Alvarez,2020-10-24,1,0,-9,9,6.666667,2.4,0,0,0,0,7.619995,-7.619995,0,117,23,34,-11,11,4.26666641235352,-4.26666641235352,2,0,0,0,2,-2,0,0,98,350,-252,252
Roque Martinez,Alexandr Romanov,Alexandr Romanov,2020-09-12,0,1,5,-5,1.875,8.5,-10.16,10.16,-12,12,-7.619995,7.619995,0,495,23,19,4,-4,-6.625,6.625,0,0,0,0,0,0,0,0,0,0,0,0
Marcos Rogerio de Lima,Alexandr Romanov,Alexandr Romanov,2020-11-07,0,1,6,-6,2.1,8.5,-2.540009,2.540009,-9,9,0,0,0,231,31,19,12,-12,-6.40000009536743,6.40000009536743,1,1,0,0,0,0,0,0,259,56,203,-203
Juan Espino,Alexandr Romanov,Alexandr Romanov,2021-04-17,0,1,10,-10,5.5,8.5,2.539993,-2.539993,-7,7,12.7,-12.7,175,341,13,19,-6,6,-3,3,2,2,0,0,0,0,0,0,203,161,42,-42
Blagoy Ivanov,Alexandr Romanov,Alexandr Romanov,2023-07-01,0,1,4,-4,3.166667,8.5,-7.62001,7.62001,-12,12,-5.080002,5.080002,0,173,25,19,6,-6,-5.33333325386047,5.33333325386047,0,3,0,0,-3,3,0,0,147,805,-658,658
Dustin Ortiz,Alexandre Pantoja,Dustin Ortiz,2018-01-20,1,0,2,-2,2.375,5.2,0,0,0,0,-5.079987,5.079987,290,438,27,31,-4,4,-2.82499980926514,2.82499980926514,1,0,0,0,1,-1,0,0,168,0,168,-168
Brandon Moreno,Alexandre Pantoja,Alexandre Pantoja,2018-05-19,0,1,-4,4,3,5.2,5.079987,-5.079987,0,0,7.62001,-7.62001,16,72,28,31,-3,3,-2.19999980926514,2.19999980926514,0,0,0,0,0,0,0,0,287,119,168,-168
Deiveson Figueiredo,Alexandre Pantoja,Deiveson Figueiredo,2019-07-27,1,0,2,-2,7,5.2,0,0,0,0,2.540009,-2.540009,112,74,24,31,-7,7,1.80000019073486,-1.80000019073486,0,1,0,0,-1,1,0,0,126,434,-308,308
Askar Askarov,Alexandre Pantoja,Askar Askarov,2020-07-18,1,0,-3,3,14,5.2,2.539993,-2.539993,0,0,0,0,311,137,15,31,-16,16,8.80000019073486,-8.80000019073486,1,0,0,0,1,-1,0,0,182,357,-175,175
Manel Kape,Alexandre Pantoja,Alexandre Pantoja,2021-02-06,0,1,-3,3,3.166667,5.2,0,0,0,0,2.540009,-2.540009,25,24,25,31,-6,6,-2.03333306312561,2.03333306312561,0,0,0,0,0,0,0,0,0,203,-203,203
Brandon Moreno,Alexandre Pantoja,Alexandre Pantoja,2023-07-08,0,1,-4,4,3,5.2,5.079987,-5.079987,0,0,7.62001,-7.62001,241,506,28,31,-3,3,-2.19999980926514,2.19999980926514,1,1,0,0,0,0,0,0,959,882,77,-77
Liz Carmouche,Alexis Davis,Alexis Davis,2013-11-06,0,1,0,0,1.857143,1.909091,0,0,-10,10,-5.080002,5.080002,18,188,20,32,-12,12,-5.1948070526123e-02,5.1948070526123e-02,0,0,0,0,0,0,0,0,256,0,256,-256
Cindy Dandois,Alexis Davis,Alexis Davis,2017-04-22,0,1,0,0,2.666667,1.909091,2.539993,-2.539993,0,0,0.2799988,-0.2799988,398,162,11,32,-21,21,0.757575869560242,-0.757575869560242,0,1,0,0,-1,1,0,0,0,1263,-1263,1263
Liz Carmouche,Alexis Davis,Alexis Davis,2017-12-09,0,1,0,0,1.857143,1.909091,0,0,-10,10,-5.080002,5.080002,393,350,20,32,-12,12,-5.1948070526123e-02,5.1948070526123e-02,2,2,0,0,0,0,0,0,392,231,161,-161
Katlyn Chookagian,Alexis Davis,Katlyn Chookagian,2018-07-28,1,0,-4,4,3.6,1.909091,7.619995,-7.619995,-10,10,0,0,0,19,23,32,-9,9,1.69090902805328,-1.69090902805328,2,3,0,0,-1,1,0,0,182,231,-49,49
Viviane Araujo,Alexis Davis,Viviane Araujo,2019-07-27,1,0,-2,2,2.2,1.909091,-5.080002,5.080002,-10,10,0,0,60,226,16,32,-16,16,0.290909171104431,-0.290909171104431,1,0,0,0,1,-1,0,0,77,364,-287,287
Brock Lesnar,Alistair Overeem,Alistair Overeem,2011-12-30,0,1,3,-3,1.666667,2.473684,-2.539993,2.539993,0,0,2.540009,-2.540009,0,16,8,66,-58,58,-0.807017683982849,0.807017683982849,0,0,1,0,0,0,1,-1,433,0,433,-433
Travis Browne,Alistair Overeem,Travis Browne,2013-08-17,1,0,-2,2,2.571429,2.473684,5.080002,-5.080002,-10,10,-2.539993,2.539993,2,135,25,66,-41,41,9.77442264556885e-02,-9.77442264556885e-02,1,1,1,0,0,0,1,-1,126,596,-470,470
Frank Mir,Alistair Overeem,Alistair Overeem,2014-02-01,0,1,1,-1,1.636364,2.473684,-2.539993,2.539993,-1,1,-2.539993,2.539993,29,518,29,66,-37,37,-0.837320685386658,0.837320685386658,3,0,1,1,3,-3,0,0,784,168,616,-616
Roy Nelson,Alistair Overeem,Alistair Overeem,2015-03-14,0,1,4,-4,1.571429,2.473684,-10.15999,10.15999,-2,2,-17.78,17.78,34,0,36,66,-30,30,-0.902255773544312,0.902255773544312,1,1,0,1,0,0,-1,1,337,406,-69,69
Junior Dos Santos,Alistair Overeem,Alistair Overeem,2015-12-19,0,1,-4,4,2.333333,2.473684,0,0,-27,27,-7.619995,7.619995,0,3,30,66,-36,36,-0.140351057052612,0.140351057052612,1,2,1,1,-1,1,0,0,371,280,91,-91
Andrei Arlovski,Alistair Overeem,Alistair Overeem,2016-05-08,0,1,2,-2,1.545455,2.473684,-2.539993,2.539993,-25,25,-7.619995,7.619995,47,79,56,66,-10,10,-0.928229808807373,0.928229808807373,0,3,4,1,-3,3,3,-3,127,141,-14,14
Stipe Miocic,Alistair Overeem,Stipe Miocic,2016-09-10,1,0,-2,2,5,2.473684,0,0,-25,25,0,0,21,6,24,66,-42,42,2.52631568908691,-2.52631568908691,2,4,1,1,-2,2,0,0,119,125,-6,6
Mark Hunt,Alistair Overeem,Alistair Overeem,2017-03-04,0,1,6,-6,0.9285714,2.473684,-15.23999,15.23999,0,0,-20.31999,20.31999,0,213,27,66,-39,39,-1.54511290788651,1.54511290788651,2,0,2,2,2,-2,0,0,350,175,175,-175
Francis Ngannou,Alistair Overeem,Francis Ngannou,2017-12-02,1,0,-6,6,5.666667,2.473684,0,0,-15,15,7.62001,-7.62001,63,0,20,66,-46,46,3.19298219680786,-3.19298219680786,0,1,0,2,-1,1,-2,2,0,273,-273,273
Curtis Blaydes,Alistair Overeem,Curtis Blaydes,2018-06-09,1,0,-11,11,4.25,2.473684,0,0,0,0,0,0,465,0,21,66,-45,45,1.77631568908691,-1.77631568908691,4,0,1,3,4,-4,-2,2,119,189,-70,70
Aleksei Oleinik,Alistair Overeem,Alistair Overeem,2019-04-20,0,1,3,-3,3.529412,2.473684,-5.079987,5.079987,-25,25,0,0,83,72,77,66,11,-11,1.05572748184204,-1.05572748184204,1,0,0,4,1,-1,-4,4,825,315,510,-510
Walt Harris,Alistair Overeem,Alistair Overeem,2020-05-16,0,1,-3,3,1.3,2.473684,2.540009,-2.540009,-15,15,-7.619995,7.619995,47,262,23,66,-43,43,-1.1736843585968,1.1736843585968,3,1,2,4,2,-2,-2,2,301,392,-91,91
Cody Gibson,Aljamain Sterling,Aljamain Sterling,2014-02-22,0,1,2,-2,2.222222,5.75,7.62001,-7.62001,0,0,0,0,191,475,29,27,2,-2,-3.52777767181396,3.52777767181396,0,0,0,0,0,0,0,0,0,0,0,0
Takeya Mizugaki,Aljamain Sterling,Aljamain Sterling,2015-04-18,0,1,6,-6,1.909091,5.75,0,0,0,0,-5.080002,5.080002,31,457,32,27,5,-5,-3.84090912342072,3.84090912342072,3,1,0,0,2,-2,0,0,329,420,-91,91
Johnny Eduardo,Aljamain Sterling,Aljamain Sterling,2015-12-10,0,1,11,-11,2.153846,5.75,0,0,0,0,0,0,1,209,41,27,14,-14,-3.5961537361145,3.5961537361145,1,2,0,0,-1,1,0,0,579,236,343,-343
Bryan Caraway,Aljamain Sterling,Bryan Caraway,2016-05-29,1,0,5,-5,2.333333,5.75,2.540009,-2.540009,0,0,-7.619995,7.619995,395,231,30,27,3,-3,-3.41666674613953,3.41666674613953,2,3,0,0,-1,1,0,0,309,171,138,-138
Raphael Assuncao,Aljamain Sterling,Raphael Assuncao,2017-01-28,1,0,7,-7,2.8,5.75,-5.079987,5.079987,0,0,-12.7,12.7,0,2,38,27,11,-11,-2.95000004768372,2.95000004768372,0,0,1,0,0,0,1,-1,203,244,-41,41
Augusto Mendes,Aljamain Sterling,Aljamain Sterling,2017-04-15,0,1,7,-7,3,5.75,-2.539993,2.539993,0,0,-15.23999,15.23999,193,359,8,27,-19,19,-2.75,2.75,1,0,0,0,1,-1,0,0,90,77,13,-13
Renan Barao,Aljamain Sterling,Aljamain Sterling,2017-07-29,0,1,3,-3,3.777778,5.75,-2.539993,2.539993,10,-10,-2.539993,2.539993,274,339,43,27,16,-16,-1.97222232818604,1.97222232818604,1,1,2,0,0,0,2,-2,308,105,203,-203
Marlon Moraes,Aljamain Sterling,Marlon Moraes,2017-12-09,1,0,1,-1,2.3,5.75,-2.539993,2.539993,0,0,-10.16,10.16,13,0,33,27,6,-6,-3.45000004768372,3.45000004768372,0,2,0,0,-2,2,0,0,0,133,-133,133
Brett Johns,Aljamain Sterling,Aljamain Sterling,2018-04-21,0,1,-2,2,8.5,5.75,0,0,0,0,0,0,391,82,19,27,-8,8,2.75,-2.75,2,0,0,1,2,-2,-1,1,141,133,8,-8
Cody Stamann,Aljamain Sterling,Aljamain Sterling,2018-09-08,0,1,-1,1,3.5,5.75,-2.539993,2.539993,0,0,-17.78,17.78,156,173,27,27,0,0,-2.25,2.25,1,1,0,1,0,0,-1,1,427,140,287,-287
Jimmie Rivera,Aljamain Sterling,Aljamain Sterling,2019-02-17,0,1,0,0,4.6,5.75,-7.619995,7.619995,0,0,-7.619995,7.619995,170,165,28,27,1,-1,-1.15000009536743,1.15000009536743,0,2,0,1,-2,2,-1,1,0,162,-162,162
Pedro Munhoz,Aljamain Sterling,Aljamain Sterling,2019-06-08,0,1,3,-3,2.5,5.75,-2.539993,2.539993,0,0,-15.23999,15.23999,5,0,28,27,1,-1,-3.25,3.25,2,3,0,1,-1,1,-1,1,741,111,630,-630
Cory Sandhagen,Aljamain Sterling,Aljamain Sterling,2020-06-06,0,1,-2,2,4.25,5.75,10.16,-10.16,0,0,-2.539993,2.539993,0,73,21,27,-6,6,-1.5,1.5,0,4,0,1,-4,4,-1,1,0,364,-364,364
TJ Dillashaw,Aljamain Sterling,Aljamain Sterling,2022-10-22,0,1,3,-3,3.6,5.75,-2.539993,2.539993,0,0,-10.16,10.16,3,426,23,27,-4,4,-2.15000009536743,2.15000009536743,10,5,1,1,5,-5,0,0,455,868,-413,413
Henry Cejudo,Aljamain Sterling,Aljamain Sterling,2023-05-06,0,1,3,-3,5.333333,5.75,-7.619995,7.619995,0,0,-17.78,17.78,306,240,19,27,-8,8,-0.416666507720947,0.416666507720947,6,6,1,1,0,0,0,0,1092,196,896,-896
"Sean O'Malley",Aljamain Sterling,"Sean O'Malley",2023-08-19,1,0,-6,6,17,5.75,10.16,-10.16,0,0,2.540009,-2.540009,18,34,18,27,-9,9,11.25,-11.25,2,7,1,1,-5,5,0,0,301,105,196,-196
Jake Hadley,Allan Nascimento,Allan Nascimento,2022-05-14,0,1,-5,5,5,3.333333,-2.540009,2.540009,0,0,2.540009,-2.540009,230,567,12,26,-14,14,1.66666674613953,-1.66666674613953,0,0,0,0,0,0,0,0,0,0,0,0
Carlos Hernandez,Allan Nascimento,Allan Nascimento,2023-01-14,0,1,-2,2,4.5,3.333333,0,0,0,0,-5.080002,5.080002,0,143,11,26,-15,15,1.16666674613953,-1.16666674613953,0,1,0,0,-1,1,0,0,0,245,-245,245
John Gunther,Allan Zuniga,John Gunther,2018-07-06,1,0,6,-6,5,13,5.080002,-5.080002,0,0,5.080002,-5.080002,668,0,6,14,-8,8,-8,8,0,0,0,0,0,0,0,0,0,0,0,0
Paul Craig,Alonzo Menifield,Alonzo Menifield,2019-06-29,0,1,0,0,2.833333,4.666667,7.619995,-7.619995,-20,20,0,0,12,82,23,17,6,-6,-1.83333325386047,1.83333325386047,1,0,2,0,1,-1,2,-2,91,0,91,-91
Devin Clark,Alonzo Menifield,Devin Clark,2020-06-06,1,0,-2,2,1.75,4.666667,0,0,0,0,-2.539993,2.539993,158,522,22,17,5,-5,-2.91666650772095,2.91666650772095,1,1,2,0,0,0,2,-2,112,343,-231,231
Fabio Cherant,Alonzo Menifield,Alonzo Menifield,2021-03-27,0,1,-7,7,1.75,4.666667,2.539993,-2.539993,0,0,-5.079987,5.079987,0,67,11,17,-6,6,-2.91666650772095,2.91666650772095,0,0,0,0,0,0,0,0,0,294,-294,294
Ed Herman,Alonzo Menifield,Alonzo Menifield,2021-08-07,0,1,7,-7,1.6875,4.666667,2.539993,-2.539993,0,0,2.540009,-2.540009,1,48,43,17,26,-26,-2.97916650772095,2.97916650772095,2,1,2,0,1,-1,2,-2,329,133,196,-196
William Knight,Alonzo Menifield,William Knight,2021-12-04,1,0,-1,1,2.2,4.666667,-5.080002,5.080002,0,0,-7.619995,7.619995,43,385,16,17,-1,1,-2.46666646003723,2.46666646003723,0,2,0,0,-2,2,0,0,238,119,119,-119
Misha Cirkunov,Alonzo Menifield,Alonzo Menifield,2022-10-15,0,1,1,-1,1.666667,4.666667,7.619995,-7.619995,0,0,2.540009,-2.540009,0,3,24,17,7,-7,-2.99999988079071,2.99999988079071,0,0,4,0,0,0,4,-4,231,315,-84,84
Jimmy Crute,Alonzo Menifield,Alonzo Menifield,2023-07-08,0,1,-8,8,3,4.666667,5.080002,-5.080002,0,0,-5.079987,5.079987,72,105,16,17,-1,1,-1.66666650772095,1.66666650772095,0,1,2,0,-1,1,2,-2,581,266,315,-315
John Lineker,Alptekin Ozkilic,John Lineker,2014-07-16,1,0,-4,4,3.444444,1.8,-5.080002,5.080002,10,-10,5.079987,-5.079987,16,55,40,14,26,-26,1.64444446563721,-1.64444446563721,2,0,0,0,2,-2,0,0,347,0,347,-347
Ben Nguyen,Alptekin Ozkilic,Ben Nguyen,2015-05-09,1,0,-3,3,2,1.8,0,0,0,0,0,0,23,98,24,14,10,-10,0.200000047683716,-0.200000047683716,0,0,0,1,0,0,-1,1,0,297,-297,297
Kenny Florian,Alvin Robinson,Kenny Florian,2007-07-07,1,0,7,-7,2.333333,1.666667,2.540009,-2.540009,-10,10,15.24001,-15.24001,142,75,20,24,-4,4,0.666666626930237,-0.666666626930237,1,0,1,0,1,-1,1,-1,93,0,93,-93
Jorge Gurgel,Alvin Robinson,Alvin Robinson,2007-10-20,0,1,5,-5,1.4,1.666667,-5.080002,5.080002,0,0,2.539993,-2.539993,370,485,24,24,0,0,-0.266666650772095,0.266666650772095,1,0,0,1,1,-1,-1,1,105,105,0,0
Nate Diaz,Alvin Robinson,Nate Diaz,2008-01-23,1,0,-3,3,1.692308,1.666667,7.62001,-7.62001,15,-15,20.31999,-20.31999,151,57,35,24,11,-11,2.56410837173462e-02,-2.56410837173462e-02,1,1,0,1,0,0,-1,1,214,95,119,-119
Mark Bocek,Alvin Robinson,Mark Bocek,2008-11-15,1,0,1,-1,2.4,1.666667,-2.539993,2.539993,0,0,17.78,-17.78,699,54,17,24,-7,7,0.733333468437195,-0.733333468437195,0,0,1,1,0,0,0,0,210,297,-87,87
Cynthia Calvillo,Amanda Cooper,Cynthia Calvillo,2017-03-04,1,0,4,-4,1.5,0.6,2.539993,-2.539993,0,0,0,0,107,0,15,8,7,-7,0.899999976158142,-0.899999976158142,0,0,0,0,0,0,0,0,0,0,0,0
Miranda Granger,Amanda Lemos,Amanda Lemos,2019-12-21,0,1,-5,5,2.333333,4.333333,7.619995,-7.619995,0,0,7.619995,-7.619995,6,140,10,16,-6,6,-2.00000023841858,2.00000023841858,0,0,0,0,0,0,0,0,0,0,0,0
Montserrat Conejo Ruiz,Amanda Lemos,Amanda Lemos,2021-07-17,0,1,-6,6,3.333333,4.333333,-10.16,10.16,0,0,-10.16,10.16,0,4,13,16,-3,3,-1.00000023841858,1.00000023841858,1,1,0,0,0,0,0,0,119,574,-455,455
Angela Hill,Amanda Lemos,Amanda Lemos,2021-12-18,0,1,2,-2,1.153846,4.333333,-2.539993,2.539993,0,0,-2.540009,2.540009,264,131,28,16,12,-12,-3.17948734760284,3.17948734760284,0,2,0,0,-2,2,0,0,133,154,-21,21
Jessica Andrade,Amanda Lemos,Jessica Andrade,2022-04-23,1,0,-4,4,2,4.333333,-7.619995,7.619995,0,0,-7.62001,7.62001,38,0,36,16,20,-20,-2.33333349227905,2.33333349227905,1,3,3,0,-2,2,3,-3,210,126,84,-84
Sheila Gaff,Amanda Nunes,Amanda Nunes,2013-08-03,0,1,-2,2,1.285714,4.6,-7.619995,7.619995,0,0,-7.259995,7.259995,12,98,16,28,-12,12,-3.31428563594818,3.31428563594818,0,0,1,0,0,0,1,-1,98,0,98,-98
Germaine de Randamie,Amanda Nunes,Amanda Nunes,2013-11-06,0,1,4,-4,2.5,4.6,2.539993,-2.539993,0,0,5.080002,-5.080002,0,162,14,28,-14,14,-2.09999990463257,2.09999990463257,1,1,0,0,0,0,0,0,102,95,7,-7
Shayna Baszler,Amanda Nunes,Amanda Nunes,2015-03-21,0,1,8,-8,1.363636,4.6,-2.540009,2.540009,0,0,-5.259995,5.259995,1,1,26,28,-2,2,-3.236363530159,3.236363530159,0,2,1,0,-2,2,1,-1,203,500,-297,297
Sara McMann,Amanda Nunes,Amanda Nunes,2015-08-08,0,1,7,-7,2.166667,4.6,-5.080002,5.080002,0,0,-7.619995,7.619995,6,43,19,28,-9,9,-2.43333315849304,2.43333315849304,0,3,1,0,-3,3,1,-1,189,140,49,-49
Cristiane Justino,Amanda Nunes,Amanda Nunes,2018-12-29,0,1,3,-3,10.5,4.6,0,0,10,-10,-2.539993,2.539993,0,1,23,28,-5,5,5.90000009536743,-5.90000009536743,3,4,0,0,-1,1,0,0,301,1239,-938,938
Holly Holm,Amanda Nunes,Amanda Nunes,2019-07-06,0,1,6,-6,2.142857,4.6,0,0,0,0,0,0,0,5,22,28,-6,6,-2.45714282989502,2.45714282989502,0,5,0,0,-5,5,0,0,553,189,364,-364
Germaine de Randamie,Amanda Nunes,Amanda Nunes,2019-12-14,0,1,4,-4,2.5,4.6,2.539993,-2.539993,0,0,5.080002,-5.080002,99,1110,14,28,-14,14,-2.09999990463257,2.09999990463257,5,6,1,0,-1,1,1,-1,154,161,-7,7
Megan Anderson,Amanda Nunes,Amanda Nunes,2021-03-06,0,1,-1,1,2.2,4.6,10.16,-10.16,10,-10,7.62001,-7.62001,0,42,16,28,-12,12,-2.39999985694885,2.39999985694885,2,7,0,0,-5,5,0,0,371,448,-77,77
Irene Aldana,Amanda Nunes,Amanda Nunes,2023-06-10,0,1,0,0,2,4.6,2.539993,-2.539993,0,0,-2.539993,2.539993,10,420,21,28,-7,7,-2.59999990463257,2.59999990463257,2,8,0,0,-6,6,0,0,273,826,-553,553
Mackenzie Dern,Amanda Ribas,Amanda Ribas,2019-10-12,0,1,0,0,4.333333,2.75,2.539993,-2.539993,-10,10,-7.619995,7.619995,2,106,16,15,1,-1,1.58333349227905,-1.58333349227905,1,0,0,0,1,-1,0,0,588,0,588,-588
Randa Markos,Amanda Ribas,Amanda Ribas,2020-03-14,0,1,8,-8,0.9166667,2.75,2.539993,-2.539993,-10,10,-7.619995,7.619995,60,445,23,15,8,-8,-1.83333331346512,1.83333331346512,1,1,0,0,0,0,0,0,140,154,-14,14
Virna Jandiroba,Amanda Ribas,Amanda Ribas,2021-10-30,0,1,5,-5,6.333333,2.75,0,0,-10,10,-5.080002,5.080002,186,43,22,15,7,-7,3.58333349227905,-3.58333349227905,2,2,0,0,0,0,0,0,133,595,-462,462
Katlyn Chookagian,Amanda Ribas,Katlyn Chookagian,2022-05-14,1,0,5,-5,3.6,2.75,15.23999,-15.23999,0,0,5.080002,-5.080002,6,289,23,15,8,-8,0.849999904632568,-0.849999904632568,2,3,1,0,-1,1,1,-1,119,196,-77,77
Viviane Araujo,Amanda Ribas,Amanda Ribas,2023-03-04,0,1,7,-7,2.2,2.75,2.539993,-2.539993,0,0,5.080002,-5.080002,0,500,16,15,1,-1,-0.549999952316284,0.549999952316284,0,0,0,0,0,0,0,0,140,294,-154,154
Maycee Barber,Amanda Ribas,Maycee Barber,2023-06-24,1,0,-4,4,6.5,2.75,5.080002,-5.080002,0,0,-2.539993,2.539993,82,145,15,15,0,0,3.75,-3.75,4,1,0,0,3,-3,0,0,91,112,-21,21
Chuck Liddell,Amar Suloev,Chuck Liddell,2002-01-11,1,0,7,-7,2.625,3.428571,12.70001,-12.70001,22,-22,15.03999,-15.03999,0,0,29,31,-2,2,-0.803571462631226,0.803571462631226,2,0,0,0,2,-2,0,0,252,0,252,-252
Phil Baroni,Amar Suloev,Phil Baroni,2002-05-10,1,0,1,-1,0.8333333,3.428571,0,0,-13,13,4.880005,-4.880005,51,3,33,31,2,-2,-2.59523814916611,2.59523814916611,0,0,0,0,0,0,0,0,189,119,70,-70
Alex Andrade,Amaury Bitetti,Amaury Bitetti,2000-06-09,0,1,,,2,2.5,5.080002,-5.080002,15,-15,5.949997,-5.949997,92,14,15,7,8,-8,-0.5,0.5,0,0,0,0,0,0,0,0,0,0,0,0
CB Dollaway,Amir Sadollah,Amir Sadollah,2008-06-21,0,1,-3,3,1.888889,1.2,10.16,-10.16,15,-15,2.539993,-2.539993,133,0,26,11,15,-15,0.688888788223267,-0.688888788223267,0,0,0,0,0,0,0,0,0,0,0,0
Johny Hendricks,Amir Sadollah,Johny Hendricks,2009-08-08,1,0,-3,3,2.25,1.2,-2.540009,2.540009,15,-15,-15.24001,15.24001,2,0,26,11,15,-15,1.04999995231628,-1.04999995231628,0,1,0,0,-1,1,0,0,0,413,-413,413
Phil Baroni,Amir Sadollah,Amir Sadollah,2009-11-21,0,1,4,-4,0.8333333,1.2,-2.540009,2.540009,0,0,-7.619995,7.619995,136,328,33,11,22,-22,-0.366666734218597,0.366666734218597,0,0,1,1,0,0,0,0,1750,105,1645,-1645
Brad Blackburn,Amir Sadollah,Amir Sadollah,2010-01-11,0,1,3,-3,1.384615,1.2,0,0,0,0,-5.080002,5.080002,148,303,31,11,20,-20,0.18461537361145,-0.18461537361145,3,1,0,1,2,-2,-1,1,205,51,154,-154
Dong Hyun Kim,Amir Sadollah,Dong Hyun Kim,2010-05-29,1,0,-1,1,5.5,1.2,10.16,-10.16,0,0,2.539993,-2.539993,743,9,26,11,15,-15,4.29999995231628,-4.29999995231628,1,2,0,1,-1,1,-1,1,735,138,597,-597
DaMarques Johnson,Amir Sadollah,Amir Sadollah,2011-03-26,0,1,-2,2,1,1.2,7.619995,-7.619995,0,0,0,0,155,191,30,11,19,-19,-0.200000047683716,0.200000047683716,0,0,1,1,0,0,0,0,237,301,-64,64
Duane Ludwig,Amir Sadollah,Duane Ludwig,2011-08-14,1,0,3,-3,1.5,1.2,0,0,0,0,-12.7,12.7,99,59,35,11,24,-24,0.299999952316284,-0.299999952316284,1,1,0,1,0,0,-1,1,274,141,133,-133
Jorge Lopez,Amir Sadollah,Amir Sadollah,2012-05-15,0,1,-8,8,2.2,1.2,0,0,0,0,-10.5,10.5,504,112,16,11,5,-5,1,-1,0,0,0,1,0,0,-1,1,0,275,-275,275
Dan Hardy,Amir Sadollah,Dan Hardy,2012-09-29,1,0,-2,2,2.5,1.2,5.080002,-5.080002,0,0,-2.539993,2.539993,409,45,35,11,24,-24,1.29999995231628,-1.29999995231628,1,1,0,1,0,0,-1,1,126,137,-11,11
Yoshihiro Akiyama,Amir Sadollah,Yoshihiro Akiyama,2014-09-20,1,0,5,-5,2.333333,1.2,0,0,0,0,0,0,475,12,20,11,9,-9,1.13333320617676,-1.13333320617676,0,0,1,1,0,0,0,0,938,721,217,-217
Martin Day,Anderson Dos Santos,Anderson Dos Santos,2020-11-28,0,1,-3,3,1.333333,2.333333,12.7,-12.7,10,-10,7.619995,-7.619995,15,177,14,30,-16,16,-0.99999988079071,0.99999988079071,0,0,1,0,0,0,1,-1,140,0,140,-140
Chris Leben,Anderson Silva,Anderson Silva,2006-06-28,0,1,-6,6,2,3.090909,-7.62001,7.62001,0,0,-10.16,10.16,0,9,33,45,-12,12,-1.09090900421143,1.09090900421143,2,0,0,0,2,-2,0,0,163,0,163,-163
Rich Franklin,Anderson Silva,Anderson Silva,2006-10-14,0,1,1,-1,4.142857,3.090909,-2.540009,2.540009,0,0,-2.540009,2.540009,0,22,36,45,-9,9,1.05194807052612,-1.05194807052612,6,1,0,0,5,-5,0,0,224,108,116,-116
Travis Lutter,Anderson Silva,Anderson Silva,2007-02-03,0,1,2,-2,1.666667,3.090909,-7.62001,7.62001,0,0,-5.080002,5.080002,295,26,16,45,-29,29,-1.42424237728119,1.42424237728119,0,2,0,0,-2,2,0,0,532,112,420,-420
Nate Marquardt,Anderson Silva,Anderson Silva,2007-07-07,0,1,-4,4,1.842105,3.090909,-5.080002,5.080002,0,0,-7.619995,7.619995,144,43,54,45,9,-9,-1.24880373477936,1.24880373477936,2,3,0,0,-1,1,0,0,270,154,116,-116
Rich Franklin,Anderson Silva,Anderson Silva,2007-10-20,0,1,1,-1,4.142857,3.090909,-2.540009,2.540009,0,0,-2.540009,2.540009,91,52,36,45,-9,9,1.05194807052612,-1.05194807052612,2,4,1,0,-2,2,1,-1,126,105,21,-21
Dan Henderson,Anderson Silva,Anderson Silva,2008-03-01,0,1,5,-5,2.133333,3.090909,-7.62001,7.62001,0,0,-7.619995,7.619995,225,156,47,45,2,-2,-0.957575559616089,0.957575559616089,0,5,0,0,-5,5,0,0,175,133,42,-42
James Irvin,Anderson Silva,Anderson Silva,2008-07-19,0,1,-4,4,1.7,3.090909,0,0,20,-20,-5.080002,5.080002,0,6,27,45,-18,18,-1.39090895652771,1.39090895652771,0,6,2,0,-6,6,2,-2,420,140,280,-280
Patrick Cote,Anderson Silva,Anderson Silva,2008-10-25,0,1,-5,5,2.090909,3.090909,-7.62001,7.62001,-15,15,-5.080002,5.080002,28,97,34,45,-11,11,-1,1,3,7,0,0,-4,4,0,0,276,98,178,-178
Thales Leites,Anderson Silva,Anderson Silva,2009-04-18,0,1,-7,7,3.111111,3.090909,-2.540009,2.540009,0,0,2.539993,-2.539993,158,165,37,45,-8,8,2.02021598815918e-02,-2.02021598815918e-02,4,8,0,0,-4,4,0,0,175,175,0,0
Forrest Griffin,Anderson Silva,Anderson Silva,2009-08-08,0,1,-4,4,2.714286,3.090909,2.539993,-2.539993,20,-20,0,0,0,19,26,45,-19,19,-0.376623392105103,0.376623392105103,3,9,1,0,-6,6,1,-1,399,112,287,-287
Demian Maia,Anderson Silva,Anderson Silva,2010-04-10,0,1,-2,2,2.545455,3.090909,-2.540009,2.540009,-15,15,-12.7,12.7,4,82,39,45,-6,6,-0.545454502105713,0.545454502105713,1,10,1,0,-9,9,1,-1,63,245,-182,182
Vitor Belfort,Anderson Silva,Anderson Silva,2011-02-05,0,1,-2,2,1.857143,3.090909,-5.080002,5.080002,0,0,-7.619995,7.619995,3,5,40,45,-5,5,-1.23376619815826,1.23376619815826,1,11,2,0,-10,10,2,-2,504,301,203,-203
Yushin Okami,Anderson Silva,Anderson Silva,2011-08-27,0,1,-6,6,2.833333,3.090909,0,0,-15,15,-5.080002,5.080002,111,33,46,45,1,-1,-0.257575750350952,0.257575750350952,0,12,0,0,-12,12,0,0,672,203,469,-469
Stephan Bonnar,Anderson Silva,Anderson Silva,2012-10-13,0,1,-2,2,1.666667,3.090909,5.079987,-5.079987,20,-20,5.080002,-5.080002,178,21,24,45,-21,21,-1.42424237728119,1.42424237728119,3,13,1,0,-10,10,1,-1,329,413,-84,84
Michael Bisping,Anderson Silva,Michael Bisping,2016-02-27,1,0,-4,4,3.333333,3.090909,-2.540009,2.540009,0,0,-5.080002,5.080002,44,5,39,45,-6,6,0.242424249649048,-0.242424249649048,2,14,1,0,-12,12,1,-1,224,1232,-1008,1008
Daniel Cormier,Anderson Silva,Daniel Cormier,2016-07-09,1,0,-4,4,7.333333,3.090909,-7.62001,7.62001,50,-50,-12.7,12.7,633,0,25,45,-20,20,4.24242448806763,-4.24242448806763,2,0,0,0,2,-2,0,0,280,133,147,-147
Derek Brunson,Anderson Silva,Anderson Silva,2017-02-11,0,1,-8,8,2.555556,3.090909,-2.540009,2.540009,0,0,0,0,228,0,32,45,-13,13,-0.535353422164917,0.535353422164917,0,0,2,0,0,0,2,-2,77,217,-140,140
Israel Adesanya,Anderson Silva,Israel Adesanya,2019-02-09,1,0,-14,14,8,3.090909,5.079987,-5.079987,0,0,7.619995,-7.619995,0,0,27,45,-18,18,4.90909099578857,-4.90909099578857,4,1,0,0,3,-3,0,0,98,728,-630,630
Jared Cannonier,Anderson Silva,Jared Cannonier,2019-05-11,1,0,-9,9,2.833333,3.090909,-7.62001,7.62001,0,0,0,0,9,0,23,45,-22,22,-0.257575750350952,0.257575750350952,0,0,2,0,0,0,2,-2,357,91,266,-266
Uriah Hall,Anderson Silva,Uriah Hall,2020-10-31,1,0,-9,9,1.636364,3.090909,-5.080002,5.080002,0,0,5.080002,-5.080002,15,31,29,45,-16,16,-1.454545378685,1.454545378685,2,0,1,1,2,-2,0,0,672,539,133,-133
Renan Barao,Andre Ewell,Andre Ewell,2018-09-22,0,1,1,-1,3.777778,1.888889,-5.080002,5.080002,0,0,-12.7,12.7,294,28,43,26,17,-17,1.88888883590698,-1.88888883590698,0,0,2,0,0,0,2,-2,210,0,210,-210
Anderson Dos Santos,Andre Ewell,Andre Ewell,2019-06-22,0,1,2,-2,2.333333,1.888889,-7.619995,7.619995,-10,10,-12.7,12.7,232,2,30,26,4,-4,0.444444417953491,-0.444444417953491,0,1,0,0,-1,1,0,0,217,273,-56,56
Julio Arce,Andre Ewell,Julio Arce,2021-07-24,1,0,-2,2,3,1.888889,-2.540009,2.540009,-10,10,-12.7,12.7,24,0,24,26,-2,2,1.11111116409302,-1.11111116409302,0,2,0,0,-2,2,0,0,630,763,-133,133
Miguel Baeza,Andre Fialho,Andre Fialho,2022-04-16,0,1,1,-1,3.333333,2,5.080002,-5.080002,0,0,0,0,0,3,13,24,-11,11,1.33333325386047,-1.33333325386047,0,0,1,0,0,0,1,-1,154,0,154,-154
Joaquin Buckley,Andre Fialho,Joaquin Buckley,2023-05-20,1,0,0,0,2.666667,2,-5.080002,5.080002,0,0,5.079987,-5.079987,23,7,22,24,-2,2,0.666666746139526,-0.666666746139526,0,1,3,0,-1,1,3,-3,161,399,-238,238
Felipe Arantes,Andre Fili,Andre Fili,2014-10-25,0,1,2,-2,1.8,2.2,-7.619995,7.619995,-10,10,-2.540009,2.540009,314,392,28,32,-4,4,-0.400000095367432,0.400000095367432,1,0,0,0,1,-1,0,0,252,0,252,-252
Gabriel Benitez,Andre Fili,Andre Fili,2015-11-21,0,1,2,-2,2.090909,2.2,-7.619995,7.619995,10,-10,-7.62001,7.62001,0,7,34,32,2,-2,-0.10909104347229,0.10909104347229,2,1,0,0,1,-1,0,0,161,392,-231,231
Hacran Dias,Andre Fili,Andre Fili,2016-10-01,0,1,6,-6,3.833333,2.2,-7.619995,7.619995,10,-10,-12.70001,12.70001,333,140,29,32,-3,3,1.63333320617676,-1.63333320617676,0,2,0,0,-2,2,0,0,168,315,-147,147
Dennis Bermudez,Andre Fili,Andre Fili,2018-01-27,0,1,4,-4,1.888889,2.2,-12.7,12.7,10,-10,-20.32001,20.32001,191,50,26,32,-6,6,-0.311111211776733,0.311111211776733,0,3,2,0,-3,3,2,-2,189,483,-294,294
Joanderson Brito,Andre Fili,Joanderson Brito,2022-04-30,1,0,-4,4,5,2.2,-7.619995,7.619995,0,0,-5.080002,5.080002,7,0,18,32,-14,14,2.79999995231628,-2.79999995231628,0,4,0,0,-4,4,0,0,0,1554,-1554,1554
Bill Algeo,Andre Fili,Andre Fili,2022-09-17,0,1,1,-1,2.428571,2.2,2.540009,-2.540009,0,0,-2.540009,2.540009,7,258,24,32,-8,8,0.22857141494751,-0.22857141494751,2,0,0,1,2,-2,-1,1,63,140,-77,77
Antonio Arroyo,Andre Muniz,Andre Muniz,2019-11-16,0,1,1,-1,1.8,3.833333,5.080002,-5.080002,0,0,-12.7,12.7,303,321,14,29,-15,15,-2.03333330154419,2.03333330154419,0,0,0,0,0,0,0,0,0,0,0,0
Bartosz Fabinski,Andre Muniz,Andre Muniz,2020-09-05,0,1,4,-4,3,3.833333,-2.539993,2.539993,-15,15,-7.619995,7.619995,146,2,20,29,-9,9,-0.833333253860474,0.833333253860474,0,1,0,0,-1,1,0,0,658,294,364,-364
Eryk Anders,Andre Muniz,Andre Muniz,2021-12-11,0,1,3,-3,1.875,3.833333,0,0,0,0,-7.619995,7.619995,0,138,23,29,-6,6,-1.95833325386047,1.95833325386047,1,2,1,0,-1,1,1,-1,182,462,-280,280
Uriah Hall,Andre Muniz,Andre Muniz,2022-07-02,0,1,5,-5,1.636364,3.833333,-2.539993,2.539993,0,0,2.540009,-2.540009,18,612,29,29,0,0,-2.19696962833405,2.19696962833405,0,3,1,0,-3,3,1,-1,336,203,133,-133
Brendan Allen,Andre Muniz,Brendan Allen,2023-02-25,1,0,-6,6,4.4,3.833333,2.540009,-2.540009,0,0,-7.619995,7.619995,252,15,27,29,-2,2,0.566666841506958,-0.566666841506958,3,4,2,0,-1,1,2,-2,147,238,-91,91
Paul Craig,Andre Muniz,Paul Craig,2023-07-22,1,0,2,-2,2.833333,3.833333,5.080002,-5.080002,0,0,-5.080002,5.080002,176,107,23,29,-6,6,-1,1,0,0,4,0,0,0,4,-4,182,147,35,-35
Pat Miletich,Andre Pederneiras,Pat Miletich,1999-07-16,1,0,-1,1,4.142857,1,5.080002,-5.080002,15,-15,5,-5,96,4,36,2,34,-34,3.14285707473755,-3.14285707473755,2,0,0,0,2,-2,0,0,189,0,189,-189
Micheal Gillmore,Andre Petroski,Andre Petroski,2021-08-28,0,1,4,-4,1.2,5,-2.540009,2.540009,-15,15,-2.539993,2.539993,3,458,11,12,-1,1,-3.79999995231628,3.79999995231628,0,0,0,0,0,0,0,0,0,0,0,0
Nick Maximov,Andre Petroski,Andre Petroski,2022-05-14,0,1,-6,6,4,5,0,0,0,0,7.619995,-7.619995,0,23,10,12,-2,2,-1,1,1,1,0,0,0,0,0,0,98,259,-161,161
Gerald Meerschaert,Andre Petroski,Andre Petroski,2023-08-19,0,1,3,-3,2.058824,5,2.539993,-2.539993,0,0,10.16,-10.16,114,126,52,12,40,-40,-2.94117641448975,2.94117641448975,0,2,2,0,-2,2,2,-2,133,462,-329,329
Harry Moskowitz,Andre Roberts,Andre Roberts,1998-05-15,0,1,,,0.5,7,7.619995,-7.619995,-70,70,9,-9,0,0,18,16,2,-2,-6.5,6.5,0,0,0,0,0,0,0,0,0,0,0,0
Gary Goodridge,Andre Roberts,Gary Goodridge,1999-03-05,1,0,-1,1,1.045455,7,2.539993,-2.539993,-96,96,2,-2,0,0,45,16,29,-29,-5.95454549789429,5.95454549789429,0,1,1,0,-1,1,1,-1,1022,294,728,-728
Albert Morales,Andre Soukhamthath,Albert Morales,2017-03-04,1,0,-3,3,1.75,1.625,0,0,0,0,5.080002,-5.080002,282,138,11,21,-10,10,0.125,-0.125,0,0,0,0,0,0,0,0,0,0,0,0
Alejandro Perez,Andre Soukhamthath,Alejandro Perez,2017-08-05,1,0,-1,1,2.555556,1.625,-7.619995,7.619995,0,0,-7.62001,7.62001,132,9,32,21,11,-11,0.930555582046509,-0.930555582046509,0,0,0,0,0,0,0,0,784,154,630,-630
Luke Sanders,Andre Soukhamthath,Andre Soukhamthath,2017-12-09,0,1,2,-2,2.6,1.625,-7.619995,7.619995,0,0,-7.62001,7.62001,109,0,18,21,-3,3,0.974999904632568,-0.974999904632568,0,0,0,0,0,0,0,0,0,126,-126,126
"Sean O'Malley",Andre Soukhamthath,"Sean O'Malley",2018-03-03,1,0,-6,6,17,1.625,5.080002,-5.080002,0,0,5.080002,-5.080002,55,361,18,21,-3,3,15.375,-15.375,1,1,0,0,0,0,0,0,92,84,8,-8
Jonathan Martinez,Andre Soukhamthath,Andre Soukhamthath,2018-10-27,0,1,-6,6,4.5,1.625,-2.539993,2.539993,0,0,0,0,300,267,22,21,1,-1,2.875,-2.875,0,0,0,0,0,0,0,0,0,238,-238,238
Montel Jackson,Andre Soukhamthath,Montel Jackson,2019-04-13,1,0,-4,4,6.5,1.625,2.540009,-2.540009,0,0,12.7,-12.7,464,5,15,21,-6,6,4.875,-4.875,1,1,0,0,0,0,0,0,105,168,-63,63
Ross Pearson,Andre Winner,Ross Pearson,2009-06-20,1,0,-3,3,1.25,1.909091,-7.619995,7.619995,0,0,-10.16,10.16,227,361,36,32,4,-4,-0.659090876579285,0.659090876579285,0,0,0,0,0,0,0,0,0,0,0,0
Rolando Delgado,Andre Winner,Andre Winner,2009-11-14,0,1,-1,1,1.833333,1.909091,10.16,-10.16,0,0,10.16,-10.16,10,13,17,32,-15,15,-7.57575035095215e-02,7.57575035095215e-02,0,0,0,0,0,0,0,0,154,147,7,-7
Rafaello Oliveira,Andre Winner,Andre Winner,2010-03-31,0,1,0,0,2.125,1.909091,-7.619995,7.619995,0,0,-5.080002,5.080002,97,42,25,32,-7,7,0.215909123420715,-0.215909123420715,0,1,0,0,-1,1,0,0,0,137,-137,137
Nik Lentz,Andre Winner,Nik Lentz,2010-08-28,1,0,-2,2,2.5,1.909091,-7.619995,7.619995,-10,10,-12.7,12.7,780,25,42,32,10,-10,0.590909123420715,-0.590909123420715,1,2,0,0,-1,1,0,0,343,150,193,-193
Dennis Siver,Andre Winner,Dennis Siver,2010-11-13,1,0,2,-2,2.090909,1.909091,-12.7,12.7,-10,10,-7.619995,7.619995,35,0,34,32,2,-2,0.181818127632141,-0.181818127632141,0,0,0,0,0,0,0,0,0,77,-77,77
Anthony Njokuani,Andre Winner,Anthony Njokuani,2011-07-02,1,0,2,-2,1.333333,1.909091,5.080002,-5.080002,0,0,5.080002,-5.080002,66,25,28,32,-4,4,-0.575757503509521,0.575757503509521,0,0,0,0,0,0,0,0,0,231,-231,231
Veronica Hardy,Andrea Lee,Andrea Lee,2018-05-19,0,1,-7,7,1.75,1.625,-5.080002,5.080002,0,0,-12.7,12.7,103,484,11,21,-10,10,0.125,-0.125,0,0,0,0,0,0,0,0,0,0,0,0
Ashlee Evans-Smith,Andrea Lee,Andrea Lee,2019-02-17,0,1,1,-1,1,1.625,5.080002,-5.080002,10,-10,-5.080002,5.080002,36,85,12,21,-9,9,-0.625,0.625,1,1,0,0,0,0,0,0,316,274,42,-42
Montana De La Rosa,Andrea Lee,Andrea Lee,2019-06-22,0,1,-6,6,1.5,1.625,2.539993,-2.539993,0,0,-2.539993,2.539993,237,149,20,21,-1,1,-0.125,0.125,3,2,0,0,1,-1,0,0,133,125,8,-8
Cynthia Calvillo,Andrea Lee,Andrea Lee,2021-11-13,0,1,2,-2,1.5,1.625,-5.080002,5.080002,-10,10,-12.7,12.7,39,0,15,21,-6,6,-0.125,0.125,0,3,0,0,-3,3,0,0,357,875,-518,518
Viviane Araujo,Andrea Lee,Viviane Araujo,2022-05-14,1,0,2,-2,2.2,1.625,-5.080002,5.080002,0,0,-2.539993,2.539993,640,48,16,21,-5,5,0.575000047683716,-0.575000047683716,0,4,0,0,-4,4,0,0,364,182,182,-182
Maycee Barber,Andrea Lee,Maycee Barber,2023-03-25,1,0,-10,10,6.5,1.625,-2.539993,2.539993,0,0,-10.15999,10.15999,45,320,15,21,-6,6,4.875,-4.875,3,0,0,0,3,-3,0,0,266,315,-49,49
Modestas Bukauskas,Andreas Michailidis,Modestas Bukauskas,2020-07-15,1,0,-5,5,3,2.166667,7.619995,-7.619995,35,-35,5.080002,-5.080002,0,9,20,19,1,-1,0.833333253860474,-0.833333253860474,0,0,0,0,0,0,0,0,0,0,0,0
KB Bhullar,Andreas Michailidis,Andreas Michailidis,2021-05-01,0,1,-3,3,4,2.166667,10.15999,-10.15999,15,-15,5.080002,-5.080002,12,119,10,19,-9,9,1.83333325386047,-1.83333325386047,0,0,1,1,0,0,0,0,203,290,-87,87
Rinat Fakhretdinov,Andreas Michailidis,Rinat Fakhretdinov,2022-06-04,1,0,-3,3,21,2.166667,0,0,0,0,-5.079987,5.079987,780,39,22,19,3,-3,18.8333332538605,-18.8333332538605,0,1,0,1,-1,1,-1,1,0,399,-399,399
Gilbert Burns,Andreas Stahl,Gilbert Burns,2014-07-26,1,0,2,-2,3.666667,2.5,-2.539993,2.539993,0,0,-2.660004,2.660004,223,181,28,14,14,-14,1.16666674613953,-1.16666674613953,0,0,0,0,0,0,0,0,0,0,0,0
Santiago Ponzinibbio,Andreas Stahl,Santiago Ponzinibbio,2015-12-10,1,0,2,-2,4.285714,2.5,2.540009,-2.540009,0,0,2.419998,-2.419998,13,16,37,14,23,-23,1.7857141494751,-1.7857141494751,1,0,0,0,1,-1,0,0,291,502,-211,211
Junior Albini,Andrei Arlovski,Andrei Arlovski,2017-11-11,0,1,-12,12,2.333333,1.545455,0,0,24,-24,-7.619995,7.619995,217,2,20,56,-36,36,0.787878751754761,-0.787878751754761,1,0,0,0,1,-1,0,0,112,0,112,-112
Shamil Abdurakhimov,Andrei Arlovski,Shamil Abdurakhimov,2018-09-15,1,0,-2,2,2.5,1.545455,0,0,-5,5,-2.540009,2.540009,206,18,28,56,-28,28,0.954545497894287,-0.954545497894287,1,1,2,0,0,0,2,-2,294,308,-14,14
Ricardo Almeida,Andrei Semenov,Andrei Semenov,2002-01-11,0,1,1,-1,2.6,3.777778,0,0,-15,15,2.960007,-2.960007,45,147,18,43,-25,25,-1.1777777671814,1.1777777671814,1,0,0,0,1,-1,0,0,105,0,105,-105
Ivan Salaverry,Andrei Semenov,Ivan Salaverry,2002-05-10,1,0,7,-7,1.555556,3.777778,0,0,0,0,0,0,355,105,23,43,-20,20,-2.22222208976746,2.22222208976746,0,1,0,0,-1,1,0,0,0,119,-119,119
Luke Barnatt,Andrew Craig,Luke Barnatt,2013-10-26,1,0,-2,2,3.25,2.25,12.7,-12.7,15,-15,2.540009,-2.540009,46,0,17,13,4,-4,1,-1,1,0,0,0,1,-1,0,0,196,0,196,-196
Gregor Gillespie,Andrew Holbrook,Gregor Gillespie,2017-04-08,1,0,-1,1,14,4,-10.16,10.16,0,0,2.539993,-2.539993,5,0,15,15,0,0,10,-10,0,0,0,0,0,0,0,0,0,0,0,0
Thibault Gouti,Andrew Holbrook,Thibault Gouti,2017-09-02,1,0,-1,1,2.4,4,-2.539993,2.539993,0,0,5.080002,-5.080002,30,0,17,15,2,-2,-1.59999990463257,1.59999990463257,0,0,1,1,0,0,0,0,371,147,224,-224
Khalil Rountree Jr.,Andrew Sanchez,Andrew Sanchez,2016-07-08,0,1,-2,2,2.6,1.857143,0,0,20,-20,5.079987,-5.079987,0,722,18,20,-2,2,0.742857098579407,-0.742857098579407,0,0,0,0,0,0,0,0,0,0,0,0
Ryan Janes,Andrew Sanchez,Ryan Janes,2017-12-01,1,0,7,-7,3.333333,1.857143,5.080002,-5.080002,0,0,5.079987,-5.079987,14,127,13,20,-7,7,1.47619044780731,-1.47619044780731,0,1,0,0,-1,1,0,0,138,511,-373,373
Markus Perez,Andrew Sanchez,Andrew Sanchez,2018-08-25,0,1,0,0,2.4,1.857143,0,0,0,0,-2.540009,2.540009,7,340,17,20,-3,3,0.54285728931427,-0.54285728931427,0,0,0,1,0,0,-1,1,0,267,-267,267
Marc-Andre Barriault,Andrew Sanchez,Andrew Sanchez,2019-05-04,0,1,-2,2,2.666667,1.857143,0,0,0,0,0,0,5,378,22,20,2,-2,0.809523940086365,-0.809523940086365,0,1,0,1,-1,1,-1,1,0,252,-252,252
Makhmud Muradov,Andrew Sanchez,Makhmud Muradov,2021-01-23,1,0,-2,2,3.25,1.857143,2.540009,-2.540009,0,0,2.539993,-2.539993,16,22,34,20,14,-14,1.39285719394684,-1.39285719394684,1,2,0,1,-1,1,-1,1,413,630,-217,217
Akira Corassani,Andy Ogle,Akira Corassani,2012-09-29,1,0,7,-7,2,1.5,0,0,0,0,-2.539993,2.539993,2,348,18,15,3,-3,0.5,-0.5,0,0,0,0,0,0,0,0,0,0,0,0
Josh Grispi,Andy Ogle,Andy Ogle,2013-02-16,0,1,0,0,2.8,1.5,7.619995,-7.619995,0,0,12.70001,-12.70001,19,791,19,15,4,-4,1.29999995231628,-1.29999995231628,0,0,1,0,0,0,1,-1,196,140,56,-56
Cole Miller,Andy Ogle,Cole Miller,2013-10-26,1,0,5,-5,1.909091,1.5,12.7,-12.7,0,0,10.16,-10.16,267,464,32,15,17,-17,0.409090876579285,-0.409090876579285,1,1,1,0,0,0,1,-1,196,252,-56,56
Maximo Blanco,Andy Ogle,Maximo Blanco,2014-05-31,1,0,5,-5,1.5,1.5,0,0,0,0,5.080002,-5.080002,147,345,20,15,5,-5,0,0,0,0,0,0,0,0,0,0,182,217,-35,35
Makwan Amirkhani,Andy Ogle,Makwan Amirkhani,2015-01-24,1,0,1,-1,1.888889,1.5,5.080002,-5.080002,0,0,7.62001,-7.62001,2,0,26,15,11,-11,0.388888835906982,-0.388888835906982,0,0,0,0,0,0,0,0,0,238,-238,238
Cole Miller,Andy Wang,Cole Miller,2007-06-23,1,0,-7,7,1.909091,0.875,17.78,-17.78,-10,10,15.42,-15.42,15,0,32,15,17,-17,1.03409087657928,-1.03409087657928,0,0,0,0,0,0,0,0,0,0,0,0
Mounir Lazzez,Ange Loosa,Mounir Lazzez,2022-04-16,1,0,5,-5,3.666667,3.333333,7.619995,-7.619995,0,0,5.079987,-5.079987,62,8,14,13,1,-1,0.333333492279053,-0.333333492279053,1,0,0,0,1,-1,0,0,640,0,640,-640
AJ Fletcher,Ange Loosa,Ange Loosa,2022-08-20,0,1,-4,4,3.333333,3.333333,0,0,0,0,-17.78001,17.78001,36,326,13,13,0,0,0,0,0,0,0,0,0,0,0,0,161,126,35,-35
Jessica Andrade,Angela Hill,Jessica Andrade,2017-02-04,1,0,-7,7,2,1.153846,-5.080002,5.080002,0,0,-5.080002,5.080002,95,6,36,28,8,-8,0.846153855323792,-0.846153855323792,2,0,1,0,2,-2,1,-1,147,0,147,-147
Cortney Casey,Angela Hill,Cortney Casey,2018-08-25,1,0,-2,2,1,1.153846,10.15999,-10.15999,10,-10,7.619995,-7.619995,101,23,20,28,-8,8,-0.153846144676208,0.153846144676208,0,0,0,0,0,0,0,0,133,567,-434,434
Jodie Esquibel,Angela Hill,Angela Hill,2019-04-27,0,1,-2,2,1,1.153846,-5.080002,5.080002,0,0,0,0,23,5,12,28,-16,16,-0.153846144676208,0.153846144676208,0,0,0,0,0,0,0,0,553,245,308,-308
Ariane Carnelossi,Angela Hill,Angela Hill,2019-09-21,0,1,-8,8,4.666667,1.153846,-2.540009,2.540009,0,0,-7.619995,7.619995,38,59,17,28,-11,11,3.51282036304474,-3.51282036304474,0,1,0,0,-1,1,0,0,0,147,-147,147
Hannah Cifers,Angela Hill,Angela Hill,2020-01-25,0,1,-8,8,1.428571,1.153846,-5.080002,5.080002,0,0,-5.080002,5.080002,0,186,17,28,-11,11,0.274725317955017,-0.274725317955017,2,2,0,0,0,0,0,0,161,126,35,-35
Claudia Gadelha,Angela Hill,Claudia Gadelha,2020-05-16,1,0,-4,4,3.6,1.153846,2.539993,-2.539993,0,0,-2.539993,2.539993,167,37,23,28,-5,5,2.44615375995636,-2.44615375995636,1,3,0,0,-2,2,0,0,315,112,203,-203
Loopy Godinez,Angela Hill,Angela Hill,2022-08-13,0,1,-9,9,3.666667,1.153846,-2.540009,2.540009,0,0,-7.619995,7.619995,17,36,14,28,-14,14,2.51282060146332,-2.51282060146332,2,0,0,0,2,-2,0,0,266,819,-553,553
Emily Ducote,Angela Hill,Angela Hill,2022-12-03,0,1,-9,9,1.5,1.153846,-2.540009,2.540009,0,0,-2.539993,2.539993,0,0,20,28,-8,8,0.346153855323792,-0.346153855323792,1,1,0,0,0,0,0,0,140,112,28,-28
Mackenzie Dern,Angela Hill,Mackenzie Dern,2023-05-20,1,0,-8,8,4.333333,1.153846,2.539993,-2.539993,0,0,-2.539993,2.539993,792,431,16,28,-12,12,3.17948734760284,-3.17948734760284,0,2,0,0,-2,2,0,0,231,168,63,-63
Amanda Cooper,Angela Magana,Amanda Cooper,2017-12-02,1,0,-8,8,0.6,1.222222,5.080002,-5.080002,0,0,-2.540009,2.540009,480,0,8,20,-12,12,-0.622222185134888,0.622222185134888,1,0,0,0,1,-1,0,0,378,0,378,-378
Rodrigo Damm,Anistavio Medeiros,Rodrigo Damm,2012-06-23,1,0,8,-8,1.444444,1.9,2.539993,-2.539993,10,-10,10.34,-10.34,33,0,22,29,-7,7,-0.455555558204651,0.455555558204651,0,0,0,0,0,0,0,0,0,0,0,0
Germaine de Randamie,Anna Elmose,Germaine de Randamie,2016-05-08,1,0,1,-1,2.5,1.5,15.23999,-15.23999,20,-20,17.34,-17.34,34,114,14,5,9,-9,1,-1,1,0,1,0,1,-1,1,-1,421,0,421,-421
Amanda Cooper,Anna Elmose,Amanda Cooper,2016-11-19,1,0,-7,7,0.6,1.5,0,0,0,0,-0.4400024,0.4400024,183,134,8,5,3,-3,-0.899999976158142,0.899999976158142,0,0,0,1,0,0,-1,1,134,195,-61,61
Thiago Alves,Ansar Chalangov,Thiago Alves,2005-11-19,1,0,-4,4,1.533333,2.8,0,0,0,0,-16.2,16.2,61,44,38,19,19,-19,-1.26666665077209,1.26666665077209,0,0,0,0,0,0,0,0,47,0,47,-47
Thomas Almeida,Anthony Birchak,Thomas Almeida,2015-11-07,1,0,-5,5,4.4,2,-2.540009,2.540009,10,-10,2.540009,-2.540009,5,22,27,24,3,-3,2.40000009536743,-2.40000009536743,3,0,0,0,3,-3,0,0,119,0,119,-119
Todd Duffee,Anthony Hamilton,Todd Duffee,2014-12-06,1,0,-5,5,3,1.666667,-5.080002,5.080002,0,0,5.080002,-5.080002,2,0,12,24,-12,12,1.33333337306976,-1.33333337306976,0,0,1,0,0,0,1,-1,1652,0,1652,-1652
Shamil Abdurakhimov,Anthony Hamilton,Shamil Abdurakhimov,2016-02-21,1,0,-1,1,2.5,1.666667,-5.080002,5.080002,-25,25,0,0,4,15,28,24,4,-4,0.833333373069763,-0.833333373069763,0,0,1,1,0,0,0,0,323,442,-119,119
Damian Grabowski,Anthony Hamilton,Anthony Hamilton,2016-07-30,0,1,0,0,4,1.666667,-10.16,10.16,-19,19,-2.539993,2.539993,0,2,25,24,1,-1,2.33333337306976,-2.33333337306976,0,0,1,1,0,0,0,0,175,160,15,-15
Marcel Fortuna,Anthony Hamilton,Marcel Fortuna,2017-02-04,1,0,-5,5,3,1.666667,-10.16,10.16,-55,55,-5.079987,5.079987,1,25,12,24,-12,12,1.33333337306976,-1.33333337306976,0,1,0,1,-1,1,-1,1,0,189,-189,189
Josh Fremd,Anthony Hernandez,Anthony Hernandez,2022-04-09,0,1,0,0,2.2,5.5,10.15999,-10.15999,0,0,2.539993,-2.539993,157,645,16,13,3,-3,-3.29999995231628,3.29999995231628,0,0,0,0,0,0,0,0,0,0,0,0
Marc-Andre Barriault,Anthony Hernandez,Anthony Hernandez,2022-09-17,0,1,4,-4,2.666667,5.5,2.539993,-2.539993,0,0,-2.539993,2.539993,25,525,22,13,9,-9,-2.83333325386047,2.83333325386047,1,1,1,0,0,0,1,-1,147,161,-14,14
Christian Aguilera,Anthony Ivy,Christian Aguilera,2020-06-13,1,0,-2,2,1.75,2,-12.70001,12.70001,-15,15,-5.080002,5.080002,0,0,22,12,10,-10,-0.25,0.25,0,0,0,0,0,0,0,0,0,0,0,0
Bryan Barberena,Anthony Ivy,Bryan Barberena,2020-09-12,1,0,1,-1,1.636364,2,-5.080002,5.080002,-15,15,-5.080002,5.080002,117,350,29,12,17,-17,-0.363636374473572,0.363636374473572,0,0,2,1,0,0,1,-1,448,91,357,-357
Rich Clementi,Anthony Johnson,Rich Clementi,2007-09-22,1,0,8,-8,1.956522,3.666667,-12.70001,12.70001,-50,50,-15.23999,15.23999,162,143,68,28,40,-40,-1.71014499664307,1.71014499664307,1,0,0,0,1,-1,0,0,240,0,240,-240
Kevin Burns,Anthony Johnson,Kevin Burns,2008-07-19,1,0,4,-4,1.714286,3.666667,-10.16,10.16,-35,35,-10.15999,10.15999,17,407,19,28,-9,9,-1.95238101482391,1.95238101482391,1,0,0,0,1,-1,0,0,42,301,-259,259
Kevin Burns,Anthony Johnson,Anthony Johnson,2008-12-13,0,1,4,-4,1.714286,3.666667,-10.16,10.16,-35,35,-10.15999,10.15999,1,449,19,28,-9,9,-1.95238101482391,1.95238101482391,2,0,0,1,2,-2,-1,1,147,147,0,0
Luigi Fioravanti,Anthony Johnson,Anthony Johnson,2009-02-07,0,1,4,-4,1.733333,3.666667,-15.24001,15.24001,-35,35,-20.31999,20.31999,18,9,41,28,13,-13,-1.93333339691162,1.93333339691162,0,1,1,1,-1,1,0,0,231,56,175,-175
Dan Hardy,Anthony Johnson,Anthony Johnson,2011-03-26,0,1,1,-1,2.5,3.666667,-5.080002,5.080002,-35,35,-10.15999,10.15999,0,765,35,28,7,-7,-1.16666674613953,1.16666674613953,0,2,0,1,-2,2,-1,1,364,777,-413,413
Charlie Brenneman,Anthony Johnson,Anthony Johnson,2011-10-01,0,1,3,-3,2.375,3.666667,-10.16,10.16,-50,50,-20.31999,20.31999,0,134,27,28,-1,1,-1.29166674613953,1.29166674613953,1,3,1,1,-2,2,0,0,97,189,-92,92
Vitor Belfort,Anthony Johnson,Vitor Belfort,2012-01-14,1,0,7,-7,1.857143,3.666667,-5.080002,5.080002,-20,20,-10.15999,10.15999,72,132,40,28,12,-12,-1.80952394008636,1.80952394008636,0,4,3,1,-4,4,2,-2,343,105,238,-238
Phil Davis,Anthony Johnson,Anthony Johnson,2014-04-26,0,1,-1,1,4.25,3.666667,0,0,0,0,2.540009,-2.540009,32,15,21,28,-7,7,0.583333253860474,-0.583333253860474,3,0,0,1,3,-3,-1,1,266,833,-567,567
Alexander Gustafsson,Anthony Johnson,Anthony Johnson,2015-01-24,0,1,-2,2,2.25,3.666667,7.619995,-7.619995,0,0,2.540009,-2.540009,0,32,26,28,-2,2,-1.41666674613953,1.41666674613953,1,1,0,1,0,0,-1,1,322,273,49,-49
Daniel Cormier,Anthony Johnson,Daniel Cormier,2015-05-23,1,0,5,-5,7.333333,3.666667,-7.62001,7.62001,30,-30,-15.23999,15.23999,557,43,25,28,-3,3,3.66666674613953,-3.66666674613953,0,2,0,1,-2,2,-1,1,140,119,21,-21
Ryan Bader,Anthony Johnson,Anthony Johnson,2016-01-30,0,1,1,-1,4.6,3.666667,0,0,0,0,-10.15999,10.15999,0,73,28,28,0,0,0.933333158493042,-0.933333158493042,5,0,2,1,5,-5,1,-1,119,252,-133,133
Daniel Cormier,Anthony Johnson,Daniel Cormier,2017-04-08,1,0,5,-5,7.333333,3.666667,-7.62001,7.62001,30,-30,-15.23999,15.23999,253,158,25,28,-3,3,3.66666674613953,-3.66666674613953,3,1,0,1,2,-2,-1,1,273,434,-161,161
Jason High,Anthony Lapsley,Jason High,2013-11-16,1,0,-1,1,3.5,3.285714,-2.539993,2.539993,-15,15,7.419998,-7.419998,512,317,27,30,-3,3,0.214285612106323,-0.214285612106323,0,0,0,0,0,0,0,0,161,0,161,-161
He-Man Gipson,Anthony Macias,Anthony Macias,1995-07-14,0,1,,,0.5,1.444444,,,,,-5,5,0,0,3,44,-41,41,-0.944444417953491,0.944444417953491,0,0,0,0,0,0,0,0,0,0,0,0
Edson Barboza,Anthony Njokuani,Edson Barboza,2011-03-19,1,0,-6,6,2.090909,1.333333,-5.080002,5.080002,-10,10,0,0,45,28,34,28,6,-6,0.757575631141663,-0.757575631141663,1,0,0,0,1,-1,0,0,119,0,119,-119
Danny Castillo,Anthony Njokuani,Danny Castillo,2011-12-30,1,0,1,-1,1.7,1.333333,-10.16,10.16,0,0,-10.16,10.16,484,19,27,28,-1,1,0.366666674613953,-0.366666674613953,0,0,0,0,0,0,0,0,138,286,-148,148
John Makdessi,Anthony Njokuani,Anthony Njokuani,2012-04-21,0,1,-6,6,2,1.333333,-12.7,12.7,0,0,-17.78,17.78,0,0,27,28,-1,1,0.666666626930237,-0.666666626930237,1,0,0,0,1,-1,0,0,357,113,244,-244
Rafael Dos Anjos,Anthony Njokuani,Rafael Dos Anjos,2012-07-11,1,0,-5,5,2.133333,1.333333,-12.7,12.7,15,-15,-12.7,12.7,405,0,47,28,19,-19,0.800000071525574,-0.800000071525574,1,1,1,0,0,0,1,-1,57,81,-24,24
Roger Bowling,Anthony Njokuani,Anthony Njokuani,2013-04-20,0,1,-3,3,2,1.333333,-10.16,10.16,0,0,-17.78,17.78,54,2,18,28,-10,10,0.666666626930237,-0.666666626930237,0,0,0,0,0,0,0,0,0,283,-283,283
Daron Cruickshank,Anthony Njokuani,Daron Cruickshank,2014-10-04,1,0,-5,5,1.8,1.333333,-12.7,12.7,0,0,-7.619995,7.619995,176,0,28,28,0,0,0.466666579246521,-0.466666579246521,0,1,0,0,-1,1,0,0,70,532,-462,462
Jeff Monson,Anthony Perosh,Jeff Monson,2006-07-08,1,0,2,-2,2.307692,1.5,-15.24001,15.24001,42,-42,-2.539993,2.539993,64,9,86,25,61,-61,0.807692289352417,-0.807692289352417,0,0,1,0,0,0,1,-1,1639,0,1639,-1639
Mirko Filipovic,Anthony Perosh,Mirko Filipovic,2010-02-20,1,0,-2,2,3.181818,1.5,-2.539993,2.539993,25,-25,-5.080002,5.080002,211,39,46,25,21,-21,1.68181824684143,-1.68181824684143,0,0,1,1,0,0,0,0,896,1323,-427,427
Tom Blackledge,Anthony Perosh,Anthony Perosh,2011-02-26,0,1,,,1.428571,1.5,,,0,0,2.5,-2.5,9,68,17,25,-8,8,-7.14285373687744e-02,7.14285373687744e-02,0,0,0,2,0,0,-2,2,0,371,-371,371
Cyrille Diabate,Anthony Perosh,Anthony Perosh,2011-11-05,0,1,-1,1,1.9,1.5,7.619995,-7.619995,0,0,15.24001,-15.24001,15,245,29,25,4,-4,0.399999976158142,-0.399999976158142,0,1,0,2,-1,1,-2,2,385,252,133,-133
Nick Penner,Anthony Perosh,Anthony Perosh,2012-03-02,0,1,-8,8,3.666667,1.5,2.539993,-2.539993,0,0,5.5,-5.5,10,148,14,25,-11,11,2.16666674613953,-2.16666674613953,0,2,0,2,-2,2,-2,2,0,118,-118,118
Ryan Jimmo,Anthony Perosh,Ryan Jimmo,2012-07-21,1,0,-9,9,3.8,1.5,-5.080002,5.080002,0,0,-5.080002,5.080002,2,0,24,25,-1,1,2.29999995231628,-2.29999995231628,0,3,0,2,-3,3,-2,2,0,141,-141,141
Vinny Magalhaes,Anthony Perosh,Anthony Perosh,2013-08-03,0,1,-11,11,1.555556,1.5,0,0,0,0,0,0,0,6,23,25,-2,2,5.55555820465088e-02,-5.55555820465088e-02,1,0,0,3,1,-1,-3,3,315,378,-63,63
Ryan Bader,Anthony Perosh,Ryan Bader,2013-12-06,1,0,-11,11,4.6,1.5,-2.539993,2.539993,0,0,-2.539993,2.539993,734,0,28,25,3,-3,3.09999990463257,-3.09999990463257,0,1,2,3,-1,1,-1,1,93,125,-32,32
Guto Inocente,Anthony Perosh,Anthony Perosh,2014-11-07,0,1,-14,14,1.75,1.5,0,0,0,0,2.5,-2.5,0,163,11,25,-14,14,0.25,-0.25,0,0,1,3,0,0,-2,2,124,336,-212,212
"Sean O'Connell",Anthony Perosh,"Sean O'Connell",2015-05-09,1,0,-11,11,1.888889,1.5,-5.080002,5.080002,0,0,-2.539993,2.539993,0,0,26,25,1,-1,0.388888835906982,-0.388888835906982,1,1,0,3,0,0,-3,3,111,183,-72,72
Clay Guida,Anthony Pettis,Clay Guida,2011-06-04,1,0,5,-5,1.9,2.4,-7.62001,7.62001,0,0,-5.080002,5.080002,617,41,58,34,24,-24,-0.50000011920929,0.50000011920929,0,0,0,0,0,0,0,0,714,0,714,-714
Joe Lauzon,Anthony Pettis,Anthony Pettis,2012-02-25,0,1,2,-2,1.75,2.4,0,0,0,0,-2.540009,2.540009,0,2,44,34,10,-10,-0.650000095367432,0.650000095367432,1,0,0,0,1,-1,0,0,244,266,-22,22
Donald Cerrone,Anthony Pettis,Anthony Pettis,2013-01-26,0,1,4,-4,2.117647,2.4,7.619995,-7.619995,0,0,2.539993,-2.539993,0,2,53,34,19,-19,-0.282352924346924,0.282352924346924,2,1,0,0,1,-1,0,0,168,336,-168,168
Benson Henderson,Anthony Pettis,Anthony Pettis,2013-08-31,0,1,3,-3,3.428571,2.4,-2.540009,2.540009,15,-15,-5.080002,5.080002,189,0,31,34,-3,3,1.02857136726379,-1.02857136726379,2,2,0,0,0,0,0,0,133,217,-84,84
Gilbert Melendez,Anthony Pettis,Anthony Pettis,2014-12-06,0,1,5,-5,2.75,2.4,-2.540009,2.540009,-10,10,2.539993,-2.539993,261,3,30,34,-4,4,0.349999904632568,-0.349999904632568,1,3,0,0,-2,2,0,0,413,462,-49,49
Rafael Dos Anjos,Anthony Pettis,Rafael Dos Anjos,2015-03-14,1,0,2,-2,2.133333,2.4,-5.080002,5.080002,15,-15,-5.080002,5.080002,882,52,47,34,13,-13,-0.266666650772095,0.266666650772095,2,4,1,0,-2,2,1,-1,203,98,105,-105
Eddie Alvarez,Anthony Pettis,Eddie Alvarez,2016-01-17,1,0,4,-4,4.833333,2.4,-2.540009,2.540009,0,0,-7.62001,7.62001,458,0,35,34,1,-1,2.43333339691162,-2.43333339691162,1,0,0,0,1,-1,0,0,218,309,-91,91
Edson Barboza,Anthony Pettis,Edson Barboza,2016-04-23,1,0,1,-1,2.090909,2.4,2.539993,-2.539993,-10,10,7.619995,-7.619995,0,0,34,34,0,0,-0.309091091156006,0.309091091156006,0,0,1,0,0,0,1,-1,134,97,37,-37
Charles Oliveira,Anthony Pettis,Anthony Pettis,2016-08-27,0,1,-3,3,3.777778,2.4,0,0,0,0,5.080002,-5.080002,297,191,43,34,9,-9,1.37777757644653,-1.37777757644653,1,0,1,0,1,-1,1,-1,624,126,498,-498
Max Holloway,Anthony Pettis,Max Holloway,2016-12-10,1,0,-4,4,3.571429,2.4,2.539993,-2.539993,-10,10,-7.62001,7.62001,36,84,32,34,-2,2,1.17142844200134,-1.17142844200134,5,1,0,0,4,-4,0,0,189,105,84,-84
Jim Miller,Anthony Pettis,Anthony Pettis,2017-07-08,0,1,3,-3,2.117647,2.4,-5.080002,5.080002,0,0,-2.540009,2.540009,110,217,53,34,19,-19,-0.282352924346924,0.282352924346924,0,0,0,1,0,0,-1,1,147,210,-63,63
Michael Chiesa,Anthony Pettis,Anthony Pettis,2018-07-07,0,1,-1,1,2.571429,2.4,7.619995,-7.619995,15,-15,7.619995,-7.619995,158,64,25,34,-9,9,0.171428442001343,-0.171428442001343,0,1,1,1,-1,1,0,0,377,364,13,-13
Tony Ferguson,Anthony Pettis,Tony Ferguson,2018-10-06,1,0,3,-3,2.888889,2.4,2.539993,-2.539993,0,0,10.15999,-10.15999,4,71,35,34,1,-1,0.488888740539551,-0.488888740539551,7,2,0,1,5,-5,-1,1,364,91,273,-273
Nate Diaz,Anthony Pettis,Nate Diaz,2019-08-17,1,0,2,-2,1.692308,2.4,5.080002,-5.080002,15,-15,10.15999,-10.15999,358,109,35,34,1,-1,-0.707692384719849,0.707692384719849,0,0,1,2,0,0,-1,1,1092,315,777,-777
Diego Ferreira,Anthony Pettis,Diego Ferreira,2020-01-18,1,0,3,-3,3.6,2.4,-2.540009,2.540009,0,0,5.080002,-5.080002,234,0,23,34,-11,11,1.19999980926514,-1.19999980926514,4,0,1,2,4,-4,-1,1,133,154,-21,21
Donald Cerrone,Anthony Pettis,Anthony Pettis,2020-05-09,0,1,4,-4,2.117647,2.4,7.619995,-7.619995,0,0,2.539993,-2.539993,106,0,53,34,19,-19,-0.282352924346924,0.282352924346924,0,0,7,2,0,0,5,-5,112,112,0,0
Alex Morono,Anthony Pettis,Anthony Pettis,2020-12-19,0,1,-3,3,2.875,2.4,2.539993,-2.539993,15,-15,0,0,150,272,31,34,-3,3,0.474999904632568,-0.474999904632568,0,1,1,2,-1,1,-1,1,315,224,91,-91
Rashid Magomedov,Anthony Rocco Martin,Rashid Magomedov,2014-02-01,1,0,5,-5,10,2.833333,-7.62001,7.62001,-15,15,-7.619995,7.619995,128,362,22,23,-1,1,7.16666674613953,-7.16666674613953,0,0,0,0,0,0,0,0,0,0,0,0
Beneil Dariush,Anthony Rocco Martin,Beneil Dariush,2014-08-23,1,0,1,-1,4.4,2.833333,-5.080002,5.080002,-15,15,-2.539993,2.539993,71,140,27,23,4,-4,1.56666684150696,-1.56666684150696,0,0,1,0,0,0,1,-1,134,203,-69,69
Fabricio Camoes,Anthony Rocco Martin,Anthony Rocco Martin,2014-10-25,0,1,11,-11,1.555556,2.833333,-5.080002,5.080002,-15,15,-5.080002,5.080002,3,177,23,23,0,0,-1.27777767181396,1.27777767181396,0,0,0,0,0,0,0,0,301,63,238,-238
Felipe Olivieri,Anthony Rocco Martin,Anthony Rocco Martin,2016-01-30,0,1,4,-4,2.8,2.833333,-7.62001,7.62001,-15,15,-7.419998,7.419998,19,241,19,23,-4,4,-3.33333015441895e-02,3.33333015441895e-02,0,1,0,0,-1,1,0,0,0,462,-462,462
Johnny Case,Anthony Rocco Martin,Anthony Rocco Martin,2017-06-25,0,1,0,0,3.666667,2.833333,-5.080002,5.080002,-15,15,-2.539993,2.539993,52,0,28,23,5,-5,0.833333492279053,-0.833333492279053,0,2,0,0,-2,2,0,0,463,512,-49,49
Olivier Aubin-Mercier,Anthony Rocco Martin,Olivier Aubin-Mercier,2017-09-16,1,0,1,-1,2.2,2.833333,-7.62001,7.62001,-15,15,-7.619995,7.619995,304,311,16,23,-7,7,-0.633333206176758,0.633333206176758,2,3,0,0,-1,1,0,0,280,83,197,-197
Keita Nakamura,Anthony Rocco Martin,Anthony Rocco Martin,2018-04-21,0,1,5,-5,3.4,2.833333,-2.540009,2.540009,0,0,0,0,98,32,44,23,21,-21,0.566666841506958,-0.566666841506958,0,0,0,0,0,0,0,0,567,217,350,-350
Ryan LaFlare,Anthony Rocco Martin,Anthony Rocco Martin,2018-10-06,0,1,7,-7,4.666667,2.833333,2.539993,-2.539993,0,0,2.540009,-2.540009,21,215,17,23,-6,6,1.83333325386047,-1.83333325386047,0,1,1,0,-1,1,1,-1,441,168,273,-273
Jake Matthews,Anthony Rocco Martin,Anthony Rocco Martin,2018-12-01,0,1,-4,4,3.166667,2.833333,-2.540009,2.540009,0,0,0,0,38,70,25,23,2,-2,0.333333492279053,-0.333333492279053,1,2,0,0,-1,1,0,0,378,56,322,-322
Sergio Moraes,Anthony Rocco Martin,Anthony Rocco Martin,2019-03-09,0,1,7,-7,2.333333,2.833333,0,0,0,0,-2.539993,2.539993,87,132,20,23,-3,3,-0.5,0.5,1,3,1,0,-2,2,1,-1,168,98,70,-70
Demian Maia,Anthony Rocco Martin,Demian Maia,2019-06-29,1,0,12,-12,2.545455,2.833333,2.539993,-2.539993,0,0,-2.539993,2.539993,363,71,39,23,16,-16,-0.287878751754761,0.287878751754761,0,4,1,0,-4,4,1,-1,406,112,294,-294
Ramazan Emeev,Anthony Rocco Martin,Anthony Rocco Martin,2019-11-09,0,1,3,-3,3.333333,2.833333,-5.080002,5.080002,0,0,7.619995,-7.619995,164,11,26,23,3,-3,0.5,-0.5,2,0,0,0,2,-2,0,0,420,133,287,-287
Neil Magny,Anthony Rocco Martin,Neil Magny,2020-06-06,1,0,2,-2,2.333333,2.833333,7.619995,-7.619995,0,0,17.78,-17.78,139,297,40,23,17,-17,-0.5,0.5,0,1,1,0,-1,1,1,-1,567,210,357,-357
Antonio Braga Neto,Anthony Smith,Antonio Braga Neto,2013-06-08,1,0,1,-1,3,2.055556,-2.539993,2.539993,-20,20,2.540009,-2.540009,27,4,12,55,-43,43,0.944444417953491,-0.944444417953491,0,0,0,0,0,0,0,0,0,0,0,0
Leonardo Guimaraes,Anthony Smith,Anthony Smith,2016-02-21,0,1,6,-6,2.2,2.055556,-10.15999,10.15999,-20,20,-7.039993,7.039993,215,237,16,55,-39,39,0.144444465637207,-0.144444465637207,0,0,0,0,0,0,0,0,0,988,-988,988
Cezar Ferreira,Anthony Smith,Cezar Ferreira,2016-07-08,1,0,4,-4,1.625,2.055556,-7.619995,7.619995,-20,20,5.080002,-5.080002,520,3,21,55,-34,34,-0.430555582046509,0.430555582046509,0,1,1,0,-1,1,1,-1,362,138,224,-224
Elvis Mutapcic,Anthony Smith,Anthony Smith,2016-12-03,0,1,2,-2,2.5,2.055556,-10.15999,10.15999,-20,20,-10.15999,10.15999,258,3,21,55,-34,34,0.444444417953491,-0.444444417953491,0,0,0,0,0,0,0,0,0,148,-148,148
Andrew Sanchez,Anthony Smith,Anthony Smith,2017-04-15,0,1,1,-1,1.857143,2.055556,-7.619995,7.619995,-20,20,-5.079987,5.079987,274,67,20,55,-35,35,-0.198412775993347,0.198412775993347,1,1,0,0,0,0,0,0,127,133,-6,6
Hector Lombard,Anthony Smith,Anthony Smith,2017-09-16,0,1,10,-10,3.4,2.055556,-17.78,17.78,-20,20,-12.7,12.7,96,3,44,55,-11,11,1.34444451332092,-1.34444451332092,0,2,1,0,-2,2,1,-1,546,154,392,-392
Thiago Santos,Anthony Smith,Thiago Santos,2018-02-03,1,0,5,-5,2,2.055556,-5.079987,5.079987,0,0,0,0,199,50,33,55,-22,22,-5.55555820465088e-02,5.55555820465088e-02,0,3,0,0,-3,3,0,0,497,140,357,-357
Rashad Evans,Anthony Smith,Anthony Smith,2018-06-09,0,1,9,-9,2.375,2.055556,-10.15999,10.15999,0,0,-2.539993,2.539993,15,4,27,55,-28,28,0.319444417953491,-0.319444417953491,0,0,2,1,0,0,1,-1,462,126,336,-336
Mauricio Rua,Anthony Smith,Anthony Smith,2018-07-22,0,1,7,-7,1.928571,2.055556,-7.619995,7.619995,0,0,0,0,0,1,41,55,-14,14,-0.126984119415283,0.126984119415283,1,1,1,1,0,0,0,0,498,43,455,-455
Volkan Oezdemir,Anthony Smith,Anthony Smith,2018-10-27,0,1,-1,1,2.714286,2.055556,-5.079987,5.079987,0,0,-2.539993,2.539993,296,89,26,55,-29,29,0.658730030059814,-0.658730030059814,1,2,0,1,-1,1,-1,1,630,97,533,-533
Jon Jones,Anthony Smith,Jon Jones,2019-03-02,1,0,1,-1,27,2.055556,0,0,43,-43,20.32001,-20.32001,779,0,28,55,-27,27,24.9444444179535,-24.9444444179535,8,3,0,1,5,-5,-1,1,1043,126,917,-917
Alexander Gustafsson,Anthony Smith,Anthony Smith,2019-06-01,0,1,2,-2,2.25,2.055556,2.540009,-2.540009,0,0,7.62001,-7.62001,39,84,26,55,-29,29,0.194444417953491,-0.194444417953491,0,0,2,1,0,0,1,-1,154,91,63,-63
Aleksandar Rakic,Anthony Smith,Aleksandar Rakic,2020-08-29,1,0,-4,4,4.666667,2.055556,0,0,0,0,5.080002,-5.080002,734,36,17,55,-38,38,2.61111092567444,-2.61111092567444,0,1,0,1,-1,1,-1,1,0,455,-455,455
Devin Clark,Anthony Smith,Anthony Smith,2020-11-28,0,1,-2,2,1.75,2.055556,-10.15999,10.15999,0,0,-2.539993,2.539993,67,78,22,55,-33,33,-0.305555582046509,0.305555582046509,2,0,2,1,2,-2,1,-1,175,91,84,-84
Jimmy Crute,Anthony Smith,Anthony Smith,2021-04-24,0,1,-7,7,3,2.055556,-5.079987,5.079987,0,0,-5.079987,5.079987,57,2,16,55,-39,39,0.944444417953491,-0.944444417953491,1,1,0,1,0,0,-1,1,427,147,280,-280
Magomed Ankalaev,Anthony Smith,Magomed Ankalaev,2022-07-30,1,0,-4,4,18,2.055556,-2.539993,2.539993,0,0,-2.539993,2.539993,146,51,19,55,-36,36,15.9444444179535,-15.9444444179535,7,2,0,1,5,-5,-1,1,140,462,-322,322
Pat Healy,Anthony Torres,Anthony Torres,2006-08-17,0,1,-5,5,1.478261,1.666667,10.16,-10.16,-15,15,7.880005,-7.880005,15,67,57,8,49,-49,-0.188405752182007,0.188405752182007,0,0,0,0,0,0,0,0,0,0,0,0
Jess Liaudin,Anthony Torres,Jess Liaudin,2007-09-08,1,0,,,1.818182,1.666667,2.539993,-2.539993,0,0,7.880005,-7.880005,58,46,31,8,23,-23,0.151515245437622,-0.151515245437622,1,1,0,0,0,0,0,0,140,387,-247,247
Mitch Clarke,Anton Kuivanen,Anton Kuivanen,2012-07-21,0,1,-2,2,2.2,2.4,5.080002,-5.080002,0,0,2.539993,-2.539993,266,447,16,34,-18,18,-0.200000047683716,0.200000047683716,0,0,0,0,0,0,0,0,0,0,0,0
Michael Chiesa,Anton Kuivanen,Michael Chiesa,2013-02-23,1,0,-3,3,2.571429,2.4,12.7,-12.7,15,-15,7.619995,-7.619995,128,51,25,34,-9,9,0.171428442001343,-0.171428442001343,1,1,0,0,0,0,0,0,267,217,50,-50
Jailton Almeida,Anton Turkalj,Jailton Almeida,2022-09-10,1,0,5,-5,9.5,2.666667,-2.539993,2.539993,0,0,2.540009,-2.540009,254,0,21,11,10,-10,6.83333325386047,-6.83333325386047,2,0,0,0,2,-2,0,0,112,0,112,-112
Vitor Petrino,Anton Turkalj,Vitor Petrino,2023-03-11,1,0,-1,1,9,2.666667,-5.079987,5.079987,0,0,-2.539993,2.539993,373,280,9,11,-2,2,6.33333325386047,-6.33333325386047,0,0,0,0,0,0,0,0,0,182,-182,182
Tyson Pedro,Anton Turkalj,Tyson Pedro,2023-09-09,1,0,4,-4,2.5,2.666667,-2.539993,2.539993,0,0,2.540009,-2.540009,3,0,14,11,3,-3,-0.166666746139526,0.166666746139526,1,0,1,0,1,-1,1,-1,504,182,322,-322
James Moontasri,Anton Zafir,James Moontasri,2015-11-14,1,0,-1,1,1.8,2.333333,-2.539993,2.539993,0,0,-2.660004,2.660004,3,170,14,10,4,-4,-0.533333301544189,0.533333301544189,1,0,0,0,1,-1,0,0,273,0,273,-273
Li Jingliang,Anton Zafir,Li Jingliang,2016-07-08,1,0,-1,1,2.375,2.333333,2.540009,-2.540009,0,0,-2.660004,2.660004,20,81,27,10,17,-17,4.16667461395264e-02,-4.16667461395264e-02,0,0,0,1,0,0,-1,1,286,237,49,-49
Pat Barry,Antoni Hardonk,Pat Barry,2009-10-24,1,0,-3,3,1.142857,1.333333,-12.7,12.7,-10,10,-10.15999,10.15999,69,0,15,14,1,-1,-0.190476179122925,0.190476179122925,0,0,0,0,0,0,0,0,154,0,154,-154
Roxanne Modafferi,Antonina Shevchenko,Roxanne Modafferi,2019-04-20,1,0,2,-2,1.190476,2.5,-2.540009,2.540009,0,0,5.080002,-5.080002,540,50,46,14,32,-32,-1.30952382087708,1.30952382087708,0,0,0,0,0,0,0,0,505,0,505,-505
Lucie Pudilova,Antonina Shevchenko,Antonina Shevchenko,2019-08-03,0,1,-9,9,1.75,2.5,0,0,10,-10,0,0,137,114,22,14,8,-8,-0.75,0.75,1,0,0,0,1,-1,0,0,777,105,672,-672
Katlyn Chookagian,Antonina Shevchenko,Katlyn Chookagian,2020-05-30,1,0,-4,4,3.6,2.5,2.539993,-2.539993,0,0,2.540009,-2.540009,636,0,23,14,9,-9,1.09999990463257,-1.09999990463257,0,1,1,0,-1,1,1,-1,112,301,-189,189
Ariane Lipski,Antonina Shevchenko,Antonina Shevchenko,2020-11-21,0,1,-10,10,2,2.5,-5.080002,5.080002,0,0,0,0,28,459,24,14,10,-10,-0.5,0.5,0,0,0,0,0,0,0,0,518,175,343,-343
Andrea Lee,Antonina Shevchenko,Andrea Lee,2021-05-15,1,0,-4,4,1.625,2.5,-5.080002,5.080002,0,0,5.080002,-5.080002,131,238,21,14,7,-7,-0.875,0.875,0,1,0,0,-1,1,0,0,245,175,70,-70
"Casey O'Neill",Antonina Shevchenko,"Casey O'Neill",2021-10-02,1,0,-13,13,9,2.5,-5.080002,5.080002,0,0,5.080002,-5.080002,339,72,10,14,-4,4,6.5,-6.5,1,0,0,0,1,-1,0,0,105,140,-35,35
Cortney Casey,Antonina Shevchenko,Antonina Shevchenko,2022-07-09,0,1,-2,2,1,2.5,-2.540009,2.540009,0,0,0,0,188,110,20,14,6,-6,-1.5,1.5,1,0,0,1,1,-1,-1,1,238,280,-42,42
Tim Boetsch,Antonio Carlos Junior,Antonio Carlos Junior,2018-04-14,0,1,9,-9,1.615385,2.2,-5.080002,5.080002,0,0,-12.7,12.7,5,90,34,16,18,-18,-0.584615468978882,0.584615468978882,1,0,4,0,1,-1,4,-4,293,0,293,-293
Felipe Arantes,Antonio Carvalho,Felipe Arantes,2012-01-14,1,0,-9,9,1.8,2.5,-2.539993,2.539993,-10,10,7.619995,-7.619995,167,138,28,21,7,-7,-0.700000047683716,0.700000047683716,0,0,0,0,0,0,0,0,0,0,0,0
Scott Askham,Antonio Dos Santos,Scott Askham,2015-06-20,1,0,1,-1,3.5,1.5,12.7,-12.7,0,0,10.5,-10.5,5,76,18,10,8,-8,2,-2,0,0,0,0,0,0,0,0,259,0,259,-259
Heath Herring,Antonio Rodrigo Nogueira,Antonio Rodrigo Nogueira,2007-07-07,0,1,-2,2,1.75,3.4,2.539993,-2.539993,10,-10,2.539993,-2.539993,102,221,44,44,0,0,-1.65000009536743,1.65000009536743,1,0,0,0,1,-1,0,0,91,0,91,-91
Frank Mir,Antonio Rodrigo Nogueira,Frank Mir,2008-12-27,1,0,-3,3,1.636364,3.4,0,0,24,-24,5.080002,-5.080002,41,0,29,44,-15,15,-1.763636469841,1.763636469841,0,1,1,0,-1,1,1,-1,770,539,231,-231
Randy Couture,Antonio Rodrigo Nogueira,Antonio Rodrigo Nogueira,2009-08-29,0,1,13,-13,1.727273,3.4,-5.080002,5.080002,-35,35,-5.080002,5.080002,207,335,30,44,-14,14,-1.67272734642029,1.67272734642029,0,0,4,1,0,0,3,-3,287,245,42,-42
Frank Mir,Antonio Rodrigo Nogueira,Frank Mir,2011-12-10,1,0,-3,3,1.636364,3.4,0,0,24,-24,5.080002,-5.080002,73,110,29,44,-15,15,-1.763636469841,1.763636469841,2,1,1,1,1,-1,0,0,196,833,-637,637
Dave Herman,Antonio Rodrigo Nogueira,Antonio Rodrigo Nogueira,2012-10-13,0,1,-8,8,3.666667,3.4,2.539993,-2.539993,2,-2,0,0,62,245,28,44,-16,16,0.266666650772095,-0.266666650772095,0,0,2,1,0,0,1,-1,140,308,-168,168
Roy Nelson,Antonio Rodrigo Nogueira,Roy Nelson,2014-04-11,1,0,0,0,1.571429,3.4,-7.619995,7.619995,23,-23,-10.16,10.16,10,0,36,44,-8,8,-1.82857155799866,1.82857155799866,0,1,0,1,-1,1,-1,1,797,545,252,-252
Travis Browne,Antonio Silva,Antonio Silva,2012-10-05,0,1,-3,3,2.571429,1.583333,5.080002,-5.080002,-9,9,-7.619995,7.619995,0,53,25,31,-6,6,0.988095164299011,-0.988095164299011,3,0,0,0,3,-3,0,0,167,0,167,-167
Alistair Overeem,Antonio Silva,Antonio Silva,2013-02-02,0,1,-1,1,2.473684,1.583333,0,0,1,-1,-5.080002,5.080002,384,0,66,31,35,-35,0.890350937843323,-0.890350937843323,0,1,0,0,-1,1,0,0,0,120,-120,120
Andrei Arlovski,Antonio Silva,Andrei Arlovski,2014-09-13,1,0,1,-1,1.545455,1.583333,-2.539993,2.539993,-24,24,-12.7,12.7,3,0,56,31,25,-25,-3.78788709640503e-02,3.78788709640503e-02,4,2,3,0,2,-2,3,-3,91,588,-497,497
Frank Mir,Antonio Silva,Frank Mir,2015-02-22,1,0,0,0,1.636364,1.583333,-2.539993,2.539993,0,0,-7.619995,7.619995,6,0,29,31,-2,2,5.3030252456665e-02,-5.3030252456665e-02,0,0,1,1,0,0,0,0,386,162,224,-224
Soa Palelei,Antonio Silva,Antonio Silva,2015-08-01,0,1,3,-3,4.4,1.583333,0,0,1,-1,-2.539993,2.539993,159,90,27,31,-4,4,2.81666672229767,-2.81666672229767,0,0,1,2,0,0,-1,1,399,160,239,-239
Mark Hunt,Antonio Silva,Mark Hunt,2015-11-14,1,0,5,-5,0.9285714,1.583333,-15.23999,15.23999,1,-1,-25.39999,25.39999,2,0,27,31,-4,4,-0.654761970043182,0.654761970043182,0,1,2,2,-1,1,0,0,189,105,84,-84
Roy Nelson,Antonio Silva,Roy Nelson,2016-09-24,1,0,3,-3,1.571429,1.583333,-10.15999,10.15999,-1,1,-22.86,22.86,92,19,36,31,5,-5,-1.19048357009888e-02,1.19048357009888e-02,1,0,0,3,1,-1,-3,3,231,315,-84,84
Albert Cheng,Anying Wang,Anying Wang,2014-03-01,0,1,7,-7,1.75,2,-2.540009,2.540009,0,0,-4,4,6,32,11,3,8,-8,-0.25,0.25,0,0,0,0,0,0,0,0,0,0,0,0
Colby Covington,Anying Wang,Colby Covington,2014-08-23,1,0,3,-3,5.666667,2,-2.540009,2.540009,0,0,-2.119995,2.119995,231,0,20,3,17,-17,3.66666650772095,-3.66666650772095,0,1,0,0,-1,1,0,0,0,175,-175,175
Isabela de Padua,Ariane Lipski,Ariane Lipski,2019-11-16,0,1,3,-3,2.5,2,-7.619995,7.619995,0,0,-7.619995,7.619995,279,528,7,24,-17,17,0.5,-0.5,0,0,0,0,0,0,0,0,0,0,0,0
Luana Carolina,Ariane Lipski,Ariane Lipski,2020-07-18,0,1,1,-1,2.25,2,0,0,0,0,5.080002,-5.080002,0,67,13,24,-11,11,0.25,-0.25,0,1,0,0,-1,1,0,0,0,245,-245,245
Montana De La Rosa,Ariane Lipski,Montana De La Rosa,2021-06-05,1,0,-1,1,1.5,2,2.539993,-2.539993,0,0,2.540009,-2.540009,412,0,20,24,-4,4,-0.5,0.5,1,2,0,0,-1,1,0,0,476,322,154,-154
Mandy Bohm,Ariane Lipski,Ariane Lipski,2021-09-18,0,1,5,-5,4,2,2.539993,-2.539993,0,0,10.16,-10.16,29,266,10,24,-14,14,2,-2,0,0,0,1,0,0,-1,1,0,105,-105,105
Priscila Cachoeira,Ariane Lipski,Priscila Cachoeira,2022-08-13,1,0,5,-5,2.4,2,2.539993,-2.539993,0,0,-5.079987,5.079987,11,0,17,24,-7,7,0.400000095367432,-0.400000095367432,1,1,0,1,0,0,-1,1,168,329,-161,161
JJ Aldrich,Ariane Lipski,Ariane Lipski,2023-03-11,0,1,1,-1,2,2,-2.539993,2.539993,0,0,0,0,76,19,18,24,-6,6,0,0,0,0,1,2,0,0,-1,1,280,210,70,-70
Melissa Gatto,Ariane Lipski,Ariane Lipski,2023-07-01,0,1,-2,2,4,2,-2.539993,2.539993,0,0,5.080002,-5.080002,177,47,10,24,-14,14,2,-2,1,1,0,2,0,0,-2,2,693,112,581,-581
Juan Adams,Arjan Bhullar,Arjan Bhullar,2019-05-04,0,1,-5,5,1.666667,9,10.16,-10.16,20,-20,12.7,-12.7,84,318,8,10,-2,2,-7.33333337306976,7.33333337306976,1,0,0,0,1,-1,0,0,140,0,140,-140
Islam Makhachev,Arman Tsarukyan,Islam Makhachev,2019-04-20,1,0,5,-5,24,6.666667,7.62001,-7.62001,0,0,-5.080002,5.080002,366,107,25,23,2,-2,17.3333334922791,-17.3333334922791,2,0,1,0,2,-2,1,-1,455,0,455,-455
Olivier Aubin-Mercier,Arman Tsarukyan,Arman Tsarukyan,2019-07-27,0,1,8,-8,2.2,6.666667,5.080002,-5.080002,0,0,-5.080002,5.080002,61,473,16,23,-7,7,-4.46666646003723,4.46666646003723,0,0,0,0,0,0,0,0,231,98,133,-133
Davi Ramos,Arman Tsarukyan,Arman Tsarukyan,2020-07-18,0,1,10,-10,2.5,6.666667,-2.539993,2.539993,0,0,-5.080002,5.080002,18,188,14,23,-9,9,-4.16666650772095,4.16666650772095,0,1,0,0,-1,1,0,0,0,357,-357,357
Matt Frevola,Arman Tsarukyan,Arman Tsarukyan,2021-01-23,0,1,6,-6,3.666667,6.666667,5.080002,-5.080002,0,0,-2.540009,2.540009,2,504,14,23,-9,9,-2.99999976158142,2.99999976158142,2,2,1,0,0,0,1,-1,469,189,280,-280
Christos Giagos,Arman Tsarukyan,Arman Tsarukyan,2021-09-18,0,1,7,-7,1.818182,6.666667,7.62001,-7.62001,0,0,-2.540009,2.540009,49,11,31,23,8,-8,-4.84848463535309,4.84848463535309,2,3,0,0,-1,1,0,0,126,238,-112,112
Joel Alvarez,Arman Tsarukyan,Arman Tsarukyan,2022-02-26,0,1,3,-3,6.666667,6.666667,20.32001,-20.32001,0,0,12.7,-12.7,0,368,23,23,0,0,0,0,4,4,0,0,0,0,0,0,105,161,-56,56
Mateusz Gamrot,Arman Tsarukyan,Mateusz Gamrot,2022-06-25,1,0,6,-6,11.5,6.666667,7.62001,-7.62001,0,0,-5.080002,5.080002,298,99,25,23,2,-2,4.83333349227905,-4.83333349227905,2,5,0,0,-3,3,0,0,343,119,224,-224
Damir Ismagulov,Arman Tsarukyan,Arman Tsarukyan,2022-12-17,0,1,5,-5,8,6.666667,7.62001,-7.62001,0,0,5.080002,-5.080002,6,565,27,23,4,-4,1.33333349227905,-1.33333349227905,2,0,0,0,2,-2,0,0,182,175,7,-7
Joaquim Silva,Arman Tsarukyan,Arman Tsarukyan,2023-06-17,0,1,8,-8,2.4,6.666667,2.540009,-2.540009,0,0,-7.62001,7.62001,0,541,17,23,-6,6,-4.26666641235352,4.26666641235352,0,1,0,0,-1,1,0,0,0,182,-182,182
Caio Borralho,Armen Petrosyan,Caio Borralho,2022-07-09,1,0,-2,2,14,4.5,-12.7,12.7,0,0,10.16,-10.16,609,79,15,11,4,-4,9.5,-9.5,1,0,0,0,1,-1,0,0,84,0,84,-84
AJ Dobson,Armen Petrosyan,Armen Petrosyan,2022-10-22,0,1,-1,1,3.5,4.5,-5.080002,5.080002,0,0,12.7,-12.7,49,0,9,11,-2,2,-1,1,0,0,0,0,0,0,0,0,252,105,147,-147
Christian Leroy Duncan,Armen Petrosyan,Armen Petrosyan,2023-06-17,0,1,-5,5,8,4.5,-2.539993,2.539993,0,0,20.32001,-20.32001,69,201,9,11,-2,2,3.5,-3.5,1,1,0,0,0,0,0,0,91,238,-147,147
Ryan Hall,Artem Lobov,Ryan Hall,2015-12-11,1,0,1,-1,4.5,0.8666667,2.540009,-2.540009,0,0,12.7,-12.7,445,305,11,28,-17,17,3.63333332538605,-3.63333332538605,0,0,0,0,0,0,0,0,0,0,0,0
Chris Avila,Artem Lobov,Artem Lobov,2016-08-20,0,1,-7,7,1.25,0.8666667,2.540009,-2.540009,0,0,16.25999,-16.25999,22,33,9,28,-19,19,0.383333325386047,-0.383333325386047,0,0,0,0,0,0,0,0,0,253,-253,253
Teruto Ishihara,Artem Lobov,Artem Lobov,2016-11-19,0,1,-5,5,1.428571,0.8666667,-5.080002,5.080002,-10,10,10.15999,-10.15999,69,49,17,28,-11,11,0.561904788017273,-0.561904788017273,0,1,0,0,-1,1,0,0,0,91,-91,91
Andre Fili,Artem Lobov,Andre Fili,2017-10-21,1,0,-4,4,2.2,0.8666667,5.080002,-5.080002,0,0,22.86,-22.86,268,22,32,28,4,-4,1.33333337306976,-1.33333337306976,0,2,1,0,-2,2,1,-1,84,336,-252,252
Michael Johnson,Artem Lobov,Michael Johnson,2018-10-27,1,0,0,0,1.157895,0.8666667,2.540009,-2.540009,10,-10,20.31999,-20.31999,39,0,41,28,13,-13,0.291228055953979,-0.291228055953979,0,0,0,0,0,0,0,0,714,371,343,-343
Dave Beneteau,Asbel Cancio,Dave Beneteau,1995-04-07,1,0,,,1.2,0,10.16,-10.16,25,-25,11,-11,0,0,11,1,10,-10,1.20000004768372,-1.20000004768372,1,0,0,0,1,-1,0,0,0,0,0,0
Ryan Benoit,Ashkan Mokhtarian,Ryan Benoit,2017-11-18,1,0,-4,4,1.25,4.333333,-2.539993,2.539993,0,0,2.540009,-2.540009,2,22,18,16,2,-2,-3.08333349227905,3.08333349227905,0,0,0,0,0,0,0,0,350,0,350,-350
Norma Dumont,Ashlee Evans-Smith,Norma Dumont,2020-11-28,1,0,-3,3,5,1,-2.540009,2.540009,10,-10,0,0,241,10,12,12,0,0,4,-4,0,0,0,0,0,0,0,0,0,0,0,0
Justine Kish,Ashley Yoder,Justine Kish,2016-12-09,1,0,-1,1,1.75,1,-5.079987,5.079987,10,-10,-12.7,12.7,325,120,11,16,-5,5,0.75,-0.75,1,0,0,0,1,-1,0,0,342,0,342,-342
Angela Hill,Ashley Yoder,Angela Hill,2017-07-07,1,0,3,-3,1.153846,1,-10.15999,10.15999,0,0,-12.7,12.7,174,200,28,16,12,-12,0.153846144676208,-0.153846144676208,0,0,0,0,0,0,0,0,643,210,433,-433
Mackenzie Dern,Ashley Yoder,Mackenzie Dern,2018-03-03,1,0,-6,6,4.333333,1,-7.619995,7.619995,0,0,-15.23999,15.23999,350,42,16,16,0,0,3.33333349227905,-3.33333349227905,0,0,0,0,0,0,0,0,0,239,-239,239
Amanda Cooper,Ashley Yoder,Ashley Yoder,2018-11-10,0,1,-4,4,0.6,1,-10.15999,10.15999,0,0,-12.7,12.7,329,201,8,16,-8,8,-0.399999976158142,0.399999976158142,0,0,0,0,0,0,0,0,182,252,-70,70
Syuri Kondo,Ashley Yoder,Ashley Yoder,2019-06-22,0,1,-1,1,2,1,-7.619995,7.619995,0,0,-7.619995,7.619995,20,774,9,16,-7,7,1,-1,0,1,0,0,-1,1,0,0,210,224,-14,14
Randa Markos,Ashley Yoder,Randa Markos,2019-10-26,1,0,2,-2,0.9166667,1,-7.619995,7.619995,0,0,-15.23999,15.23999,185,337,23,16,7,-7,-8.33333134651184e-02,8.33333134651184e-02,0,2,0,0,-2,2,0,0,455,126,329,-329
Livinha Souza,Ashley Yoder,Livinha Souza,2020-08-15,1,0,-3,3,3.5,1,-10.15999,10.15999,0,0,-15.23999,15.23999,163,230,18,16,2,-2,2.5,-2.5,0,0,0,0,0,0,0,0,0,294,-294,294
Miranda Granger,Ashley Yoder,Ashley Yoder,2020-11-14,0,1,-5,5,2.333333,1,0,0,0,0,-2.539993,2.539993,196,499,10,16,-6,6,1.33333325386047,-1.33333325386047,0,0,0,0,0,0,0,0,329,91,238,-238
Angela Hill,Ashley Yoder,Angela Hill,2021-03-13,1,0,3,-3,1.153846,1,-10.15999,10.15999,0,0,-12.7,12.7,232,159,28,16,12,-12,0.153846144676208,-0.153846144676208,0,1,0,0,-1,1,0,0,182,119,63,-63
Alonzo Menifield,Askar Mozharov,Alonzo Menifield,2022-06-04,1,0,7,-7,4.666667,1.461538,-7.619995,7.619995,0,0,5.079987,-5.079987,259,0,17,32,-15,15,3.20512807369232,-3.20512807369232,0,0,1,0,0,0,1,-1,637,0,637,-637
Tonya Evinger,Aspen Ladd,Aspen Ladd,2018-10-06,0,1,14,-14,2.375,3,2.539993,-2.539993,0,0,10.16,-10.16,62,113,27,12,15,-15,-0.625,0.625,0,0,1,0,0,0,1,-1,434,0,434,-434
Sijara Eubanks,Aspen Ladd,Aspen Ladd,2019-05-18,0,1,10,-10,1.142857,3,-5.080002,5.080002,-10,10,2.539993,-2.539993,148,416,15,12,3,-3,-1.85714280605316,1.85714280605316,2,1,0,0,1,-1,0,0,196,224,-28,28
Germaine de Randamie,Aspen Ladd,Germaine de Randamie,2019-07-13,1,0,11,-11,2.5,3,7.619995,-7.619995,0,0,12.7,-12.7,1,0,14,12,2,-2,-0.5,0.5,4,2,1,0,2,-2,1,-1,245,56,189,-189
Norma Dumont,Aspen Ladd,Norma Dumont,2021-10-16,1,0,5,-5,5,3,2.539993,-2.539993,10,-10,2.539993,-2.539993,107,452,12,12,0,0,2,-2,2,0,0,1,2,-2,-1,1,147,826,-679,679
Cheick Kongo,Assuerio Silva,Cheick Kongo,2007-04-21,1,0,-1,1,2.7,2,15.23999,-15.23999,-1,1,28.28,-28.28,177,431,37,24,13,-13,0.700000047683716,-0.700000047683716,0,0,0,0,0,0,0,0,189,0,189,-189
Cody Garbrandt,Augusto Mendes,Cody Garbrandt,2016-02-21,1,0,-8,8,2.6,3,5.080002,-5.080002,0,0,0,0,5,0,18,8,10,-10,-0.400000095367432,0.400000095367432,0,0,0,0,0,0,0,0,0,0,0,0
Chris Heatherly,Augusto Montano,Augusto Montano,2014-11-15,0,1,-4,4,2.25,5,-10.16,10.16,-15,15,-7.419998,7.419998,48,87,13,18,-5,5,-2.75,2.75,0,0,0,0,0,0,0,0,84,0,84,-84
Andrei Arlovski,Augusto Sakai,Augusto Sakai,2019-04-27,0,1,13,-13,1.545455,3.2,0,0,-25,25,0,0,26,121,56,21,35,-35,-1.654545545578,1.654545545578,0,0,6,0,0,0,6,-6,322,0,322,-322
Blagoy Ivanov,Augusto Sakai,Augusto Sakai,2020-05-30,0,1,4,-4,3.166667,3.2,-10.16,10.16,-15,15,-10.16,10.16,68,106,25,21,4,-4,-3.33333015441895e-02,3.33333015441895e-02,0,1,0,0,-1,1,0,0,210,399,-189,189
Alistair Overeem,Augusto Sakai,Alistair Overeem,2020-09-05,1,0,11,-11,2.473684,3.2,2.539993,-2.539993,0,0,7.619995,-7.619995,329,142,66,21,45,-45,-0.72631573677063,0.72631573677063,0,2,3,0,-2,2,3,-3,273,98,175,-175
Jairzinho Rozenstruik,Augusto Sakai,Jairzinho Rozenstruik,2021-06-05,1,0,3,-3,2.6,3.2,-2.539993,2.539993,-23,23,2.539993,-2.539993,2,0,18,21,-3,3,-0.600000143051147,0.600000143051147,0,0,0,1,0,0,-1,1,0,273,-273,273
"Don'Tale Mayes",Augusto Sakai,Augusto Sakai,2023-02-25,0,1,0,0,2,3.2,7.619995,-7.619995,-5,5,10.16,-10.16,166,531,15,21,-6,6,-1.20000004768372,1.20000004768372,1,0,0,2,1,-1,-2,2,434,630,-196,196
Dakota Bush,Austin Hubbard,Austin Hubbard,2021-04-17,0,1,-3,3,2,2.285714,0,0,0,0,5.080002,-5.080002,91,402,12,23,-11,11,-0.285714387893677,0.285714387893677,0,0,0,0,0,0,0,0,0,0,0,0
Kurt Holobaugh,Austin Hubbard,Kurt Holobaugh,2023-08-19,1,0,5,-5,3,2.285714,2.539993,-2.539993,0,0,-2.539993,2.539993,68,143,28,23,5,-5,0.714285612106323,-0.714285612106323,0,1,0,0,-1,1,0,0,1561,854,707,-707
Jacob Kilburn,Austin Lingo,Austin Lingo,2021-01-16,0,1,-1,1,2,3,-2.540009,2.540009,0,0,5.080002,-5.080002,69,228,12,12,0,0,-1,1,0,0,0,0,0,0,0,0,406,0,406,-406
Nate Landwehr,Austin Lingo,Nate Landwehr,2023-03-25,1,0,6,-6,3.4,3,-2.540009,2.540009,0,0,5.080002,-5.080002,24,0,22,12,10,-10,0.400000095367432,-0.400000095367432,1,1,0,0,0,0,0,0,224,798,-574,574
Melquizael Costa,Austin Lingo,Melquizael Costa,2023-07-15,1,0,-3,3,3.333333,3,0,0,0,0,2.539993,-2.539993,164,0,26,12,14,-14,0.333333253860474,-0.333333253860474,0,0,0,0,0,0,0,0,175,112,63,-63
Alex Caceres,Austin Springer,Alex Caceres,2020-08-29,1,0,-1,1,1.5,3,5.080002,-5.080002,0,0,5.080002,-5.080002,10,3,35,16,19,-19,-1.5,1.5,2,0,1,0,2,-2,1,-1,84,0,84,-84
Devin Clark,Azamat Murzakanov,Azamat Murzakanov,2022-08-13,0,1,-1,1,1.75,13,5.080002,-5.080002,0,0,10.16,-10.16,26,220,22,13,9,-9,-11.25,11.25,1,0,2,0,1,-1,2,-2,119,0,119,-119
Dustin Jacoby,Azamat Murzakanov,Azamat Murzakanov,2023-04-15,0,1,1,-1,2.714286,13,12.7,-12.7,0,0,12.7,-12.7,186,16,26,13,13,-13,-10.2857143878937,10.2857143878937,0,1,0,0,-1,1,0,0,168,245,-77,77
Tyson Griffin,Bart Palaszewski,Bart Palaszewski,2011-10-29,0,1,-1,1,2,2.117647,-7.619995,7.619995,0,0,-5.080002,5.080002,0,0,24,53,-29,29,-0.117647171020508,0.117647171020508,0,0,0,0,0,0,0,0,343,0,343,-343
Hatsu Hioki,Bart Palaszewski,Hatsu Hioki,2012-02-25,1,0,0,0,2.9,2.117647,5.080002,-5.080002,0,0,7.619995,-7.619995,501,15,39,53,-14,14,0.782352924346924,-0.782352924346924,1,1,0,0,0,0,0,0,119,119,0,0
Diego Nunes,Bart Palaszewski,Diego Nunes,2012-10-05,1,0,0,0,2.714286,2.117647,-7.619995,7.619995,0,0,-7.62001,7.62001,351,13,26,53,-27,27,0.596638441085815,-0.596638441085815,0,0,0,0,0,0,0,0,174,223,-49,49
Cole Miller,Bart Palaszewski,Cole Miller,2013-04-13,1,0,-1,1,1.909091,2.117647,10.16,-10.16,0,0,7.619995,-7.619995,44,0,32,53,-21,21,-0.208556294441223,0.208556294441223,0,0,1,0,0,0,1,-1,252,190,62,-62
Tsuyoshi Kohsaka,Bas Rutten,Bas Rutten,1999-01-08,0,1,-5,5,1.421053,7,-5.080002,5.080002,20,-20,-5,5,0,0,46,32,14,-14,-5.57894742488861,5.57894742488861,2,0,0,0,2,-2,0,0,84,0,84,-84
Kevin Randleman,Bas Rutten,Bas Rutten,1999-05-07,0,1,-7,7,1.0625,7,-7.619995,7.619995,0,0,-8,8,0,0,33,32,1,-1,-5.9375,5.9375,1,1,0,0,0,0,0,0,63,119,-56,56
Jack Della Maddalena,Bassil Hafez,Jack Della Maddalena,2023-07-15,1,0,-5,5,8,2,0,0,0,0,2.539993,-2.539993,79,408,18,12,6,-6,6,-6,3,0,0,0,3,-3,0,0,238,0,238,-238
Guido Cannetti,Batgerel Danaa,Batgerel Danaa,2020-03-07,0,1,10,-10,1.25,2.4,-2.539993,2.539993,0,0,-5.080002,5.080002,0,3,18,17,1,-1,-1.15000009536743,1.15000009536743,0,0,0,0,0,0,0,0,476,0,476,-476
Veronica Hardy,Bea Malecki,Bea Malecki,2020-03-14,0,1,-4,4,1.75,4,-12.7,12.7,-10,10,-25.40001,25.40001,12,204,11,5,6,-6,-2.25,2.25,1,0,0,0,1,-1,0,0,217,0,217,-217
Heather Clark,Bec Rawlings,Heather Clark,2014-12-12,1,0,9,-9,1.166667,0.875,0,0,-10,10,0,0,472,62,13,15,-2,2,0.291666626930237,-0.291666626930237,0,0,0,0,0,0,0,0,0,0,0,0
Lisa Ellis,Bec Rawlings,Bec Rawlings,2015-05-09,0,1,6,-6,1.363636,0.875,-5.080002,5.080002,-10,10,2.440002,-2.440002,78,134,26,15,11,-11,0.488636374473572,-0.488636374473572,0,0,0,0,0,0,0,0,148,148,0,0
Seo Hee Ham,Bec Rawlings,Bec Rawlings,2016-03-19,0,1,2,-2,2.125,0.875,-10.16,10.16,-10,10,-5.080002,5.080002,62,301,25,15,10,-10,1.25,-1.25,0,1,0,0,-1,1,0,0,463,315,148,-148
Jessica-Rose Clark,Bec Rawlings,Jessica-Rose Clark,2017-11-18,1,0,1,-1,1.222222,0.875,-2.539993,2.539993,10,-10,0,0,319,142,20,15,5,-5,0.347222208976746,-0.347222208976746,0,2,0,0,-2,2,0,0,0,609,-609,609
Ashlee Evans-Smith,Bec Rawlings,Ashlee Evans-Smith,2018-04-07,1,0,1,-1,1,0.875,5.080002,-5.080002,10,-10,7.619995,-7.619995,7,9,12,15,-3,3,0.125,-0.125,0,0,0,0,0,0,0,0,210,140,70,-70
Alan Jouban,Belal Muhammad,Alan Jouban,2016-07-07,1,0,7,-7,2.428571,7.666667,2.540009,-2.540009,0,0,2.539993,-2.539993,97,179,24,26,-2,2,-5.23809504508972,5.23809504508972,1,0,1,0,1,-1,1,-1,110,0,110,-110
Augusto Montano,Belal Muhammad,Belal Muhammad,2016-09-17,0,1,3,-3,5,7.666667,5.080002,-5.080002,0,0,2.539993,-2.539993,0,207,18,26,-8,8,-2.66666650772095,2.66666650772095,0,0,0,0,0,0,0,0,462,72,390,-390
Vicente Luque,Belal Muhammad,Vicente Luque,2016-11-12,1,0,-4,4,2.444444,7.666667,0,0,0,0,7.619995,-7.619995,3,0,31,26,5,-5,-5.22222208976746,5.22222208976746,1,1,0,0,0,0,0,0,49,56,-7,7
Randy Brown,Belal Muhammad,Belal Muhammad,2017-02-11,0,1,-2,2,3.4,7.666667,10.16,-10.16,0,0,15.23999,-15.23999,26,353,22,26,-4,4,-4.26666641235352,4.26666641235352,2,0,0,1,2,-2,-1,1,64,91,-27,27
Jordan Mein,Belal Muhammad,Belal Muhammad,2017-07-08,0,1,-1,1,2.583333,7.666667,2.540009,-2.540009,0,0,2.539993,-2.539993,36,415,43,26,17,-17,-5.08333325386047,5.08333325386047,3,1,0,1,2,-2,-1,1,1050,147,903,-903
Tim Means,Belal Muhammad,Belal Muhammad,2017-11-18,0,1,4,-4,2.2,7.666667,7.62001,-7.62001,0,0,7.619995,-7.619995,0,21,48,26,22,-22,-5.46666646003723,5.46666646003723,0,2,0,1,-2,2,-1,1,252,133,119,-119
Curtis Millender,Belal Muhammad,Belal Muhammad,2019-04-13,0,1,1,-1,3.4,7.666667,7.62001,-7.62001,0,0,10.15999,-10.15999,2,496,22,26,-4,4,-4.26666641235352,4.26666641235352,0,3,0,1,-3,3,-1,1,35,511,-476,476
Lyman Good,Belal Muhammad,Belal Muhammad,2020-06-20,0,1,4,-4,3.5,7.666667,2.540009,-2.540009,0,0,5.080002,-5.080002,7,104,27,26,1,-1,-4.16666650772095,4.16666650772095,1,4,0,1,-3,3,-1,1,231,434,-203,203
Dhiego Lima,Belal Muhammad,Belal Muhammad,2021-02-13,0,1,0,0,1.888889,7.666667,7.62001,-7.62001,0,0,7.619995,-7.619995,0,162,26,26,0,0,-5.77777767181396,5.77777767181396,1,5,1,1,-4,4,0,0,658,238,420,-420
Demian Maia,Belal Muhammad,Belal Muhammad,2021-06-12,0,1,11,-11,2.545455,7.666667,5.080002,-5.080002,0,0,0,0,254,0,39,26,13,-13,-5.12121200561523,5.12121200561523,1,6,1,1,-5,5,0,0,714,119,595,-595
Vicente Luque,Belal Muhammad,Belal Muhammad,2022-04-16,0,1,-3,3,2.444444,7.666667,0,0,0,0,7.619995,-7.619995,33,449,31,26,5,-5,-5.22222208976746,5.22222208976746,2,7,0,1,-5,5,-1,1,385,308,77,-77
Sean Brady,Belal Muhammad,Belal Muhammad,2022-10-22,0,1,-5,5,15,7.666667,-2.539993,2.539993,0,0,0,0,0,0,16,26,-10,10,7.33333349227905,-7.33333349227905,4,8,0,1,-4,4,-1,1,336,189,147,-147
Gilbert Burns,Belal Muhammad,Belal Muhammad,2023-05-06,0,1,2,-2,3.666667,7.666667,-2.539993,2.539993,0,0,-2.540009,2.540009,0,0,28,26,2,-2,-3.99999976158142,3.99999976158142,2,9,2,1,-7,7,1,-1,28,196,-168,168
Ryan Benoit,Ben Nguyen,Ben Nguyen,2015-11-14,0,1,-1,1,1.25,2,0,0,0,0,7.619995,-7.619995,0,138,18,24,-6,6,-0.75,0.75,1,0,0,0,1,-1,0,0,245,0,245,-245
Geane Herrera,Ben Nguyen,Ben Nguyen,2016-11-26,0,1,-2,2,3,2,0,0,0,0,2.539993,-2.539993,38,2,12,24,-12,12,1,-1,1,1,0,0,0,0,0,0,351,378,-27,27
Tim Elliott,Ben Nguyen,Ben Nguyen,2017-06-10,0,1,2,-2,1.666667,2,5.079987,-5.079987,0,0,2.539993,-2.539993,0,31,32,24,8,-8,-0.333333373069763,0.333333373069763,1,2,0,0,-1,1,0,0,56,196,-140,140
Jussier Formiga,Ben Nguyen,Jussier Formiga,2018-02-10,1,0,3,-3,2.875,2,0,0,0,0,5.079987,-5.079987,243,55,31,24,7,-7,0.875,-0.875,5,3,0,0,2,-2,0,0,141,245,-104,104
Mark Hunt,Ben Rothwell,Mark Hunt,2011-09-24,1,0,8,-8,0.9285714,2.785714,-15.23999,15.23999,0,0,-15.23999,15.23999,378,131,27,53,-26,26,-1.8571429848671,1.8571429848671,1,0,0,0,1,-1,0,0,210,0,210,-210
Gabriel Gonzaga,Ben Rothwell,Gabriel Gonzaga,2013-01-19,1,0,2,-2,1.545455,2.785714,-5.079987,5.079987,-23,23,-5.080002,5.080002,138,37,28,53,-25,25,-1.24025988578796,1.24025988578796,1,0,1,0,1,-1,1,-1,371,483,-112,112
Alistair Overeem,Ben Rothwell,Ben Rothwell,2014-09-05,0,1,2,-2,2.473684,2.785714,0,0,0,0,5.080002,-5.080002,2,13,66,53,13,-13,-0.312030076980591,0.312030076980591,0,0,1,0,0,0,1,-1,580,594,-14,14
Matt Mitrione,Ben Rothwell,Ben Rothwell,2015-06-06,0,1,3,-3,2.4,2.785714,-2.539993,2.539993,0,0,10.16,-10.16,0,2,17,53,-36,36,-0.385714292526245,0.385714292526245,0,1,1,0,-1,1,1,-1,623,274,349,-349
Josh Barnett,Ben Rothwell,Ben Rothwell,2016-01-30,0,1,4,-4,4.375,2.785714,-2.539993,2.539993,-15,15,0,0,28,7,43,53,-10,10,1.58928561210632,-1.58928561210632,1,2,2,0,-1,1,2,-2,126,238,-112,112
Junior Dos Santos,Ben Rothwell,Junior Dos Santos,2016-04-10,1,0,-2,2,2.333333,2.785714,0,0,-27,27,-2.539993,2.539993,2,1,30,53,-23,23,-0.452381134033203,0.452381134033203,0,3,2,0,-3,3,2,-2,113,71,42,-42
Blagoy Ivanov,Ben Rothwell,Blagoy Ivanov,2019-03-09,1,0,-5,5,3.166667,2.785714,-12.7,12.7,-15,15,-12.7,12.7,0,0,25,53,-28,28,0.38095235824585,-0.38095235824585,0,0,0,0,0,0,0,0,0,1063,-1063,1063
Andrei Arlovski,Ben Rothwell,Andrei Arlovski,2019-07-20,1,0,3,-3,1.545455,2.785714,-2.539993,2.539993,-25,25,-2.539993,2.539993,51,134,56,53,3,-3,-1.24025988578796,1.24025988578796,0,0,6,0,0,0,6,-6,84,133,-49,49
Chris Barnett,Ben Rothwell,Ben Rothwell,2021-05-22,0,1,-5,5,2.875,2.785714,-17.78,17.78,0,0,-7.619995,7.619995,2,123,31,53,-22,22,8.92856121063232e-02,-8.92856121063232e-02,0,0,0,0,0,0,0,0,0,672,-672,672
Marcos Rogerio de Lima,Ben Rothwell,Marcos Rogerio de Lima,2021-11-13,1,0,-4,4,2.1,2.785714,-7.619995,7.619995,-12,12,-7.619995,7.619995,0,0,31,53,-22,22,-0.685714483261108,0.685714483261108,0,1,0,0,-1,1,0,0,371,175,196,-196
Dan Barrera,Ben Saunders,Ben Saunders,2007-12-08,0,1,2,-2,3,1.692308,-12.70001,12.70001,0,0,-11.63,11.63,429,349,4,35,-31,31,1.30769228935242,-1.30769228935242,0,0,0,0,0,0,0,0,0,0,0,0
Marcus Davis,Ben Saunders,Ben Saunders,2009-11-21,0,1,10,-10,2,1.692308,-10.16,10.16,0,0,-17.78,17.78,67,54,33,35,-2,2,0.307692289352417,-0.307692289352417,0,1,1,0,-1,1,1,-1,161,714,-553,553
Jon Fitch,Ben Saunders,Jon Fitch,2010-03-27,1,0,6,-6,4.285714,1.692308,-5.080002,5.080002,0,0,-7.619995,7.619995,733,43,37,35,2,-2,2.59340643882751,-2.59340643882751,3,2,0,0,1,-1,0,0,105,126,-21,21
Dennis Hallman,Ben Saunders,Dennis Hallman,2010-08-07,1,0,7,-7,2.65,1.692308,-12.70001,12.70001,-15,15,-12.7,12.7,709,0,73,35,38,-38,0.957692384719849,-0.957692384719849,0,0,2,0,0,0,2,-2,245,133,112,-112
Chris Heatherly,Ben Saunders,Ben Saunders,2014-08-23,0,1,-5,5,2.25,1.692308,-12.70001,12.70001,-15,15,-17.58,17.58,74,44,13,35,-22,22,0.557692289352417,-0.557692289352417,0,0,0,0,0,0,0,0,0,1477,-1477,1477
Joe Riggs,Ben Saunders,Ben Saunders,2014-12-13,0,1,1,-1,2.588235,1.692308,-5.080002,5.080002,15,-15,-17.78,17.78,19,0,61,35,26,-26,0.895927667617798,-0.895927667617798,0,1,1,0,-1,1,1,-1,2922,112,2810,-2810
Kenny Robertson,Ben Saunders,Ben Saunders,2015-07-25,0,1,-1,1,3,1.692308,-10.16,10.16,0,0,-7.619995,7.619995,379,0,20,35,-15,15,1.30769228935242,-1.30769228935242,0,2,0,0,-2,2,0,0,1109,224,885,-885
Patrick Cote,Ben Saunders,Patrick Cote,2016-01-17,1,0,3,-3,2.090909,1.692308,-7.62001,7.62001,0,0,-5.080002,5.080002,90,94,34,35,-1,1,0.398601293563843,-0.398601293563843,1,3,1,0,-2,2,1,-1,267,176,91,-91
Court McGee,Ben Saunders,Ben Saunders,2017-01-15,0,1,-1,1,1.833333,1.692308,-7.62001,7.62001,0,0,-5.080002,5.080002,229,0,34,35,-1,1,0.14102566242218,-0.14102566242218,1,0,1,1,1,-1,0,0,162,364,-202,202
Alan Jouban,Ben Saunders,Alan Jouban,2018-02-24,1,0,2,-2,2.428571,1.692308,-5.080002,5.080002,0,0,-10.16,10.16,18,3,24,35,-11,11,0.736263751983643,-0.736263751983643,0,1,2,1,-1,1,1,-1,203,405,-202,202
Jake Ellenberger,Ben Saunders,Ben Saunders,2018-06-01,0,1,-2,2,2.066667,1.692308,-12.70001,12.70001,0,0,-15.24001,15.24001,40,0,46,35,11,-11,0.374358892440796,-0.374358892440796,0,0,5,2,0,0,3,-3,405,97,308,-308
Sergio Moraes,Ben Saunders,Sergio Moraes,2018-09-22,1,0,1,-1,2.333333,1.692308,-5.080002,5.080002,0,0,-12.7,12.7,485,0,20,35,-15,15,0.641025543212891,-0.641025543212891,0,1,1,2,-1,1,-1,1,371,113,258,-258
Lyman Good,Ben Saunders,Lyman Good,2018-11-03,1,0,-2,2,3.5,1.692308,-5.080002,5.080002,0,0,-7.619995,7.619995,5,0,27,35,-8,8,1.80769228935242,-1.80769228935242,0,0,0,2,0,0,-2,2,469,42,427,-427
Takashi Sato,Ben Saunders,Takashi Sato,2019-04-27,1,0,-8,8,2.285714,1.692308,-10.16,10.16,0,0,-10.16,10.16,17,25,23,35,-12,12,0.593406677246094,-0.593406677246094,0,0,0,3,0,0,-3,3,0,175,-175,175
Matt Brown,Ben Saunders,Matt Brown,2019-12-14,1,0,2,-2,1.368421,1.692308,-5.080002,5.080002,0,0,-5.080002,5.080002,453,10,45,35,10,-10,-0.323886632919312,0.323886632919312,1,0,2,4,1,-1,-2,2,763,231,532,-532
Marcos Rogerio de Lima,Ben Sosoli,Marcos Rogerio de Lima,2020-02-22,1,0,4,-4,2.1,2.333333,2.539993,-2.539993,-12,12,7.619995,-7.619995,2,0,31,10,21,-21,-0.233333349227905,0.233333349227905,0,0,0,0,0,0,0,0,364,0,364,-364
Alex Garcia,Ben Wall,Alex Garcia,2013-12-06,1,0,2,-2,2.5,1.142857,-2.540009,2.540009,15,-15,2.880005,-2.880005,2,0,21,15,6,-6,1.35714280605316,-1.35714280605316,0,0,0,0,0,0,0,0,0,0,0,0
Justin Salas,Ben Wall,Justin Salas,2014-05-10,1,0,7,-7,1.714286,1.142857,-5.080002,5.080002,0,0,-2.199997,2.199997,42,0,19,15,4,-4,0.571428537368774,-0.571428537368774,0,0,0,1,0,0,-1,1,182,155,27,-27
Charlie Brenneman,Beneil Dariush,Beneil Dariush,2014-01-15,0,1,8,-8,2.375,4.4,0,0,0,0,-5.080002,5.080002,0,43,27,27,0,0,-2.02500009536743,2.02500009536743,0,0,3,0,0,0,3,-3,480,0,480,-480
Daron Cruickshank,Beneil Dariush,Beneil Dariush,2015-03-14,0,1,4,-4,1.8,4.4,-5.080002,5.080002,0,0,0,0,24,129,28,27,1,-1,-2.60000014305115,2.60000014305115,1,1,0,0,0,0,0,0,161,423,-262,262
Michael Chiesa,Beneil Dariush,Michael Chiesa,2016-04-16,1,0,2,-2,2.571429,4.4,7.619995,-7.619995,15,-15,7.619995,-7.619995,76,60,25,27,-2,2,-1.82857155799866,1.82857155799866,2,2,1,0,0,0,1,-1,128,399,-271,271
Edson Barboza,Beneil Dariush,Edson Barboza,2017-03-11,1,0,4,-4,2.090909,4.4,2.539993,-2.539993,-10,10,7.619995,-7.619995,3,0,34,27,7,-7,-2.30909109115601,2.30909109115601,2,0,1,0,2,-2,1,-1,231,329,-98,98
Frank Camacho,Beneil Dariush,Beneil Dariush,2019-10-26,0,1,0,0,2.2,4.4,0,0,0,0,2.539993,-2.539993,0,45,32,27,5,-5,-2.20000004768372,2.20000004768372,1,0,1,1,1,-1,0,0,147,959,-812,812
Manny Bermudez,Benito Lopez,Manny Bermudez,2019-02-17,1,0,0,0,7,5,0,0,10,-10,-5.080002,5.080002,92,59,16,12,4,-4,2,-2,2,0,0,0,2,-2,0,0,210,0,210,-210
Mario Bautista,Benito Lopez,Mario Bautista,2022-11-05,1,0,1,-1,6.5,5,-2.540009,2.540009,0,0,-10.16,10.16,156,0,15,12,3,-3,1.5,-1.5,2,0,1,0,2,-2,1,-1,133,1357,-1224,1224
Gabriel Miranda,Benoit Saint Denis,Benoit Saint Denis,2022-09-03,0,1,6,-6,2.833333,12,0,0,-10,10,-5.080002,5.080002,20,197,23,13,10,-10,-9.16666674613953,9.16666674613953,0,0,0,0,0,0,0,0,0,0,0,0
Ismael Bonfim,Benoit Saint Denis,Benoit Saint Denis,2023-07-01,0,1,0,0,4.75,12,-7.619995,7.619995,0,0,-5.080002,5.080002,10,177,23,13,10,-10,-7.25,7.25,1,1,0,0,0,0,0,0,161,301,-140,140
Thiago Moises,Benoit Saint Denis,Benoit Saint Denis,2023-09-02,0,1,1,-1,2.428571,12,-5.080002,5.080002,0,0,-7.619995,7.619995,14,320,24,13,11,-11,-9.57142853736877,9.57142853736877,0,2,0,0,-2,2,0,0,0,63,-63,63
Mark Bocek,Benson Henderson,Benson Henderson,2011-04-30,0,1,2,-2,2.4,3.428571,-2.539993,2.539993,-15,15,12.7,-12.7,267,332,17,31,-14,14,-1.02857136726379,1.02857136726379,1,0,1,0,1,-1,1,-1,140,0,140,-140
Clay Guida,Benson Henderson,Benson Henderson,2011-11-12,0,1,2,-2,1.9,3.428571,-5.080002,5.080002,-15,15,0,0,169,447,58,31,27,-27,-1.52857148647308,1.52857148647308,1,1,0,0,0,0,0,0,161,196,-35,35
Frankie Edgar,Benson Henderson,Benson Henderson,2012-02-25,0,1,2,-2,2.090909,3.428571,-7.619995,7.619995,-35,35,-5.080002,5.080002,128,37,34,31,3,-3,-1.3376624584198,1.3376624584198,6,2,0,0,4,-4,0,0,140,105,35,-35
Frankie Edgar,Benson Henderson,Benson Henderson,2012-08-11,0,1,2,-2,2.090909,3.428571,-7.619995,7.619995,-35,35,-5.080002,5.080002,180,7,34,31,3,-3,-1.3376624584198,1.3376624584198,0,3,0,0,-3,3,0,0,168,168,0,0
Nate Diaz,Benson Henderson,Benson Henderson,2012-12-08,0,1,-2,2,1.692308,3.428571,7.62001,-7.62001,0,0,15.23999,-15.23999,44,1020,35,31,4,-4,-1.73626375198364,1.73626375198364,2,4,0,0,-2,2,0,0,217,119,98,-98
Rafael Dos Anjos,Benson Henderson,Rafael Dos Anjos,2014-08-23,1,0,-1,1,2.133333,3.428571,-2.539993,2.539993,0,0,0,0,2,2,47,31,16,-16,-1.29523801803589,1.29523801803589,1,5,1,0,-4,4,1,-1,77,623,-546,546
Donald Cerrone,Benson Henderson,Donald Cerrone,2015-01-18,1,0,0,0,2.117647,3.428571,10.16,-10.16,-15,15,7.619995,-7.619995,32,0,53,31,22,-22,-1.31092429161072,1.31092429161072,4,0,1,1,4,-4,0,0,15,148,-133,133
Fredy Serrano,Bentley Syler,Fredy Serrano,2015-03-21,1,0,3,-3,1.5,5,-2.539993,2.539993,0,0,0.1000061,-0.1000061,42,0,5,6,-1,1,-3.5,3.5,0,0,0,0,0,0,0,0,0,0,0,0
Simeon Thoresen,Besam Yousef,Simeon Thoresen,2012-04-14,1,0,1,-1,2.833333,1.75,5.080002,-5.080002,0,0,17.66,-17.66,208,9,23,11,12,-12,1.08333325386047,-1.08333325386047,0,0,0,0,0,0,0,0,0,0,0,0
Papy Abedi,Besam Yousef,Papy Abedi,2013-04-06,1,0,6,-6,2.5,1.75,0,0,15,-15,6.199997,-6.199997,337,265,14,11,3,-3,0.75,-0.75,0,0,0,0,0,0,0,0,357,357,0,0
Shayna Baszler,Bethe Correia,Bethe Correia,2014-08-30,0,1,3,-3,1.363636,1.833333,5.079987,-5.079987,0,0,7.440002,-7.440002,115,156,26,17,9,-9,-0.469696998596191,0.469696998596191,0,0,0,0,0,0,0,0,0,0,0,0
Irene Aldana,Bethe Correia,Irene Aldana,2019-05-11,1,0,-4,4,2,1.833333,10.15999,-10.15999,0,0,10.16,-10.16,10,15,21,17,4,-4,0.166666626930237,-0.166666626930237,2,1,0,0,1,-1,0,0,245,1715,-1470,1470
Uriah Hall,Bevon Lewis,Uriah Hall,2018-12-29,1,0,7,-7,1.636364,2.333333,-7.619995,7.619995,0,0,0,0,1,129,29,10,19,-19,-0.696969628334045,0.696969628334045,1,0,1,0,1,-1,1,-1,469,0,469,-469
Trevin Giles,Bevon Lewis,Trevin Giles,2020-11-07,1,0,-1,1,3.2,2.333333,-7.619995,7.619995,-15,15,-12.7,12.7,153,95,21,10,11,-11,0.866666793823242,-0.866666793823242,1,0,0,1,1,-1,-1,1,273,679,-406,406
Jenel Lausa,Bibulatov Magomed,Bibulatov Magomed,2017-04-08,0,1,0,0,1.4,7,0,0,0,0,7.619995,-7.619995,27,461,12,16,-4,4,-5.60000002384186,5.60000002384186,1,0,0,0,1,-1,0,0,133,0,133,-133
Rogerio Bontorin,Bibulatov Magomed,Rogerio Bontorin,2019-02-02,1,0,-4,4,4,7,0,0,0,0,5.079987,-5.079987,178,136,20,16,4,-4,-3,3,0,1,0,0,-1,1,0,0,0,665,-665,665
Forrest Griffin,Bill Mahood,Forrest Griffin,2005-06-04,1,0,-12,12,2.714286,2.857143,0,0,5,-5,-0.4199982,0.4199982,124,0,26,27,-1,1,-0.142857313156128,0.142857313156128,0,0,0,0,0,0,0,0,0,0,0,0
Jacob Kilburn,Billy Quarantillo,Billy Quarantillo,2019-12-07,0,1,-6,6,2,3.6,-2.540009,2.540009,0,0,5.080002,-5.080002,13,445,12,23,-11,11,-1.59999990463257,1.59999990463257,0,0,0,0,0,0,0,0,0,0,0,0
Spike Carlyle,Billy Quarantillo,Billy Quarantillo,2020-05-30,0,1,-4,4,3,3.6,-5.080002,5.080002,0,0,2.539993,-2.539993,541,284,12,23,-11,11,-0.599999904632568,0.599999904632568,1,1,0,0,0,0,0,0,91,175,-84,84
Kyle Nelson,Billy Quarantillo,Billy Quarantillo,2020-09-12,0,1,-2,2,3,3.6,2.539993,-2.539993,0,0,2.539993,-2.539993,87,208,20,23,-3,3,-0.599999904632568,0.599999904632568,1,2,0,0,-1,1,0,0,357,105,252,-252
Gabriel Benitez,Billy Quarantillo,Billy Quarantillo,2021-07-17,0,1,1,-1,2.090909,3.6,-5.080002,5.080002,10,-10,2.539993,-2.539993,50,520,34,23,11,-11,-1.50909090042114,1.50909090042114,1,3,2,0,-2,2,2,-2,224,308,-84,84
Shane Burgos,Billy Quarantillo,Shane Burgos,2021-11-06,1,0,-2,2,5,3.6,2.539993,-2.539993,0,0,12.7,-12.7,146,129,18,23,-5,5,1.40000009536743,-1.40000009536743,0,4,1,0,-4,4,1,-1,504,112,392,-392
Alexander Hernandez,Billy Quarantillo,Billy Quarantillo,2022-12-10,0,1,-4,4,2.333333,3.6,-2.540009,2.540009,0,0,5.080002,-5.080002,248,80,20,23,-3,3,-1.26666665077209,1.26666665077209,0,0,0,0,0,0,0,0,301,399,-98,98
Edson Barboza,Billy Quarantillo,Edson Barboza,2023-04-15,1,0,3,-3,2.090909,3.6,2.539993,-2.539993,0,0,12.7,-12.7,2,39,34,23,11,-11,-1.50909090042114,1.50909090042114,0,1,4,0,-1,1,4,-4,406,126,280,-280
Damon Jackson,Billy Quarantillo,Billy Quarantillo,2023-08-05,0,1,0,0,3.666667,3.6,2.539993,-2.539993,0,0,2.539993,-2.539993,370,111,28,23,5,-5,6.6666841506958e-02,-6.6666841506958e-02,3,0,1,1,3,-3,0,0,322,112,210,-210
Joey Gilbert,BJ Penn,BJ Penn,2001-05-04,0,1,2,-2,0.6666667,1.142857,5.080002,-5.080002,0,0,-12.8,12.8,6,270,5,30,-25,25,-0.476190507411957,0.476190507411957,0,0,0,0,0,0,0,0,0,0,0,0
Paul Creighton,BJ Penn,BJ Penn,2002-05-10,0,1,8,-8,3,1.142857,-7.619995,7.619995,0,0,-7.800003,7.800003,106,208,4,30,-26,26,1.85714280605316,-1.85714280605316,0,1,0,0,-1,1,0,0,0,371,-371,371
Matt Hughes,BJ Penn,BJ Penn,2004-01-31,0,1,5,-5,5,1.142857,0,0,15,-15,7.619995,-7.619995,0,250,54,30,24,-24,3.85714280605316,-3.85714280605316,6,2,0,0,4,-4,0,0,71,631,-560,560
Matt Hughes,BJ Penn,Matt Hughes,2006-09-23,1,0,5,-5,5,1.142857,0,0,15,-15,7.619995,-7.619995,419,118,54,30,24,-24,3.85714280605316,-3.85714280605316,4,3,0,0,1,-1,0,0,308,966,-658,658
Kenny Florian,BJ Penn,BJ Penn,2009-08-08,0,1,3,-3,2.333333,1.142857,2.540009,-2.540009,-10,10,10.16,-10.16,311,251,20,30,-10,10,1.19047605991364,-1.19047605991364,6,0,1,1,6,-6,0,0,266,1050,-784,784
Frankie Edgar,BJ Penn,Frankie Edgar,2010-04-10,1,0,-3,3,2.090909,1.142857,-7.619995,7.619995,-20,20,-5.080002,5.080002,5,0,34,30,4,-4,0.948051810264587,-0.948051810264587,3,1,0,1,2,-2,-1,1,126,245,-119,119
Frankie Edgar,BJ Penn,Frankie Edgar,2010-08-28,1,0,-3,3,2.090909,1.142857,-7.619995,7.619995,-20,20,-5.080002,5.080002,402,85,34,30,4,-4,0.948051810264587,-0.948051810264587,4,0,0,1,4,-4,-1,1,140,140,0,0
Matt Hughes,BJ Penn,BJ Penn,2010-11-20,0,1,6,-6,5,1.142857,0,0,15,-15,7.619995,-7.619995,0,3,54,30,24,-24,3.85714280605316,-3.85714280605316,1,0,1,1,1,-1,0,0,546,84,462,-462
Nick Diaz,BJ Penn,Nick Diaz,2011-10-29,1,0,-4,4,2.6,1.142857,10.16,-10.16,15,-15,15.23999,-15.23999,203,87,36,30,6,-6,1.45714271068573,-1.45714271068573,2,1,0,1,1,-1,-1,1,1806,343,1463,-1463
Rory MacDonald,BJ Penn,Rory MacDonald,2012-12-08,1,0,-10,10,4.75,1.142857,7.62001,-7.62001,15,-15,15.23999,-15.23999,151,56,23,30,-7,7,3.60714280605316,-3.60714280605316,2,0,0,1,2,-2,-1,1,231,406,-175,175
Frankie Edgar,BJ Penn,Frankie Edgar,2014-07-06,1,0,-3,3,2.090909,1.142857,-7.619995,7.619995,-20,20,-5.080002,5.080002,532,0,34,30,4,-4,0.948051810264587,-0.948051810264587,1,0,0,1,1,-1,-1,1,365,575,-210,210
Ryan Hall,BJ Penn,Ryan Hall,2018-12-29,1,0,-7,7,4.5,1.142857,2.540009,-2.540009,-10,10,0,0,0,94,11,30,-19,19,3.35714280605316,-3.35714280605316,2,0,0,2,2,-2,-2,2,756,1637,-881,881
Clay Guida,BJ Penn,Clay Guida,2019-05-11,1,0,-3,3,1.9,1.142857,-5.080002,5.080002,0,0,0,0,242,0,58,30,28,-28,0.757142782211304,-0.757142782211304,0,0,2,2,0,0,0,0,336,133,203,-203
Junior Dos Santos,Blagoy Ivanov,Junior Dos Santos,2018-07-14,1,0,3,-3,2.333333,3.166667,12.7,-12.7,-12,12,10.16,-10.16,0,3,30,25,5,-5,-0.833333492279053,0.833333492279053,0,0,3,0,0,0,3,-3,427,0,427,-427
Orion Cosce,Blood Diamond,Orion Cosce,2022-07-30,1,0,-6,6,4,1,0,0,0,0,-12.7,12.7,566,68,10,6,4,-4,3,-3,0,0,1,0,0,0,1,-1,364,0,364,-364
Edson Barboza,Bobby Green,Edson Barboza,2014-11-22,1,0,0,0,2.090909,2.142857,2.539993,-2.539993,-10,10,10.16,-10.16,0,2,34,44,-10,10,-5.1948070526123e-02,5.1948070526123e-02,1,0,1,0,1,-1,1,-1,129,0,129,-129
Rafael Fiziev,Bobby Green,Rafael Fiziev,2021-08-07,1,0,-6,6,4,2.142857,-5.080002,5.080002,0,0,0,0,8,0,15,44,-29,29,1.85714292526245,-1.85714292526245,2,0,1,0,2,-2,1,-1,238,2450,-2212,2212
Drew Dober,Bobby Green,Drew Dober,2022-12-17,1,0,-2,2,2.166667,2.142857,-5.080002,5.080002,0,0,-2.539993,2.539993,7,11,38,44,-6,6,2.38096714019775e-02,-2.38096714019775e-02,1,0,0,0,1,-1,0,0,280,497,-217,217
Tony Ferguson,Bobby Green,Bobby Green,2023-07-29,0,1,3,-3,2.888889,2.142857,2.539993,-2.539993,0,0,12.7,-12.7,13,205,35,44,-9,9,0.746031761169434,-0.746031761169434,0,0,1,1,0,0,0,0,959,224,735,-735
Josh Barnett,Bobby Hoffman,Josh Barnett,2001-11-02,1,0,-10,10,4.375,3.6,2.539993,-2.539993,5,-5,6.119995,-6.119995,328,202,43,46,-3,3,0.775000095367432,-0.775000095367432,1,0,1,0,1,-1,1,-1,126,0,126,-126
Bryce Mitchell,Bobby Moffett,Bryce Mitchell,2019-03-23,1,0,-4,4,8,2.6,0,0,0,0,-7.619995,7.619995,191,361,18,18,0,0,5.40000009536743,-5.40000009536743,0,0,0,0,0,0,0,0,0,0,0,0
Enrique Barzola,Bobby Moffett,Enrique Barzola,2019-08-10,1,0,1,-1,3.4,2.6,-7.62001,7.62001,0,0,-7.619995,7.619995,39,24,22,18,4,-4,0.800000190734863,-0.800000190734863,3,0,0,0,3,-3,0,0,448,140,308,-308
Li Jingliang,Bobby Nash,Li Jingliang,2017-01-28,1,0,2,-2,2.375,2,0,0,0,0,-7.62001,7.62001,10,221,27,12,15,-15,0.375,-0.375,1,0,0,0,1,-1,0,0,204,0,204,-204
Song Kenan,Bobby Nash,Song Kenan,2017-11-25,1,0,0,0,2.857143,2,0,0,0,0,-7.62001,7.62001,6,0,27,12,15,-15,0.857142925262451,-0.857142925262451,0,0,0,1,0,0,-1,1,0,301,-301,301
Sam Hoger,Bobby Southworth,Sam Hoger,2005-04-09,1,0,-11,11,2.5,1.666667,0,0,0,0,1,-1,159,81,14,16,-2,2,0.833333373069763,-0.833333373069763,0,0,0,0,0,0,0,0,0,0,0,0
Patrick Cote,Bobby Voelker,Patrick Cote,2013-03-16,1,0,0,0,2.090909,1.461538,-2.540009,2.540009,0,0,2.539993,-2.539993,222,343,34,32,2,-2,0.6293705701828,-0.6293705701828,1,0,1,0,1,-1,1,-1,119,0,119,-119
Robbie Lawler,Bobby Voelker,Robbie Lawler,2013-07-27,1,0,-3,3,1.875,1.461538,-2.540009,2.540009,0,0,0,0,73,0,46,32,14,-14,0.413461565971375,-0.413461565971375,0,0,0,0,0,0,0,0,3200,133,3067,-3067
William Macario,Bobby Voelker,William Macario,2013-12-28,1,0,-12,12,3,1.461538,-2.540009,2.540009,0,0,2.539993,-2.539993,68,0,12,32,-20,20,1.53846156597137,-1.53846156597137,0,0,0,1,0,0,-1,1,203,154,49,-49
Lance Benoist,Bobby Voelker,Lance Benoist,2014-06-07,1,0,-10,10,3.5,1.461538,-2.540009,2.540009,0,0,-5.080002,5.080002,423,137,9,32,-23,23,2.03846156597137,-2.03846156597137,0,0,0,1,0,0,-1,1,623,161,462,-462
Joachim Christensen,Bojan Mihajlovic,Joachim Christensen,2017-01-15,1,0,2,-2,2.333333,1.666667,10.16,-10.16,0,0,7.619995,-7.619995,332,66,20,16,4,-4,0.666666626930237,-0.666666626930237,0,0,0,0,0,0,0,0,106,0,106,-106
Abdul-Kerim Edilov,Bojan Mihajlovic,Abdul-Kerim Edilov,2017-09-02,1,0,-12,12,4.25,1.666667,7.62001,-7.62001,0,0,5.580002,-5.580002,331,0,21,16,5,-5,2.58333337306976,-2.58333337306976,0,0,0,1,0,0,-1,1,0,230,-230,230
Alessio Di Chirico,Bojan Velickovic,Bojan Velickovic,2016-04-10,0,1,-1,1,1.857143,2.5,0,0,15,-15,-5.079987,5.079987,27,46,20,21,-1,1,-0.642857193946838,0.642857193946838,0,0,0,0,0,0,0,0,0,0,0,0
Sultan Aliev,Bojan Velickovic,Sultan Aliev,2016-12-17,1,0,5,-5,5,2.5,-2.540009,2.540009,0,0,-5.079987,5.079987,552,24,18,21,-3,3,2.5,-2.5,0,1,1,0,-1,1,1,-1,693,251,442,-442
Nicholas Musoke,Bojan Velickovic,Bojan Velickovic,2017-05-28,0,1,3,-3,2.6,2.5,0,0,0,0,-2.539993,2.539993,189,29,18,21,-3,3,9.99999046325684e-02,-9.99999046325684e-02,0,0,0,0,0,0,0,0,855,162,693,-693
Darren Till,Bojan Velickovic,Darren Till,2017-09-02,1,0,-4,4,3.6,2.5,0,0,15,-15,-5.079987,5.079987,171,2,23,21,2,-2,1.09999990463257,-1.09999990463257,0,1,0,0,-1,1,0,0,0,97,-97,97
Jake Matthews,Bojan Velickovic,Jake Matthews,2017-11-18,1,0,-5,5,3.166667,2.5,-2.540009,2.540009,0,0,-7.619995,7.619995,427,278,25,21,4,-4,0.666666746139526,-0.666666746139526,0,0,0,0,0,0,0,0,924,77,847,-847
Randy Costa,Boston Salmon,Randy Costa,2019-10-18,1,0,-3,3,1.5,2,0,0,0,0,10.16,-10.16,7,43,10,9,1,-1,-0.5,0.5,0,0,0,0,0,0,0,0,188,0,188,-188
Shonie Carter,Brad Gumm,Shonie Carter,2000-03-10,1,0,,,1.645161,1.666667,-2.539993,2.539993,0,0,-5,5,408,30,82,16,66,-66,-2.15053558349609e-02,2.15053558349609e-02,0,0,0,0,0,0,0,0,0,0,0,0
Rashad Evans,Brad Imes,Rashad Evans,2005-11-05,1,0,-2,2,2.375,1.857143,-17.78,17.78,-60,60,-7.5,7.5,128,95,27,20,7,-7,0.517857193946838,-0.517857193946838,0,0,0,0,0,0,0,0,0,0,0,0
Dan Christison,Brad Imes,Dan Christison,2006-04-06,1,0,4,-4,2.857143,1.857143,2.539993,-2.539993,0,0,-12,12,108,218,27,20,7,-7,1.00000011920929,-1.00000011920929,0,0,0,0,0,0,0,0,0,152,-152,152
Heath Herring,Brad Imes,Heath Herring,2007-04-07,1,0,-1,1,1.75,1.857143,-7.62001,7.62001,-15,15,0.1199951,-0.1199951,554,74,44,20,24,-24,-0.107142806053162,0.107142806053162,0,0,0,0,0,0,0,0,72,366,-294,294
Jay Cucciniello,Brad Katona,Brad Katona,2018-07-06,0,1,5,-5,8,7.5,2.539993,-2.539993,20,-20,10.44,-10.44,0,499,9,17,-8,8,0.5,-0.5,0,0,0,0,0,0,0,0,0,0,0,0
Merab Dvalishvili,Brad Katona,Merab Dvalishvili,2019-05-04,1,0,1,-1,4,7.5,0,0,0,0,10.16,-10.16,513,36,20,17,3,-3,-3.5,3.5,1,1,0,0,0,0,0,0,231,302,-71,71
Hunter Azure,Brad Katona,Hunter Azure,2019-09-14,1,0,0,0,4.5,7.5,5.080002,-5.080002,10,-10,12.7,-12.7,29,382,11,17,-6,6,-3,3,0,0,0,0,0,0,0,0,0,133,-133,133
Cody Gibson,Brad Katona,Brad Katona,2023-08-19,0,1,4,-4,2.222222,7.5,10.16,-10.16,0,0,17.78,-17.78,0,0,29,17,12,-12,-5.27777767181396,5.27777767181396,0,0,0,0,0,0,0,0,3100,1435,1665,-1665
Steve Judson,Brad Kohler,Brad Kohler,1999-09-24,0,1,,,0,0.8,5.080002,-5.080002,10,-10,-10,10,1,8,2,27,-25,25,-0.800000011920929,0.800000011920929,0,0,0,0,0,0,0,0,0,0,0,0
Jason Brilz,Brad Morris,Jason Brilz,2008-09-17,1,0,5,-5,3.666667,1.666667,-7.62001,7.62001,0,0,-12.66,12.66,447,5,28,16,12,-12,2.00000011920929,-2.00000011920929,0,0,0,0,0,0,0,0,0,0,0,0
Renan Barao,Brad Pickett,Renan Barao,2011-11-05,1,0,-9,9,3.777778,1.785714,0,0,10,-10,5.080002,-5.080002,46,0,43,39,4,-4,1.99206340312958,-1.99206340312958,1,0,0,0,1,-1,0,0,161,0,161,-161
Damacio Page,Brad Pickett,Brad Pickett,2012-04-14,0,1,-4,4,1.9,1.785714,0,0,0,0,-5.080002,5.080002,63,337,29,39,-10,10,0.114285707473755,-0.114285707473755,0,0,0,0,0,0,0,0,0,161,-161,161
Yves Jabouin,Brad Pickett,Brad Pickett,2012-09-29,0,1,-1,1,1.818182,1.785714,2.539993,-2.539993,0,0,0,0,0,2,31,39,-8,8,3.24676036834717e-02,-3.24676036834717e-02,2,1,0,0,1,-1,0,0,294,168,126,-126
Mike Easton,Brad Pickett,Brad Pickett,2013-04-06,0,1,-5,5,2.166667,1.785714,0,0,0,0,5.080002,-5.080002,150,274,19,39,-20,20,0.380952477455139,-0.380952477455139,2,2,0,0,0,0,0,0,273,189,84,-84
Michael McDonald,Brad Pickett,Michael McDonald,2013-08-17,1,0,-12,12,4.25,1.785714,7.619995,-7.619995,0,0,5.080002,-5.080002,29,141,21,39,-18,18,2.46428573131561,-2.46428573131561,2,3,0,0,-1,1,0,0,483,133,350,-350
Ian McCall,Brad Pickett,Ian McCall,2014-07-19,1,0,-5,5,2.6,1.785714,-2.539993,2.539993,-10,10,-10.16,10.16,163,93,18,39,-21,21,0.814285635948181,-0.814285635948181,1,0,0,0,1,-1,0,0,350,336,14,-14
Chico Camus,Brad Pickett,Chico Camus,2014-11-22,1,0,-7,7,2.428571,1.785714,0,0,-10,10,-5.080002,5.080002,4,175,24,39,-15,15,0.642857193946838,-0.642857193946838,0,0,0,0,0,0,0,0,182,126,56,-56
Thomas Almeida,Brad Pickett,Thomas Almeida,2015-07-11,1,0,-13,13,4.4,1.785714,2.539993,-2.539993,10,-10,5.080002,-5.080002,1,28,27,39,-12,12,2.61428582668304,-2.61428582668304,2,0,0,0,2,-2,0,0,77,231,-154,154
Iuri Alcantara,Brad Pickett,Iuri Alcantara,2016-10-08,1,0,-2,2,3.5,1.785714,7.619995,-7.619995,0,0,7.619995,-7.619995,29,11,45,39,6,-6,1.71428573131561,-1.71428573131561,0,0,0,1,0,0,-1,1,252,455,-203,203
Urijah Faber,Brad Pickett,Urijah Faber,2016-12-17,1,0,-1,1,3.181818,1.785714,0,0,0,0,-2.540009,2.540009,381,31,46,39,7,-7,1.39610397815704,-1.39610397815704,0,0,0,1,0,0,-1,1,98,70,28,-28
Jamie Mullarkey,Brad Riddell,Brad Riddell,2019-10-05,0,1,-3,3,2.833333,2.5,12.70001,-12.70001,0,0,7.62001,-7.62001,203,179,23,14,9,-9,0.333333253860474,-0.333333253860474,0,0,0,0,0,0,0,0,0,0,0,0
Magomed Mustafaev,Brad Riddell,Brad Riddell,2020-02-22,0,1,3,-3,3.5,2.5,2.540009,-2.540009,0,0,0,0,423,122,18,14,4,-4,1,-1,1,1,0,0,0,0,0,0,1533,140,1393,-1393
Alex Da Silva,Brad Riddell,Brad Riddell,2020-09-26,0,1,-4,4,5.25,2.5,2.540009,-2.540009,0,0,5.080002,-5.080002,317,84,25,14,11,-11,2.75,-2.75,1,2,0,0,-1,1,0,0,413,217,196,-196
Drew Dober,Brad Riddell,Brad Riddell,2021-06-12,0,1,3,-3,2.166667,2.5,2.540009,-2.540009,0,0,-2.539993,2.539993,65,150,38,14,24,-24,-0.333333253860474,0.333333253860474,0,3,0,0,-3,3,0,0,98,259,-161,161
Rafael Fiziev,Brad Riddell,Rafael Fiziev,2021-12-04,1,0,-2,2,4,2.5,2.540009,-2.540009,0,0,0,0,9,14,15,14,1,-1,1.5,-1.5,3,4,1,0,-1,1,1,-1,119,175,-56,56
Renato Moicano,Brad Riddell,Renato Moicano,2022-11-12,1,0,2,-2,3.4,2.5,10.16,-10.16,0,0,2.540009,-2.540009,34,14,22,14,8,-8,0.900000095367432,-0.900000095367432,0,0,1,1,0,0,0,0,1239,343,896,-896
Michael Kuiper,Brad Scott,Brad Scott,2013-10-26,0,1,0,0,3,1.833333,-2.539993,2.539993,15,-15,-7.619995,7.619995,6,161,20,17,3,-3,1.16666662693024,-1.16666662693024,0,0,0,0,0,0,0,0,203,0,203,-203
Dylan Andrews,Brad Scott,Brad Scott,2015-05-09,0,1,10,-10,2.571429,1.833333,0,0,15,-15,-5.079987,5.079987,43,305,25,17,8,-8,0.738095164299011,-0.738095164299011,0,1,1,0,-1,1,1,-1,519,560,-41,41
Krzysztof Jotko,Brad Scott,Krzysztof Jotko,2016-02-27,1,0,0,0,4,1.833333,0,0,15,-15,2.540009,-2.540009,28,113,30,17,13,-13,2.16666662693024,-2.16666662693024,2,2,0,0,0,0,0,0,511,294,217,-217
Scott Askham,Brad Scott,Brad Scott,2017-03-18,0,1,1,-1,3.5,1.833333,5.080002,-5.080002,15,-15,-2.539993,2.539993,25,77,18,17,1,-1,1.66666662693024,-1.66666662693024,0,0,0,0,0,0,0,0,196,385,-189,189
Jack Hermansson,Brad Scott,Jack Hermansson,2017-08-05,1,0,1,-1,2.875,1.833333,0,0,15,-15,2.540009,-2.540009,152,0,31,17,14,-14,1.04166662693024,-1.04166662693024,1,1,0,0,0,0,0,0,69,140,-71,71
Carlo Pedersoli Jr.,Brad Scott,Carlo Pedersoli Jr.,2018-05-27,1,0,-4,4,3.666667,1.833333,-5.080002,5.080002,0,0,-2.539993,2.539993,86,1,14,17,-3,3,1.83333337306976,-1.83333337306976,0,0,0,1,0,0,-1,1,0,295,-295,295
Seth Baczynski,Brad Tavares,Brad Tavares,2010-06-19,0,1,6,-6,1.428571,2.222222,5.080002,-5.080002,-15,15,2.539993,-2.539993,106,693,34,29,5,-5,-0.79365086555481,0.79365086555481,0,0,0,0,0,0,0,0,0,0,0,0
Phil Baroni,Brad Tavares,Brad Tavares,2011-01-01,0,1,11,-11,0.8333333,2.222222,-10.16,10.16,-15,15,-5.080002,5.080002,109,44,33,29,4,-4,-1.38888901472092,1.38888901472092,0,1,1,0,-1,1,1,-1,406,196,210,-210
Aaron Simpson,Brad Tavares,Aaron Simpson,2011-07-02,1,0,13,-13,2.4,2.222222,-2.539993,2.539993,-15,15,-2.540009,2.540009,659,58,17,29,-12,12,0.177777767181396,-0.177777767181396,0,2,0,0,-2,2,0,0,0,182,-182,182
Riki Fukuda,Brad Tavares,Brad Tavares,2013-03-02,0,1,7,-7,2.666667,2.222222,-2.539993,2.539993,0,0,-2.540009,2.540009,59,0,33,29,4,-4,0.444444417953491,-0.444444417953491,0,0,0,0,0,0,0,0,238,609,-371,371
Robert McDaniel,Brad Tavares,Brad Tavares,2013-08-28,0,1,5,-5,2.8,2.222222,5.080002,-5.080002,0,0,2.539993,-2.539993,282,97,38,29,9,-9,0.577777624130249,-0.577777624130249,1,1,0,0,0,0,0,0,137,179,-42,42
Lorenz Larkin,Brad Tavares,Brad Tavares,2014-01-15,0,1,1,-1,3,2.222222,-5.080002,5.080002,-15,15,-5.080002,5.080002,42,191,24,29,-5,5,0.777777671813965,-0.777777671813965,0,2,0,0,-2,2,0,0,0,140,-140,140
Yoel Romero,Brad Tavares,Yoel Romero,2014-04-19,1,0,10,-10,2.6,2.222222,-2.539993,2.539993,0,0,-2.540009,2.540009,405,68,18,29,-11,11,0.377777576446533,-0.377777576446533,1,3,0,0,-2,2,0,0,364,94,270,-270
Tim Boetsch,Brad Tavares,Tim Boetsch,2014-08-16,1,0,7,-7,1.615385,2.222222,-2.539993,2.539993,0,0,0,0,35,257,34,29,5,-5,-0.606837749481201,0.606837749481201,0,0,2,0,0,0,2,-2,112,119,-7,7
Nate Marquardt,Brad Tavares,Brad Tavares,2015-01-03,0,1,8,-8,1.842105,2.222222,-2.539993,2.539993,0,0,0,0,87,29,54,29,25,-25,-0.380117058753967,0.380117058753967,2,0,1,1,2,-2,0,0,189,140,49,-49
Caio Magalhaes,Brad Tavares,Brad Tavares,2016-09-10,0,1,0,0,3.333333,2.222222,0,0,0,0,-2.540009,2.540009,167,119,13,29,-16,16,1.11111092567444,-1.11111092567444,0,1,0,1,-1,1,-1,1,426,616,-190,190
Thales Leites,Brad Tavares,Brad Tavares,2017-10-07,0,1,7,-7,3.111111,2.222222,0,0,0,0,10.15999,-10.15999,177,84,37,29,8,-8,0.888888835906982,-0.888888835906982,0,2,0,1,-2,2,-1,1,588,392,196,-196
Krzysztof Jotko,Brad Tavares,Brad Tavares,2018-04-14,0,1,-2,2,4,2.222222,0,0,0,0,7.619995,-7.619995,45,152,30,29,1,-1,1.77777767181396,-1.77777767181396,5,3,0,1,2,-2,-1,1,511,189,322,-322
Israel Adesanya,Brad Tavares,Israel Adesanya,2018-07-06,1,0,-2,2,8,2.222222,7.619995,-7.619995,0,0,15.23999,-15.23999,107,126,27,29,-2,2,5.77777767181396,-5.77777767181396,2,4,0,1,-2,2,-1,1,83,83,0,0
Edmen Shahbazyan,Brad Tavares,Edmen Shahbazyan,2019-11-02,1,0,-10,10,3,2.222222,2.540009,-2.540009,0,0,2.539993,-2.539993,4,0,16,29,-13,13,0.777777671813965,-0.777777671813965,1,0,0,1,1,-1,-1,1,337,484,-147,147
Antonio Carlos Junior,Brad Tavares,Brad Tavares,2021-01-23,0,1,-3,3,2.2,2.222222,2.540009,-2.540009,0,0,12.7,-12.7,388,5,16,29,-13,13,-2.22222805023193e-02,2.22222805023193e-02,0,0,1,2,0,0,-1,1,497,448,49,-49
Omari Akhmedov,Brad Tavares,Brad Tavares,2021-07-10,0,1,0,0,3.5,2.222222,-2.539993,2.539993,0,0,-2.540009,2.540009,102,9,27,29,-2,2,1.27777767181396,-1.27777767181396,1,1,2,2,0,0,0,0,171,168,3,-3
Dricus Du Plessis,Brad Tavares,Dricus Du Plessis,2022-07-02,1,0,-6,6,10,2.222222,0,0,0,0,5.079987,-5.079987,78,121,22,29,-7,7,7.77777767181396,-7.77777767181396,2,2,0,2,0,0,-2,2,357,357,0,0
Bruno Silva,Brad Tavares,Bruno Silva,2023-04-22,1,0,-2,2,2.555556,2.222222,-2.539993,2.539993,0,0,0,0,2,0,32,29,3,-3,0.333333253860474,-0.333333253860474,2,0,0,2,2,-2,-2,2,497,294,203,-203
Fernie Garcia,Brady Hiestand,Brady Hiestand,2022-11-19,0,1,7,-7,2.5,4,-2.540009,2.540009,0,0,-10.16,10.16,82,554,14,10,4,-4,-1.5,1.5,0,0,0,0,0,0,0,0,196,0,196,-196
Batgerel Danaa,Brady Hiestand,Brady Hiestand,2023-04-22,0,1,10,-10,2.4,4,-2.540009,2.540009,0,0,-2.539993,2.539993,60,249,17,10,7,-7,-1.59999990463257,1.59999990463257,0,1,1,0,-1,1,1,-1,315,154,161,-161
Sean Gannon,Branden Lee Hinkle,Branden Lee Hinkle,2005-10-07,0,1,,,2,1.545455,0,0,30,-30,0,0,0,229,3,28,-25,25,0.454545497894287,-0.454545497894287,0,0,0,0,0,0,0,0,0,0,0,0
Jason Lambert,Branden Lee Hinkle,Jason Lambert,2006-06-28,1,0,-1,1,2,1.545455,0,0,-50,50,-2.5,2.5,189,99,39,28,11,-11,0.454545497894287,-0.454545497894287,2,1,0,0,1,-1,0,0,74,264,-190,190
Kyle Bochniak,Brandon Davis,Kyle Bochniak,2018-01-20,1,0,3,-3,1.6,1.4,-7.62001,7.62001,10,-10,-5.080002,5.080002,230,8,13,24,-11,11,0.200000047683716,-0.200000047683716,0,0,0,0,0,0,0,0,182,0,182,-182
Enrique Barzola,Brandon Davis,Enrique Barzola,2018-05-19,1,0,1,-1,3.4,1.4,-7.62001,7.62001,10,-10,-5.080002,5.080002,433,53,22,24,-2,2,2.00000011920929,-2.00000011920929,2,0,0,0,2,-2,0,0,119,119,0,0
Randy Costa,Brandon Davis,Brandon Davis,2019-04-13,0,1,-4,4,1.5,1.4,-2.540009,2.540009,0,0,2.539993,-2.539993,37,75,10,24,-14,14,0.100000023841858,-0.100000023841858,0,0,0,0,0,0,0,0,0,329,-329,329
Giga Chikadze,Brandon Davis,Giga Chikadze,2019-09-28,1,0,2,-2,5,1.4,5.080002,-5.080002,10,-10,5.080002,-5.080002,71,182,18,24,-6,6,3.60000002384186,-3.60000002384186,0,1,0,0,-1,1,0,0,0,168,-168,168
Batgerel Danaa,Brandon Davis,Batgerel Danaa,2021-10-16,1,0,1,-1,2.4,1.4,-7.62001,7.62001,0,0,-5.080002,5.080002,5,0,17,24,-7,7,1.00000011920929,-1.00000011920929,1,0,0,0,1,-1,0,0,175,749,-574,574
Joe Lauzon,Brandon Melendez,Joe Lauzon,2007-06-23,1,0,-1,1,1.75,1,-2.539993,2.539993,0,0,-2.660004,2.660004,275,82,44,50,-6,6,0.75,-0.75,1,0,0,0,1,-1,0,0,273,0,273,-273
Ryan Benoit,Brandon Moreno,Brandon Moreno,2016-12-03,0,1,5,-5,1.25,3,-5.079987,5.079987,0,0,-5.080002,5.080002,16,290,18,28,-10,10,-1.75,1.75,1,0,0,0,1,-1,0,0,126,0,126,-126
Kai Kara-France,Brandon Moreno,Brandon Moreno,2019-12-14,0,1,0,0,2.181818,3,-7.619995,7.619995,0,0,-2.540009,2.540009,0,0,35,28,7,-7,-0.818181753158569,0.818181753158569,1,1,0,0,0,0,0,0,308,1106,-798,798
Jussier Formiga,Brandon Moreno,Brandon Moreno,2020-03-14,0,1,8,-8,2.875,3,-5.079987,5.079987,0,0,-7.62001,7.62001,253,225,31,28,3,-3,-0.125,0.125,7,2,0,0,5,-5,0,0,525,91,434,-434
Deiveson Figueiredo,Brandon Moreno,Brandon Moreno,2021-06-12,0,1,6,-6,7,3,-5.079987,5.079987,0,0,-5.080002,5.080002,90,289,24,28,-4,4,4,-4,2,3,0,0,-1,1,0,0,203,455,-252,252
Deiveson Figueiredo,Brandon Moreno,Deiveson Figueiredo,2022-01-22,1,0,6,-6,7,3,-5.079987,5.079987,0,0,-5.080002,5.080002,138,46,24,28,-4,4,4,-4,0,4,0,0,-4,4,0,0,224,224,0,0
Kai Kara-France,Brandon Moreno,Brandon Moreno,2022-07-30,0,1,1,-1,2.181818,3,-7.619995,7.619995,0,0,-2.540009,2.540009,24,45,35,28,7,-7,-0.818181753158569,0.818181753158569,0,0,0,0,0,0,0,0,672,189,483,-483
Deiveson Figueiredo,Brandon Moreno,Brandon Moreno,2023-01-21,0,1,6,-6,7,3,-5.079987,5.079987,0,0,-5.080002,5.080002,35,412,24,28,-4,4,4,-4,1,1,0,0,0,0,0,0,364,175,189,-189
Tim Elliott,Brandon Royval,Brandon Royval,2020-05-30,0,1,6,-6,1.666667,2.5,-5.080002,5.080002,0,0,-5.080002,5.080002,241,124,32,21,11,-11,-0.833333373069763,0.833333373069763,0,0,0,0,0,0,0,0,231,0,231,-231
Kai Kara-France,Brandon Royval,Brandon Royval,2020-09-26,0,1,-1,1,2.181818,2.5,-12.7,12.7,0,0,2.539993,-2.539993,91,91,35,21,14,-14,-0.318181753158569,0.318181753158569,1,1,0,0,0,0,0,0,217,119,98,-98
Brandon Moreno,Brandon Royval,Brandon Moreno,2020-11-21,1,0,-2,2,3,2.5,-5.080002,5.080002,0,0,5.080002,-5.080002,181,0,28,21,7,-7,0.5,-0.5,0,2,0,0,-2,2,0,0,917,56,861,-861
Alexandre Pantoja,Brandon Royval,Alexandre Pantoja,2021-08-21,1,0,2,-2,5.2,2.5,-10.15999,10.15999,0,0,-2.540009,2.540009,171,8,31,21,10,-10,2.69999980926514,-2.69999980926514,5,0,0,1,5,-5,-1,1,609,273,336,-336
Rogerio Bontorin,Brandon Royval,Brandon Royval,2022-01-15,0,1,0,0,4,2.5,-10.15999,10.15999,0,0,-2.540009,2.540009,461,103,20,21,-1,1,1.5,-1.5,0,0,1,1,0,0,0,0,315,147,168,-168
Matheus Nicolau,Brandon Royval,Brandon Royval,2023-04-15,0,1,0,0,4.75,2.5,-7.619995,7.619995,0,0,-5.080002,5.080002,0,7,23,21,2,-2,2.25,-2.25,1,1,1,1,0,0,0,0,133,455,-322,322
Justin Edwards,Brandon Thatch,Brandon Thatch,2013-08-28,0,1,2,-2,1.8,2.2,-10.16,10.16,-15,15,-10.16,10.16,2,19,14,16,-2,2,-0.400000095367432,0.400000095367432,1,0,0,0,1,-1,0,0,327,0,327,-327
Benson Henderson,Brandon Thatch,Benson Henderson,2015-02-14,1,0,2,-2,3.428571,2.2,-12.70001,12.70001,0,0,-10.16,10.16,275,17,31,16,15,-15,1.22857141494751,-1.22857141494751,2,1,0,0,1,-1,0,0,252,535,-283,283
Gunnar Nelson,Brandon Thatch,Gunnar Nelson,2015-07-11,1,0,-4,4,3.8,2.2,-7.62001,7.62001,0,0,-5.080002,5.080002,85,0,24,16,8,-8,1.59999990463257,-1.59999990463257,0,0,0,0,0,0,0,0,280,147,133,-133
Siyar Bahadurzada,Brandon Thatch,Siyar Bahadurzada,2016-03-05,1,0,1,-1,3,2.2,-7.62001,7.62001,0,0,-2.540009,2.540009,499,29,32,16,16,-16,0.799999952316284,-0.799999952316284,0,0,0,0,0,0,0,0,798,238,560,-560
Niko Price,Brandon Thatch,Niko Price,2016-12-30,1,0,-4,4,2.142857,2.2,-5.080002,5.080002,0,0,5.079987,-5.079987,171,1,22,16,6,-6,-5.7142972946167e-02,5.7142972946167e-02,0,0,0,0,0,0,0,0,0,300,-300,300
Fabiano Scherner,Brandon Vera,Brandon Vera,2005-10-03,0,1,6,-6,1.1,2.142857,0,0,27,-27,-5.119995,5.119995,77,203,21,22,-1,1,-1.04285705089569,1.04285705089569,0,0,0,0,0,0,0,0,0,0,0,0
Justin Eilers,Brandon Vera,Brandon Vera,2006-02-04,0,1,-1,1,2.714286,2.142857,-5.080002,5.080002,5,-5,-10.12,10.12,35,11,26,22,4,-4,0.571428537368774,-0.571428537368774,1,1,0,0,0,0,0,0,532,124,408,-408
Assuerio Silva,Brandon Vera,Brandon Vera,2006-05-27,0,1,3,-3,2,2.142857,-12.7,12.7,11,-11,-18.12,18.12,35,0,24,22,2,-2,-0.142857074737549,0.142857074737549,0,2,0,0,-2,2,0,0,131,112,19,-19
Frank Mir,Brandon Vera,Brandon Vera,2006-11-18,0,1,-2,2,1.636364,2.142857,0,0,34,-34,2.540009,-2.540009,0,34,29,22,7,-7,-0.506493449211121,0.506493449211121,5,3,0,0,2,-2,0,0,882,175,707,-707
Tim Sylvia,Brandon Vera,Tim Sylvia,2007-10-20,1,0,1,-1,3.1,2.142857,12.7,-12.7,35,-35,5.080002,-5.080002,460,185,41,22,19,-19,0.95714282989502,-0.95714282989502,1,4,0,0,-3,3,0,0,791,336,455,-455
Reese Andy,Brandon Vera,Brandon Vera,2008-07-19,0,1,5,-5,2.333333,2.142857,-7.619995,7.619995,-25,25,-11.58,11.58,220,188,10,22,-12,12,0.190476179122925,-0.190476179122925,0,0,0,0,0,0,0,0,0,273,-273,273
Keith Jardine,Brandon Vera,Keith Jardine,2008-10-18,1,0,1,-1,1.545455,2.142857,-2.539993,2.539993,-45,45,-5.080002,5.080002,220,38,28,22,6,-6,-0.597402572631836,0.597402572631836,0,1,1,0,-1,1,1,-1,147,91,56,-56
Michael Patt,Brandon Vera,Brandon Vera,2009-03-07,0,1,,,3,2.142857,-7.619995,7.619995,-25,25,-13.12,13.12,0,11,16,22,-6,6,0.857142925262451,-0.857142925262451,0,0,0,0,0,0,0,0,0,140,-140,140
Krzysztof Soszynski,Brandon Vera,Brandon Vera,2009-08-29,0,1,1,-1,2.166667,2.142857,-5.080002,5.080002,-25,25,-2.539993,2.539993,159,186,38,22,16,-16,2.38096714019775e-02,-2.38096714019775e-02,1,1,0,0,0,0,0,0,133,175,-42,42
Randy Couture,Brandon Vera,Randy Couture,2009-11-14,1,0,14,-14,1.727273,2.142857,-5.080002,5.080002,-25,25,-7.619995,7.619995,539,145,30,22,8,-8,-0.415584325790405,0.415584325790405,0,2,4,0,-2,2,4,-4,77,77,0,0
Jon Jones,Brandon Vera,Jon Jones,2010-03-21,1,0,-10,10,27,2.142857,2.539993,-2.539993,18,-18,15.24001,-15.24001,163,0,28,22,6,-6,24.8571429252625,-24.8571429252625,1,0,0,0,1,-1,0,0,253,127,126,-126
Eliot Marshall,Brandon Vera,Brandon Vera,2011-10-29,0,1,-3,3,2.5,2.142857,-2.539993,2.539993,-25,25,-2.539993,2.539993,130,430,14,22,-8,8,0.357142925262451,-0.357142925262451,0,0,0,1,0,0,-1,1,587,587,0,0
Mauricio Rua,Brandon Vera,Mauricio Rua,2012-08-04,1,0,-4,4,1.928571,2.142857,-5.080002,5.080002,-25,25,-5.080002,5.080002,686,111,41,22,19,-19,-0.214285612106323,0.214285612106323,0,1,0,1,-1,1,-1,1,0,280,-280,280
Ben Rothwell,Brandon Vera,Ben Rothwell,2013-08-31,1,0,-4,4,2.785714,2.142857,2.539993,-2.539993,35,-35,0,0,99,0,53,22,31,-31,0.642857313156128,-0.642857313156128,2,0,1,2,2,-2,-1,1,497,392,105,-105
Ben Saunders,Brandon Wolff,Ben Saunders,2008-12-10,1,0,-8,8,1.692308,1.4,12.70001,-12.70001,0,0,17.58,-17.58,48,6,35,12,23,-23,0.292307734489441,-0.292307734489441,1,0,0,0,1,-1,0,0,123,0,123,-123
Parker Porter,Braxton Smith,Parker Porter,2023-05-06,1,0,5,-5,1.555556,2.5,2.540009,-2.540009,8,-8,7.619995,-7.619995,27,0,23,7,16,-16,-0.944444417953491,0.944444417953491,0,0,1,0,0,0,1,-1,84,0,84,-84
Zhang Lipeng,"Brendan O'Reilly",Zhang Lipeng,2014-08-23,1,0,-3,3,2.555556,2,10.16,-10.16,-15,15,5.080002,-5.080002,483,196,32,9,23,-23,0.555555582046509,-0.555555582046509,1,0,0,0,1,-1,0,0,175,0,175,-175
Vik Grujic,"Brendan O'Reilly","Brendan O'Reilly",2015-05-09,0,1,11,-11,1,2,10.16,-10.16,0,0,10.16,-10.16,301,458,12,9,3,-3,-1,1,1,0,0,0,1,-1,0,0,315,259,56,-56
Alan Jouban,"Brendan O'Reilly",Alan Jouban,2016-03-19,1,0,6,-6,2.428571,2,12.70001,-12.70001,0,0,10.16,-10.16,34,46,24,9,15,-15,0.428571462631226,-0.428571462631226,0,1,1,0,-1,1,1,-1,168,315,-147,147
Dong Hyun Ma,"Brendan O'Reilly",Dong Hyun Ma,2016-12-03,1,0,-1,1,1.454545,2,10.16,-10.16,-15,15,2.540009,-2.540009,595,221,27,9,18,-18,-0.545454502105713,0.545454502105713,0,0,2,1,0,0,1,-1,182,259,-77,77
Roy Nelson,Brendan Schaub,Roy Nelson,2009-12-05,1,0,7,-7,1.571429,2,-10.15999,10.15999,18,-18,-12.7,12.7,82,0,36,15,21,-21,-0.428571462631226,0.428571462631226,0,0,0,0,0,0,0,0,0,0,0,0
Chase Gormley,Brendan Schaub,Brendan Schaub,2010-03-21,0,1,,,2.333333,2,-2.539993,2.539993,20,-20,-5.119995,5.119995,0,3,20,15,5,-5,0.333333253860474,-0.333333253860474,0,0,0,1,0,0,-1,1,148,106,42,-42
Gabriel Gonzaga,Brendan Schaub,Brendan Schaub,2010-10-23,0,1,4,-4,1.545455,2,-5.079987,5.079987,-3,3,-5.080002,5.080002,0,7,28,15,13,-13,-0.454545497894287,0.454545497894287,3,1,1,1,2,-2,0,0,420,216,204,-204
Mirko Filipovic,Brendan Schaub,Brendan Schaub,2011-03-19,0,1,8,-8,3.181818,2,-5.079987,5.079987,-15,15,-12.7,12.7,110,417,46,15,31,-31,1.18181824684143,-1.18181824684143,0,2,2,1,-2,2,1,-1,175,147,28,-28
Antonio Rodrigo Nogueira,Brendan Schaub,Antonio Rodrigo Nogueira,2011-08-27,1,0,7,-7,3.4,2,-2.539993,2.539993,-5,5,-2.539993,2.539993,17,20,44,15,29,-29,1.40000009536743,-1.40000009536743,0,3,1,1,-3,3,0,0,553,161,392,-392
Ben Rothwell,Brendan Schaub,Ben Rothwell,2012-04-21,1,0,1,-1,2.785714,2,0,0,20,-20,0,0,2,8,53,15,38,-38,0.785714387893677,-0.785714387893677,1,0,1,2,1,-1,-1,1,679,238,441,-441
Lavar Johnson,Brendan Schaub,Brendan Schaub,2013-02-23,0,1,6,-6,1.8,2,0,0,-5,5,10.16,-10.16,55,722,28,15,13,-13,-0.200000047683716,0.200000047683716,0,0,0,3,0,0,-3,3,273,308,-35,35
Matt Mitrione,Brendan Schaub,Brendan Schaub,2013-09-21,0,1,5,-5,2.4,2,-2.539993,2.539993,20,-20,10.16,-10.16,0,53,17,15,2,-2,0.400000095367432,-0.400000095367432,0,1,1,3,-1,1,-2,2,280,210,70,-70
Andrei Arlovski,Brendan Schaub,Andrei Arlovski,2014-06-14,1,0,4,-4,1.545455,2,-2.539993,2.539993,-5,5,-2.539993,2.539993,190,192,56,15,41,-41,-0.454545497894287,0.454545497894287,3,2,3,3,1,-1,0,0,2296,266,2030,-2030
Travis Browne,Brendan Schaub,Travis Browne,2014-12-06,1,0,1,-1,2.571429,2,5.080002,-5.080002,10,-10,2.540009,-2.540009,101,49,25,15,10,-10,0.571428537368774,-0.571428537368774,0,0,1,3,0,0,-2,2,231,175,56,-56
Kwan Ho Kwak,Brett Johns,Brett Johns,2016-11-19,0,1,3,-3,4.5,8.5,-5.079987,5.079987,0,0,-12.34,12.34,9,596,11,19,-8,8,-4,4,0,0,0,0,0,0,0,0,0,0,0,0
Tony Gravely,Brett Johns,Brett Johns,2020-01-25,0,1,1,-1,2.555556,8.5,-5.079987,5.079987,0,0,-5.080002,5.080002,249,441,32,19,13,-13,-5.94444441795349,5.94444441795349,0,1,0,0,-1,1,0,0,0,1162,-1162,1162
Montel Jackson,Brett Johns,Brett Johns,2020-07-18,0,1,0,0,6.5,8.5,7.62001,-7.62001,0,0,10.16,-10.16,161,522,15,19,-4,4,-2,2,2,2,0,0,0,0,0,0,462,175,287,-287
Randy Brown,Brian Camozzi,Randy Brown,2016-12-09,1,0,1,-1,3.4,1.4,2.539993,-2.539993,0,0,0,0,236,30,22,12,10,-10,2.00000011920929,-2.00000011920929,1,0,0,0,1,-1,0,0,83,0,83,-83
Omari Akhmedov,Brian Ebersole,Omari Akhmedov,2015-06-06,1,0,-7,7,3.5,2.833333,0,0,15,-15,0,0,0,0,27,69,-42,42,0.666666746139526,-0.666666746139526,1,0,0,0,1,-1,0,0,154,0,154,-154
Matt Brown,Brian Foster,Brian Foster,2010-11-20,0,1,3,-3,1.368421,2.7,7.62001,-7.62001,0,0,10.16,-10.16,109,200,45,37,8,-8,-1.33157896995544,1.33157896995544,0,0,0,0,0,0,0,0,140,0,140,-140
Derek Brunson,Brian Houston,Derek Brunson,2013-11-06,1,0,-3,3,2.555556,0.6666667,-2.540009,2.540009,0,0,2.580002,-2.580002,30,0,32,10,22,-22,1.88888889551163,-1.88888889551163,1,0,0,0,1,-1,0,0,312,0,312,-312
Don Frye,Brian Johnston,Don Frye,1996-07-12,1,0,,,2.222222,1,-5.080002,5.080002,-11,11,-5,5,0,0,29,10,19,-19,1.22222232818604,-1.22222232818604,3,0,0,0,3,-3,0,0,147,0,147,-147
Scott Fiedler,Brian Johnston,Brian Johnston,1996-07-12,0,1,,,0,1,2.539993,-2.539993,5,-5,3,-3,0,0,1,10,-9,9,-1,1,0,0,0,1,0,0,-1,1,0,0,0,0
Mark Coleman,Brian Johnston,Mark Coleman,1996-09-20,1,0,,,1.6,1,-5.080002,5.080002,-25,25,-2.5,2.5,0,0,26,10,16,-16,0.600000023841858,-0.600000023841858,4,1,0,1,3,-3,-1,1,0,70,-70,70
Dan Bobish,Brian Johnston,Dan Bobish,1997-07-27,1,0,,,1.888889,1,-2.539993,2.539993,115,-115,-2,2,0,0,26,10,16,-16,0.888888835906982,-0.888888835906982,0,0,0,2,0,0,-2,2,0,310,-310,310
Iuri Alcantara,Brian Kelleher,Brian Kelleher,2017-06-03,0,1,6,-6,3.5,1.714286,7.619995,-7.619995,0,0,12.7,-12.7,7,0,45,38,7,-7,1.78571426868439,-1.78571426868439,2,0,0,0,2,-2,0,0,91,0,91,-91
Renan Barao,Brian Kelleher,Brian Kelleher,2018-02-24,0,1,0,0,3.777778,1.714286,0,0,10,-10,10.16,-10.16,133,266,43,38,5,-5,2.06349194049835,-2.06349194049835,0,1,2,0,-1,1,2,-2,210,266,-56,56
Montel Jackson,Brian Kelleher,Montel Jackson,2018-12-29,1,0,-6,6,6.5,1.714286,10.16,-10.16,0,0,22.86,-22.86,16,5,15,38,-23,23,4.78571426868439,-4.78571426868439,0,2,0,0,-2,2,0,0,147,308,-161,161
Hunter Azure,Brian Kelleher,Brian Kelleher,2020-05-13,0,1,-5,5,4.5,1.714286,5.080002,-5.080002,10,-10,7.619995,-7.619995,21,29,11,38,-27,27,2.78571426868439,-2.78571426868439,1,0,0,0,1,-1,0,0,242,501,-259,259
Kevin Croom,Brian Kelleher,Brian Kelleher,2022-01-15,0,1,-1,1,1.4,1.714286,12.7,-12.7,0,0,17.78,-17.78,47,386,36,38,-2,2,-0.314285755157471,0.314285755157471,0,1,0,0,-1,1,0,0,0,612,-612,612
Mario Bautista,Brian Kelleher,Mario Bautista,2022-06-25,1,0,-7,7,6.5,1.714286,7.619995,-7.619995,0,0,7.619995,-7.619995,88,0,15,38,-23,23,4.78571426868439,-4.78571426868439,1,2,1,0,-1,1,1,-1,126,161,-35,35
Seth Baczynski,Brian Melancon,Brian Melancon,2013-07-06,0,1,0,0,1.428571,2.333333,17.78,-17.78,0,0,12.5,-12.5,16,100,34,10,24,-24,-0.904761791229248,0.904761791229248,0,0,0,0,0,0,0,0,204,0,204,-204
Kelvin Gastelum,Brian Melancon,Kelvin Gastelum,2013-08-28,1,0,-10,10,2.25,2.333333,2.539993,-2.539993,0,0,2.339996,-2.339996,30,0,26,10,16,-16,-8.33332538604736e-02,8.33332538604736e-02,1,1,0,0,0,0,0,0,137,53,84,-84
Diego Brandao,Brian Ortega,Brian Ortega,2016-01-02,0,1,4,-4,2,5,-2.540009,2.540009,0,0,-12.7,12.7,20,103,33,18,15,-15,-3,3,2,0,2,0,2,-2,2,-2,98,0,98,-98
Clay Guida,Brian Ortega,Brian Ortega,2016-06-04,0,1,9,-9,1.9,5,-2.540009,2.540009,10,-10,2.540009,-2.540009,32,4,58,18,40,-40,-3.10000002384186,3.10000002384186,0,1,1,0,-1,1,1,-1,210,154,56,-56
Renato Moicano,Brian Ortega,Brian Ortega,2017-07-29,0,1,2,-2,3.4,5,7.619995,-7.619995,10,-10,7.62001,-7.62001,20,0,22,18,4,-4,-1.59999990463257,1.59999990463257,3,2,0,0,1,-1,0,0,105,420,-315,315
Frankie Edgar,Brian Ortega,Brian Ortega,2018-03-03,0,1,9,-9,2.090909,5,-5.080002,5.080002,-10,10,-2.539993,2.539993,0,2,34,18,16,-16,-2.90909099578857,2.90909099578857,7,3,0,0,4,-4,0,0,294,217,77,-77
Max Holloway,Brian Ortega,Max Holloway,2018-12-08,1,0,0,0,3.571429,5,7.619995,-7.619995,0,0,0,0,16,145,32,18,14,-14,-1.42857146263123,1.42857146263123,6,4,0,0,2,-2,0,0,728,280,448,-448
Krzysztof Soszynski,Brian Stann,Krzysztof Soszynski,2009-04-18,1,0,3,-3,2.166667,2,0,0,0,0,7.619995,-7.619995,107,9,38,18,20,-20,0.166666746139526,-0.166666746139526,0,0,0,0,0,0,0,0,0,0,0,0
Steve Cantwell,Brian Stann,Brian Stann,2009-09-16,0,1,-6,6,1.166667,2,2.540009,-2.540009,-20,20,2.539993,-2.539993,0,6,13,18,-5,5,-0.833333373069763,0.833333373069763,0,0,0,0,0,0,0,0,0,151,-151,151
Phil Davis,Brian Stann,Phil Davis,2010-02-06,1,0,-4,4,4.25,2,2.540009,-2.540009,0,0,12.7,-12.7,645,0,21,18,3,-3,2.25,-2.25,0,1,0,0,-1,1,0,0,0,143,-143,143
Mike Massenzio,Brian Stann,Brian Stann,2010-08-01,0,1,-2,2,1.444444,2,2.540009,-2.540009,-20,20,-2.540009,2.540009,358,318,22,18,4,-4,-0.555555582046509,0.555555582046509,1,0,0,0,1,-1,0,0,683,176,507,-507
Chris Leben,Brian Stann,Brian Stann,2011-01-01,0,1,0,0,2,2,-5.080002,5.080002,-20,20,-2.540009,2.540009,8,104,33,18,15,-15,0,0,2,1,1,0,1,-1,1,-1,196,153,43,-43
Jorge Santiago,Brian Stann,Brian Stann,2011-05-28,0,1,0,0,2.083333,2,0,0,-35,35,2.539993,-2.539993,15,102,37,18,19,-19,8.33332538604736e-02,-8.33332538604736e-02,0,2,0,0,-2,2,0,0,0,147,-147,147
Chael Sonnen,Brian Stann,Chael Sonnen,2011-10-08,1,0,3,-3,1.933333,2,0,0,0,0,-2.540009,2.540009,472,18,44,18,26,-26,-6.66667222976685e-02,6.66667222976685e-02,0,3,0,0,-3,3,0,0,0,133,-133,133
Alessio Sakara,Brian Stann,Brian Stann,2012-04-14,0,1,-1,1,1.727273,2,-2.539993,2.539993,-20,20,-5.080002,5.080002,0,76,30,18,12,-12,-0.272727251052856,0.272727251052856,0,0,0,0,0,0,0,0,408,189,219,-219
Michael Bisping,Brian Stann,Michael Bisping,2012-09-22,1,0,2,-2,3.333333,2,0,0,-20,20,2.539993,-2.539993,272,66,39,18,21,-21,1.33333325386047,-1.33333325386047,0,1,1,0,-1,1,1,-1,238,161,77,-77
Wanderlei Silva,Brian Stann,Wanderlei Silva,2013-03-02,1,0,4,-4,2.692308,2,-5.080002,5.080002,0,0,0,0,37,54,48,18,30,-30,0.692307710647583,-0.692307710647583,0,0,0,0,0,0,0,0,0,161,-161,161
Clint Hester,Bristol Marunde,Clint Hester,2013-04-13,1,0,-4,4,1.833333,1.6,2.540009,-2.540009,35,-35,5.080002,-5.080002,118,144,17,26,-9,9,0.233333349227905,-0.233333349227905,0,0,0,0,0,0,0,0,0,0,0,0
Viscardi Andrade,Bristol Marunde,Viscardi Andrade,2013-08-03,1,0,-2,2,3.166667,1.6,-5.080002,5.080002,0,0,0,0,18,0,25,26,-1,1,1.56666672229767,-1.56666672229767,0,0,0,1,0,0,-1,1,0,112,-112,112
Jon Fitch,Brock Larson,Jon Fitch,2005-10-03,1,0,-1,1,4.285714,4.2,2.540009,-2.540009,0,0,7.62001,-7.62001,609,176,37,52,-15,15,8.57143402099609e-02,-8.57143402099609e-02,0,0,0,0,0,0,0,0,0,0,0,0
Brian Foster,Brock Larson,Brian Foster,2009-11-21,1,0,-7,7,2.7,4.2,-5.080002,5.080002,0,0,0,0,176,59,37,52,-15,15,-1.49999976158142,1.49999976158142,0,0,0,0,0,0,0,0,63,1510,-1447,1447
Heath Herring,Brock Lesnar,Brock Lesnar,2008-08-09,0,1,-1,1,1.75,1.666667,2.539993,-2.539993,-15,15,-7.62001,7.62001,115,693,44,8,36,-36,8.33333730697632e-02,-8.33333730697632e-02,1,0,0,0,1,-1,0,0,161,0,161,-161
Randy Couture,Brock Lesnar,Brock Lesnar,2008-11-15,0,1,14,-14,1.727273,1.666667,-5.080002,5.080002,-60,60,-15.24001,15.24001,186,170,30,8,22,-22,6.06061220169067e-02,-6.06061220169067e-02,2,1,3,0,1,-1,3,-3,448,98,350,-350
Shane Carwin,Brock Lesnar,Brock Lesnar,2010-07-03,0,1,3,-3,6,1.666667,-2.539993,2.539993,0,0,-2.540009,2.540009,163,154,14,8,6,-6,4.33333337306976,-4.33333337306976,4,2,0,0,2,-2,0,0,98,595,-497,497
Juliana Miller,Brogan Walker,Juliana Miller,2022-08-06,1,0,-8,8,1.333333,2,7.619995,-7.619995,0,0,-2.539993,2.539993,580,76,7,12,-5,5,-0.666666626930237,0.666666626930237,0,0,0,0,0,0,0,0,0,0,0,0
Iasmin Lucindo,Brogan Walker,Iasmin Lucindo,2023-04-22,1,0,-13,13,3,2,-2.539993,2.539993,-10,10,-2.539993,2.539993,46,64,20,12,8,-8,1,-1,0,0,0,1,0,0,-1,1,0,259,-259,259
Kazula Vargas,Brok Weaver,Brok Weaver,2020-02-15,0,1,6,-6,2.4,2.5,-10.16,10.16,0,0,-5.080002,5.080002,188,0,17,21,-4,4,-9.99999046325684e-02,9.99999046325684e-02,0,0,0,0,0,0,0,0,0,0,0,0
Roosevelt Roberts,Brok Weaver,Roosevelt Roberts,2020-05-30,1,0,-2,2,3.333333,2.5,5.080002,-5.080002,0,0,0,0,184,140,13,21,-8,8,0.833333253860474,-0.833333253860474,1,1,0,0,0,0,0,0,203,105,98,-98
Jalin Turner,Brok Weaver,Jalin Turner,2020-09-12,1,0,-3,3,1.857143,2.5,7.619995,-7.619995,0,0,10.16,-10.16,107,28,20,21,-1,1,-0.642857193946838,0.642857193946838,0,0,0,0,0,0,0,0,0,105,-105,105
Shauna Bannon,Bruna Brasil,Bruna Brasil,2023-07-22,0,1,0,0,5,3,-2.539993,2.539993,0,0,0,0,65,201,6,12,-6,6,2,-2,0,0,0,0,0,0,0,0,0,0,0,0
Krzysztof Jotko,Bruno Santos,Krzysztof Jotko,2013-12-06,1,0,-2,2,4,7.5,10.16,-10.16,0,0,17.58,-17.58,238,298,30,17,13,-13,-3.5,3.5,0,0,0,0,0,0,0,0,0,0,0,0
Chris Camozzi,Bruno Santos,Bruno Santos,2014-07-05,0,1,1,-1,1.846154,7.5,12.70001,-12.70001,0,0,12.5,-12.5,2,545,37,17,20,-20,-5.65384614467621,5.65384614467621,0,0,0,0,0,0,0,0,241,211,30,-30
David Dvorak,Bruno Silva,David Dvorak,2020-03-14,1,0,-3,3,3.333333,2.555556,-17.78,17.78,-60,60,-15.24001,15.24001,73,91,26,32,-6,6,0.777777671813965,-0.777777671813965,0,0,0,0,0,0,0,0,0,0,0,0
JP Buys,Bruno Silva,Bruno Silva,2021-03-20,0,1,-7,7,1.5,2.555556,-17.78,17.78,-50,50,-17.78001,17.78001,62,231,15,32,-17,17,-1.05555558204651,1.05555558204651,0,0,0,0,0,0,0,0,0,371,-371,371
Victor Rodriguez,Bruno Silva,Bruno Silva,2021-05-22,0,1,-3,3,1.75,2.555556,-17.78,17.78,-60,60,-17.78001,17.78001,0,2,11,32,-21,21,-0.805555582046509,0.805555582046509,0,1,1,0,-1,1,1,-1,203,63,140,-140
Andrew Sanchez,Bruno Silva,Bruno Silva,2021-10-16,0,1,1,-1,1.857143,2.555556,2.539993,-2.539993,0,0,0,0,473,15,20,32,-12,12,-0.698412775993347,0.698412775993347,1,2,1,0,-1,1,1,-1,434,147,287,-287
Alex Pereira,Bruno Silva,Alex Pereira,2022-03-12,1,0,2,-2,4,2.555556,10.15999,-10.15999,20,-20,12.7,-12.7,77,195,10,32,-22,22,1.44444441795349,-1.44444441795349,0,3,0,0,-3,3,0,0,0,147,-147,147
Gerald Meerschaert,Bruno Silva,Gerald Meerschaert,2022-08-13,1,0,1,-1,2.058824,2.555556,2.539993,-2.539993,0,0,7.619995,-7.619995,132,1,52,32,20,-20,-0.496731996536255,0.496731996536255,5,0,1,0,5,-5,1,-1,238,154,84,-84
Tyson Nam,Bruno Silva,Bruno Silva,2023-03-11,0,1,6,-6,1.5,2.555556,-12.70001,12.70001,-60,60,-15.24001,15.24001,0,53,35,32,3,-3,-1.05555558204651,1.05555558204651,1,0,0,0,1,-1,0,0,210,210,0,0
Brendan Allen,Bruno Silva,Brendan Allen,2023-06-24,1,0,-6,6,4.4,2.555556,5.080002,-5.080002,0,0,2.539993,-2.539993,149,2,27,32,-5,5,1.84444451332092,-1.84444451332092,4,1,2,0,3,-3,2,-2,119,105,14,-14
Melsik Baghdasaryan,Bruno Souza,Melsik Baghdasaryan,2021-11-06,1,0,4,-4,4,3.333333,-2.540009,2.540009,0,0,0,0,10,45,10,13,-3,3,0.666666746139526,-0.666666746139526,0,0,0,0,0,0,0,0,0,0,0,0
Luis Saldana,Bruno Souza,Luis Saldana,2022-03-26,1,0,5,-5,2.285714,3.333333,2.539993,-2.539993,0,0,7.619995,-7.619995,96,12,23,13,10,-10,-1.0476188659668,1.0476188659668,0,0,0,0,0,0,0,0,0,140,-140,140
Warlley Alves,Bryan Barberena,Bryan Barberena,2016-05-14,0,1,-2,2,2.5,1.636364,-2.540009,2.540009,0,0,0,0,115,206,21,29,-8,8,0.863636374473572,-0.863636374473572,3,0,0,0,3,-3,0,0,154,0,154,-154
Johnny Bedford,Bryan Caraway,Bryan Caraway,2013-04-27,0,1,2,-2,1.615385,2.333333,5.080002,-5.080002,0,0,7.619995,-7.619995,20,381,34,30,4,-4,-0.71794867515564,0.71794867515564,2,0,0,0,2,-2,0,0,133,0,133,-133
Raphael Assuncao,Bryan Caraway,Raphael Assuncao,2014-10-04,1,0,2,-2,2.8,2.333333,-7.619995,7.619995,0,0,-5.080002,5.080002,41,59,38,30,8,-8,0.466666698455811,-0.466666698455811,6,1,1,0,5,-5,1,-1,224,525,-301,301
Tyler Diamond,Bryce Mitchell,Bryce Mitchell,2018-07-06,0,1,4,-4,9,8,-7.62001,7.62001,0,0,-2.540009,2.540009,512,135,10,18,-8,8,1,-1,0,0,0,0,0,0,0,0,0,0,0,0
Andre Fili,Bryce Mitchell,Bryce Mitchell,2020-10-31,0,1,4,-4,2.2,8,2.539993,-2.539993,0,0,10.16,-10.16,34,612,32,18,14,-14,-5.79999995231628,5.79999995231628,1,1,1,0,0,0,1,-1,140,848,-708,708
Edson Barboza,Bryce Mitchell,Bryce Mitchell,2022-03-05,0,1,9,-9,2.090909,8,2.539993,-2.539993,0,0,12.7,-12.7,2,688,34,18,16,-16,-5.90909099578857,5.90909099578857,0,2,4,0,-2,2,4,-4,189,490,-301,301
Dan Ige,Bryce Mitchell,Bryce Mitchell,2023-09-23,0,1,4,-4,2.428571,8,-7.62001,7.62001,0,0,2.539993,-2.539993,131,453,24,18,6,-6,-5.57142853736877,5.57142853736877,2,3,0,0,-1,1,0,0,105,567,-462,462
Caio Magalhaes,Buddy Roberts,Buddy Roberts,2012-06-08,0,1,-5,5,3.333333,4,-2.540009,2.540009,0,0,-5.580002,5.580002,227,6,13,15,-2,2,-0.666666746139526,0.666666746139526,0,0,0,0,0,0,0,0,0,0,0,0
Yushin Okami,Buddy Roberts,Yushin Okami,2012-08-11,1,0,2,-2,2.833333,4,0,0,-15,15,-0.5,0.5,328,3,46,15,31,-31,-1.16666674613953,1.16666674613953,0,1,1,0,-1,1,1,-1,350,64,286,-286
Brad Morris,Cain Velasquez,Cain Velasquez,2008-04-19,0,1,3,-3,1.666667,4.666667,2.540009,-2.540009,-35,35,-2.580002,2.580002,0,108,16,17,-1,1,-2.99999988079071,2.99999988079071,0,0,0,0,0,0,0,0,0,0,0,0
"Jake O'Brien",Cain Velasquez,Cain Velasquez,2008-07-19,0,1,-2,2,3.75,4.666667,5.080002,-5.080002,-35,35,-2.540009,2.540009,0,113,19,17,2,-2,-0.916666507720947,0.916666507720947,1,1,0,0,0,0,0,0,609,91,518,-518
Denis Stojnic,Cain Velasquez,Cain Velasquez,2009-02-07,0,1,3,-3,4.333333,4.666667,-2.539993,2.539993,5,-5,-10.58,10.58,4,208,16,17,-1,1,-0.333333015441895,0.333333015441895,0,2,0,0,-2,2,0,0,0,203,-203,203
Cheick Kongo,Cain Velasquez,Cain Velasquez,2009-06-13,0,1,8,-8,2.7,4.666667,7.619995,-7.619995,0,0,12.7,-12.7,51,780,37,17,20,-20,-1.96666646003723,1.96666646003723,1,3,0,0,-2,2,0,0,784,126,658,-658
Ben Rothwell,Cain Velasquez,Cain Velasquez,2009-10-24,0,1,1,-1,2.785714,4.666667,7.619995,-7.619995,25,-25,2.539993,-2.539993,0,278,53,17,36,-36,-1.88095211982727,1.88095211982727,0,4,0,0,-4,4,0,0,0,133,-133,133
Antonio Rodrigo Nogueira,Cain Velasquez,Cain Velasquez,2010-02-20,0,1,6,-6,3.4,4.666667,5.080002,-5.080002,0,0,0,0,0,3,44,17,27,-27,-1.26666641235352,1.26666641235352,1,5,0,0,-4,4,0,0,749,119,630,-630
Brock Lesnar,Cain Velasquez,Cain Velasquez,2010-10-23,0,1,5,-5,1.666667,4.666667,5.080002,-5.080002,25,-25,10.16,-10.16,77,102,8,17,-9,9,-2.99999988079071,2.99999988079071,1,6,0,0,-5,5,0,0,469,245,224,-224
Junior Dos Santos,Cain Velasquez,Junior Dos Santos,2011-11-12,1,0,-2,2,2.333333,4.666667,7.619995,-7.619995,-2,2,0,0,8,0,30,17,13,-13,-2.33333325386047,2.33333325386047,6,7,0,0,-1,1,0,0,462,385,77,-77
Antonio Silva,Cain Velasquez,Cain Velasquez,2012-05-26,0,1,3,-3,1.583333,4.666667,7.619995,-7.619995,24,-24,12.7,-12.7,0,209,31,17,14,-14,-3.08333313465118,3.08333313465118,0,0,0,1,0,0,-1,1,0,196,-196,196
Junior Dos Santos,Cain Velasquez,Cain Velasquez,2012-12-29,0,1,-2,2,2.333333,4.666667,7.619995,-7.619995,-2,2,0,0,63,835,30,17,13,-13,-2.33333325386047,2.33333325386047,8,1,0,1,7,-7,-1,1,217,217,0,0
Antonio Silva,Cain Velasquez,Cain Velasquez,2013-05-25,0,1,3,-3,1.583333,4.666667,7.619995,-7.619995,24,-24,12.7,-12.7,0,11,31,17,14,-14,-3.08333313465118,3.08333313465118,0,2,1,1,-2,2,0,0,364,147,217,-217
Junior Dos Santos,Cain Velasquez,Cain Velasquez,2013-10-19,0,1,-2,2,2.333333,4.666667,7.619995,-7.619995,-2,2,0,0,2,1048,30,17,13,-13,-2.33333325386047,2.33333325386047,1,3,0,1,-2,2,-1,1,147,147,0,0
Travis Browne,Cain Velasquez,Cain Velasquez,2016-07-09,0,1,0,0,2.571429,4.666667,12.7,-12.7,15,-15,5.080002,-5.080002,0,156,25,17,8,-8,-2.09523797035217,2.09523797035217,2,4,1,1,-2,2,0,0,174,994,-820,820
Francis Ngannou,Cain Velasquez,Francis Ngannou,2019-02-17,1,0,-4,4,5.666667,4.666667,7.619995,-7.619995,10,-10,15.24001,-15.24001,0,2,20,17,3,-3,1,-1,1,5,0,1,-4,4,-1,1,442,953,-511,511
Paul Varelans,Cal Worsham,Paul Varelans,1995-07-14,1,0,,,1,1.3,22.86,-22.86,70,-70,23,-23,0,0,18,23,-5,5,-0.299999952316284,0.299999952316284,0,0,0,0,0,0,0,0,0,0,0,0
Zane Frazier,Cal Worsham,Cal Worsham,1996-05-17,0,1,,,0.3636364,1.3,15.24001,-15.24001,20,-20,15,-15,0,0,15,23,-8,8,-0.936363577842712,0.936363577842712,0,0,0,1,0,0,-1,1,0,308,-308,308
David Abbott,Cal Worsham,David Abbott,1996-12-07,1,0,,,0.6666667,1.3,2.540009,-2.540009,35,-35,-0.5,0.5,0,0,25,23,2,-2,-0.633333265781403,0.633333265781403,1,1,0,1,0,0,-1,1,0,204,-204,204
Tim Credeur,Cale Yarbrough,Tim Credeur,2008-07-19,1,0,10,-10,3,2.666667,5.080002,-5.080002,0,0,2.5,-2.5,2,0,16,11,5,-5,0.333333253860474,-0.333333253860474,0,0,0,0,0,0,0,0,0,0,0,0
Maki Pitolo,Callan Potter,Callan Potter,2019-10-05,0,1,-7,7,1.444444,2,-5.080002,5.080002,15,-15,7.619995,-7.619995,94,505,22,27,-5,5,-0.555555582046509,0.555555582046509,0,0,0,0,0,0,0,0,0,0,0,0
Song Kenan,Callan Potter,Song Kenan,2020-02-22,1,0,-6,6,2.857143,2,0,0,0,0,-2.540009,2.540009,7,3,27,27,0,0,0.857142925262451,-0.857142925262451,1,1,0,0,0,0,0,0,175,140,35,-35
Andre Fili,Calvin Kattar,Calvin Kattar,2017-07-29,0,1,-2,2,2.2,3.285714,0,0,0,0,5.080002,-5.080002,0,36,32,30,2,-2,-1.08571434020996,1.08571434020996,0,0,1,0,0,0,1,-1,462,0,462,-462
Shane Burgos,Calvin Kattar,Calvin Kattar,2018-01-20,0,1,-3,3,5,3.285714,0,0,0,0,7.619995,-7.619995,0,13,18,30,-12,12,1.71428561210632,-1.71428561210632,2,1,0,0,1,-1,0,0,182,175,7,-7
Chris Fishgold,Calvin Kattar,Calvin Kattar,2018-10-27,0,1,-4,4,4.5,3.285714,-7.619995,7.619995,0,0,-10.16,10.16,34,5,22,30,-8,8,1.21428561210632,-1.21428561210632,0,2,0,0,-2,2,0,0,0,280,-280,280
Dan Ige,Calvin Kattar,Calvin Kattar,2020-07-15,0,1,-4,4,2.428571,3.285714,-10.16,10.16,0,0,-2.540009,2.540009,3,66,24,30,-6,6,-0.857142925262451,0.857142925262451,1,3,0,0,-2,2,0,0,767,627,140,-140
Max Holloway,Calvin Kattar,Max Holloway,2021-01-16,1,0,-3,3,3.571429,3.285714,0,0,0,0,-7.62001,7.62001,27,5,32,30,2,-2,0.285714149475098,-0.285714149475098,0,4,0,0,-4,4,0,0,189,185,4,-4
Giga Chikadze,Calvin Kattar,Calvin Kattar,2022-01-15,0,1,0,0,5,3.285714,2.540009,-2.540009,0,0,5.080002,-5.080002,9,222,18,30,-12,12,1.71428561210632,-1.71428561210632,6,0,0,0,6,-6,0,0,259,364,-105,105
Josh Emmett,Calvin Kattar,Josh Emmett,2022-06-18,1,0,3,-3,4.5,3.285714,-12.7,12.7,0,0,-5.080002,5.080002,4,0,22,30,-8,8,1.21428561210632,-1.21428561210632,2,1,1,0,1,-1,1,-1,189,154,35,-35
Arnold Allen,Calvin Kattar,Arnold Allen,2022-10-29,1,0,-6,6,9.5,3.285714,-7.619995,7.619995,0,0,-5.080002,5.080002,23,0,21,30,-9,9,6.21428561210632,-6.21428561210632,9,0,0,0,9,-9,0,0,224,133,91,-91
Jason Dent,Cameron Dollar,Jason Dent,2009-06-20,1,0,7,-7,1.692308,2.2,-2.539993,2.539993,0,0,-2.660004,2.660004,30,5,35,16,19,-19,-0.507692337036133,0.507692337036133,0,0,0,0,0,0,0,0,840,0,840,-840
Steven Koslow,Cameron Saaiman,Cameron Saaiman,2022-12-10,0,1,4,-4,6,9,-2.540009,2.540009,-10,10,5.080002,-5.080002,280,389,7,9,-2,2,-3,3,0,0,0,0,0,0,0,0,0,0,0,0
Mana Martinez,Cameron Saaiman,Cameron Saaiman,2023-03-04,0,1,4,-4,2.5,9,5.080002,-5.080002,0,0,7.62001,-7.62001,0,247,14,9,5,-5,-6.5,6.5,0,1,0,0,-1,1,0,0,0,84,-84,84
Terrence Mitchell,Cameron Saaiman,Cameron Saaiman,2023-07-08,0,1,11,-11,3.5,9,5.080002,-5.080002,0,0,17.78001,-17.78001,66,97,18,9,9,-9,-5.5,5.5,0,2,0,0,-2,2,0,0,0,126,-126,126
Andre Fialho,Cameron VanCamp,Andre Fialho,2022-05-07,1,0,-1,1,2,2.142857,-5.080002,5.080002,15,-15,0,0,2,0,24,22,2,-2,-0.142857074737549,0.142857074737549,0,0,0,0,0,0,0,0,105,0,105,-105
Nikolas Motta,Cameron VanCamp,Nikolas Motta,2022-09-17,1,0,0,0,2.6,2.142857,-12.70001,12.70001,0,0,-10.16,10.16,5,0,18,22,-4,4,0.45714282989502,-0.45714282989502,0,0,0,1,0,0,-1,1,0,133,-133,133
Jens Pulver,Caol Uno,Jens Pulver,2001-02-23,1,0,1,-1,1.421053,1.736842,0,0,-10,10,0,0,220,114,46,52,-6,6,-0.315789580345154,0.315789580345154,2,0,0,0,2,-2,0,0,259,0,259,-259
Fabiano Iha,Caol Uno,Caol Uno,2001-06-29,0,1,4,-4,1.8,1.736842,2.540009,-2.540009,0,0,-4.800003,4.800003,0,54,14,52,-38,38,6.31577968597412e-02,-6.31577968597412e-02,2,0,0,0,2,-2,0,0,126,126,0,0
BJ Penn,Caol Uno,BJ Penn,2001-11-02,1,0,-4,4,1.142857,1.736842,5.080002,-5.080002,0,0,0,0,2,0,30,52,-22,22,-0.593984961509705,0.593984961509705,1,1,0,0,0,0,0,0,126,126,0,0
Yves Edwards,Caol Uno,Caol Uno,2002-05-10,0,1,-2,2,1.909091,1.736842,5.080002,-5.080002,0,0,7.619995,-7.619995,230,408,64,52,12,-12,0.172248721122742,-0.172248721122742,0,0,0,1,0,0,-1,1,224,189,35,-35
Din Thomas,Caol Uno,Caol Uno,2002-09-27,0,1,-2,2,2.888889,1.736842,5.080002,-5.080002,0,0,0.1999969,-0.1999969,210,553,35,52,-17,17,1.15204668045044,-1.15204668045044,0,1,0,1,-1,1,-1,1,0,140,-140,140
Hermes Franca,Caol Uno,Hermes Franca,2003-09-26,1,0,1,-1,1.411765,1.736842,-2.539993,2.539993,0,0,2.539993,-2.539993,84,281,41,52,-11,11,-0.325077414512634,0.325077414512634,0,2,0,1,-2,2,-1,1,0,364,-364,364
Spencer Fisher,Caol Uno,Spencer Fisher,2009-06-13,1,0,-1,1,2.666667,1.736842,0,0,0,0,-5.080002,5.080002,186,433,33,52,-19,19,0.929824590682983,-0.929824590682983,3,0,1,2,3,-3,-1,1,231,2087,-1856,1856
Gleison Tibau,Caol Uno,Gleison Tibau,2010-03-31,1,0,-8,8,2.357143,1.736842,7.62001,-7.62001,0,0,2.539993,-2.539993,89,0,47,52,-5,5,0.620300769805908,-0.620300769805908,0,0,0,2,0,0,-2,2,0,291,-291,291
Taylor Lapilus,Caolan Loughran,Taylor Lapilus,2023-09-02,1,0,4,-4,6.333333,8,0,0,0,0,12.7,-12.7,18,386,22,9,13,-13,-1.66666650772095,1.66666650772095,0,0,0,0,0,0,0,0,2842,0,2842,-2842
Cynthia Calvillo,Carla Esparza,Carla Esparza,2017-12-30,0,1,0,0,1.5,2.857143,7.619995,-7.619995,0,0,2.539993,-2.539993,263,21,15,27,-12,12,-1.35714292526245,1.35714292526245,3,0,0,0,3,-3,0,0,167,0,167,-167
Alex Oliveira,Carlo Pedersoli Jr.,Alex Oliveira,2018-09-22,1,0,5,-5,1.833333,3.666667,0,0,0,0,2.539993,-2.539993,5,0,34,14,20,-20,-1.83333337306976,1.83333337306976,0,0,0,0,0,0,0,0,0,0,0,0
Dwight Grant,Carlo Pedersoli Jr.,Dwight Grant,2019-02-23,1,0,9,-9,1.833333,3.666667,5.080002,-5.080002,15,-15,2.539993,-2.539993,5,19,17,14,3,-3,-1.83333337306976,1.83333337306976,0,0,0,1,0,0,-1,1,70,154,-84,84
TJ Grant,Carlo Prater,TJ Grant,2012-05-15,1,0,-2,2,4.2,1.722222,-2.539993,2.539993,0,0,0,0,414,35,26,49,-23,23,2.47777760028839,-2.47777760028839,2,0,0,0,2,-2,0,0,227,0,227,-227
Marcus LeVesseur,Carlo Prater,Marcus LeVesseur,2012-10-05,1,0,-1,1,3.142857,1.722222,-5.080002,5.080002,0,0,-5.080002,5.080002,508,132,29,49,-20,20,1.4206348657608,-1.4206348657608,0,0,0,0,0,0,0,0,143,143,0,0
Thiago Alves,Carlos Condit,Carlos Condit,2015-05-30,0,1,0,0,1.533333,2.285714,-12.70001,12.70001,0,0,-12.7,12.7,5,153,38,46,-8,8,-0.752381086349487,0.752381086349487,2,0,1,0,2,-2,1,-1,119,0,119,-119
Michael Chiesa,Carlos Condit,Michael Chiesa,2018-12-29,1,0,-3,3,2.571429,2.285714,-2.540009,2.540009,0,0,0,0,252,18,25,46,-21,21,0.285714149475098,-0.285714149475098,0,1,1,0,-1,1,1,-1,175,1309,-1134,1134
Matt Brown,Carlos Condit,Carlos Condit,2021-01-16,0,1,4,-4,1.368421,2.285714,-5.080002,5.080002,0,0,0,0,366,292,45,46,-1,1,-0.917293310165405,0.917293310165405,2,0,2,0,2,-2,2,-2,399,749,-350,350
Yorgan De Castro,Carlos Felipe,Carlos Felipe,2020-10-03,0,1,8,-8,2,5.5,0,0,5,-5,-2.539993,2.539993,193,88,9,13,-4,4,-3.5,3.5,0,0,0,0,0,0,0,0,147,0,147,-147
Jake Collier,Carlos Felipe,Carlos Felipe,2021-06-12,0,1,6,-6,1.3,5.5,7.619995,-7.619995,-15,15,7.619995,-7.619995,0,2,23,13,10,-10,-4.20000004768372,4.20000004768372,3,1,2,0,2,-2,2,-2,189,252,-63,63
Andrei Arlovski,Carlos Felipe,Andrei Arlovski,2021-10-16,1,0,16,-16,1.545455,5.5,7.619995,-7.619995,-5,5,5.080002,-5.080002,0,82,56,13,43,-43,-3.95454549789429,3.95454549789429,1,2,7,0,-1,1,7,-7,182,126,56,-56
Victor Altamirano,Carlos Hernandez,Carlos Hernandez,2022-02-26,0,1,3,-3,4,4.5,0,0,0,0,7.62001,-7.62001,87,82,15,11,4,-4,-0.5,0.5,0,0,0,0,0,0,0,0,0,0,0,0
Denys Bondar,Carlos Hernandez,Carlos Hernandez,2023-06-17,0,1,1,-1,3.2,4.5,-5.080002,5.080002,0,0,5.080002,-5.080002,29,40,21,11,10,-10,-1.29999995231628,1.29999995231628,0,1,1,0,-1,1,1,-1,497,476,21,-21
Raoni Barcelos,Carlos Huachin,Raoni Barcelos,2019-05-11,1,0,10,-10,3.4,2,7.619995,-7.619995,0,0,0,0,203,0,22,15,7,-7,1.40000009536743,-1.40000009536743,2,0,0,0,2,-2,0,0,162,0,162,-162
Cody Durden,Carlos Mota,Cody Durden,2022-10-29,1,0,4,-4,4,4,7.619995,-7.619995,0,0,-5.080002,5.080002,752,11,20,10,10,-10,0,0,0,0,0,0,0,0,0,0,224,0,224,-224
Dan Henderson,Carlos Newton,Dan Henderson,1998-05-15,1,0,6,-6,2.133333,1.142857,5.080002,-5.080002,15,-15,9.960007,-9.960007,0,0,47,30,17,-17,0.990476250648499,-0.990476250648499,0,0,0,0,0,0,0,0,0,0,0,0
Bob Gilstrap,Carlos Newton,Carlos Newton,1998-05-15,0,1,,,0.7142857,1.142857,15.24001,-15.24001,30,-30,15,-15,0,0,12,30,-18,18,-0.428571462631226,0.428571462631226,0,0,0,0,0,0,0,0,0,0,0,0
Pat Miletich,Carlos Newton,Carlos Newton,2001-05-04,0,1,9,-9,4.142857,1.142857,2.540009,-2.540009,0,0,2,-2,44,271,36,30,6,-6,2.99999988079071,-2.99999988079071,4,1,0,0,3,-3,0,0,139,1085,-946,946
Matt Hughes,Carlos Newton,Matt Hughes,2001-11-02,1,0,3,-3,5,1.142857,0,0,0,0,7.419998,-7.419998,244,93,54,30,24,-24,3.85714280605316,-3.85714280605316,1,2,0,0,-1,1,0,0,770,182,588,-588
Matt Hughes,Carlos Newton,Matt Hughes,2002-07-13,1,0,3,-3,5,1.142857,0,0,0,0,7.419998,-7.419998,977,52,54,30,24,-24,3.85714280605316,-3.85714280605316,3,0,0,1,3,-3,-1,1,113,253,-140,140
Kennedy Nzechukwu,Carlos Ulberg,Kennedy Nzechukwu,2021-03-06,1,0,-2,2,3,10,2.540009,-2.540009,0,0,15.24001,-15.24001,5,5,16,11,5,-5,-7,7,1,0,0,0,1,-1,0,0,581,0,581,-581
Fabio Cherant,Carlos Ulberg,Carlos Ulberg,2022-02-12,0,1,-4,4,1.75,10,-7.619995,7.619995,0,0,-7.619995,7.619995,22,75,11,11,0,0,-8.25,8.25,0,0,1,1,0,0,0,0,175,343,-168,168
Tafon Nchukwi,Carlos Ulberg,Carlos Ulberg,2022-06-25,0,1,-4,4,1.5,10,-10.15999,10.15999,-20,20,0,0,0,4,10,11,-1,1,-8.5,8.5,1,1,0,1,0,0,-1,1,280,133,147,-147
Nicolae Negumereanu,Carlos Ulberg,Carlos Ulberg,2022-11-12,0,1,-4,4,6.5,10,-10.15999,10.15999,0,0,2.539993,-2.539993,0,5,15,11,4,-4,-3.5,3.5,3,2,0,1,1,-1,-1,1,105,140,-35,35
Ihor Potieria,Carlos Ulberg,Carlos Ulberg,2023-05-13,0,1,-6,6,4.75,10,-2.539993,2.539993,0,0,-5.080002,5.080002,0,8,23,11,12,-12,-5.25,5.25,1,3,0,1,-2,2,-1,1,112,182,-70,70
Naoki Inoue,Carls John De Tomas,Naoki Inoue,2017-06-17,1,0,0,0,11,3,10.15999,-10.15999,0,0,0,0,516,77,12,8,4,-4,8,-8,0,0,0,0,0,0,0,0,0,0,0,0
Christian Aguilera,Carlston Harris,Carlston Harris,2021-05-08,0,1,-4,4,1.75,3.8,-7.62001,7.62001,0,0,-10.15999,10.15999,32,52,22,24,-2,2,-2.04999995231628,2.04999995231628,0,0,0,0,0,0,0,0,252,0,252,-252
Jared Gooden,Carlston Harris,Carlston Harris,2023-03-11,0,1,-6,6,2.444444,3.8,0,0,0,0,2.540009,-2.540009,2,578,31,24,7,-7,-1.35555553436279,1.35555553436279,1,1,0,0,0,0,0,0,588,672,-84,84
Christos Giagos,Carlton Minus,Christos Giagos,2020-12-19,1,0,3,-3,1.818182,3.333333,0,0,-15,15,-10.16,10.16,537,0,31,13,18,-18,-1.51515138149261,1.51515138149261,0,0,0,0,0,0,0,0,490,0,490,-490
Cheick Kongo,Carmelo Marrero,Carmelo Marrero,2006-10-14,0,1,6,-6,2.7,2.666667,10.15999,-10.15999,35,-35,22.86,-22.86,165,542,37,22,15,-15,3.33333015441895e-02,-3.33333015441895e-02,1,0,0,0,1,-1,0,0,49,0,49,-49
Gabriel Gonzaga,Carmelo Marrero,Gabriel Gonzaga,2006-12-30,1,0,2,-2,1.545455,2.666667,5.080002,-5.080002,37,-37,7.619995,-7.619995,178,0,28,22,6,-6,-1.12121224403381,1.12121224403381,2,1,0,0,1,-1,0,0,217,77,140,-140
Wilson Gouveia,Carmelo Marrero,Wilson Gouveia,2007-05-26,1,0,2,-2,1.75,2.666667,2.539993,-2.539993,-20,20,7.619995,-7.619995,39,0,22,22,0,0,-0.916666746139526,0.916666746139526,1,0,0,0,1,-1,0,0,51,147,-96,96
Ryan Bader,Carmelo Marrero,Ryan Bader,2009-04-01,1,0,-3,3,4.6,2.666667,5.080002,-5.080002,0,0,2.540009,-2.540009,606,61,28,22,6,-6,1.93333315849304,-1.93333315849304,1,0,0,0,1,-1,0,0,109,676,-567,567
Ray Borg,Casey Kenney,Casey Kenney,2019-03-30,0,1,-3,3,2.6,4,-7.619995,7.619995,0,0,-12.7,12.7,393,384,18,20,-2,2,-1.40000009536743,1.40000009536743,0,0,0,0,0,0,0,0,539,0,539,-539
Manny Bermudez,Casey Kenney,Casey Kenney,2019-08-17,0,1,-3,3,7,4,7.62001,-7.62001,10,-10,7.619995,-7.619995,370,317,16,20,-4,4,3,-3,3,1,0,0,2,-2,0,0,181,140,41,-41
Merab Dvalishvili,Casey Kenney,Merab Dvalishvili,2020-02-15,1,0,1,-1,4,4,-2.539993,2.539993,0,0,0,0,340,5,20,20,0,0,0,0,2,2,0,0,0,0,0,0,287,182,105,-105
Dominick Cruz,Casey Kenney,Dominick Cruz,2021-03-06,1,0,6,-6,6,4,2.540009,-2.540009,0,0,0,0,127,26,28,20,8,-8,2,-2,0,0,0,0,0,0,0,0,1527,385,1142,-1142
Shana Dobson,"Casey O'Neill","Casey O'Neill",2021-02-20,0,1,8,-8,0.8,9,0,0,0,0,0,0,13,446,9,10,-1,1,-8.19999998807907,8.19999998807907,0,0,0,0,0,0,0,0,553,0,553,-553
Roxanne Modafferi,"Casey O'Neill","Casey O'Neill",2022-02-12,0,1,15,-15,1.190476,9,2.539993,-2.539993,0,0,0,0,66,2,46,10,36,-36,-7.80952382087708,7.80952382087708,0,1,0,0,-1,1,0,0,140,357,-217,217
Jennifer Maia,"Casey O'Neill",Jennifer Maia,2023-03-18,1,0,9,-9,2.333333,9,-5.080002,5.080002,0,0,-12.7,12.7,83,0,30,10,20,-20,-6.66666674613953,6.66666674613953,1,2,0,0,-1,1,0,0,119,399,-280,280
Miesha Tate,Cat Zingano,Cat Zingano,2013-04-13,0,1,-4,4,2.111111,2.5,0,0,-10,10,-7.619995,7.619995,296,353,28,14,14,-14,-0.388888835906982,0.388888835906982,0,0,0,0,0,0,0,0,0,0,0,0
Amanda Nunes,Cat Zingano,Cat Zingano,2014-09-27,0,1,-6,6,4.6,2.5,5.080002,-5.080002,-10,10,2.539993,-2.539993,188,417,28,14,14,-14,2.09999990463257,-2.09999990463257,0,1,0,0,-1,1,0,0,0,532,-532,532
Ronda Rousey,Cat Zingano,Ronda Rousey,2015-02-28,1,0,-4,4,6,2.5,2.539993,-2.539993,-10,10,-5.080002,5.080002,5,3,14,14,0,0,3.5,-3.5,1,2,0,0,-1,1,0,0,427,154,273,-273
Julianna Pena,Cat Zingano,Julianna Pena,2016-07-09,1,0,-8,8,2.4,2.5,0,0,-10,10,2.539993,-2.539993,292,545,17,14,3,-3,-9.99999046325684e-02,9.99999046325684e-02,1,0,0,0,1,-1,0,0,952,497,455,-455
Ketlen Vieira,Cat Zingano,Ketlen Vieira,2018-03-03,1,0,-9,9,4.666667,2.5,5.080002,-5.080002,-10,10,0,0,609,14,17,14,3,-3,2.16666650772095,-2.16666650772095,0,0,0,0,0,0,0,0,0,602,-602,602
Marion Reneau,Cat Zingano,Cat Zingano,2018-07-14,0,1,5,-5,1.125,2.5,0,0,-10,10,0,0,76,534,17,14,3,-3,-1.375,1.375,0,0,0,0,0,0,0,0,0,133,-133,133
Megan Anderson,Cat Zingano,Megan Anderson,2018-12-29,1,0,-8,8,2.2,2.5,15.24001,-15.24001,0,0,10.16,-10.16,0,0,16,14,2,-2,-0.299999952316284,0.299999952316284,0,1,0,0,-1,1,0,0,203,168,35,-35
Mike King,Cathal Pendred,Cathal Pendred,2014-07-19,0,1,4,-4,5,4.25,5.080002,-5.080002,15,-15,2.5,-2.5,141,122,6,21,-15,15,0.75,-0.75,0,0,0,0,0,0,0,0,0,0,0,0
Augusto Montano,Cathal Pendred,Cathal Pendred,2015-06-13,0,1,3,-3,5,4.25,0,0,0,0,-5.080002,5.080002,0,382,18,21,-3,3,0.75,-0.75,0,1,0,0,-1,1,0,0,0,329,-329,329
John Howard,Cathal Pendred,John Howard,2015-07-11,1,0,5,-5,1.846154,4.25,-15.24001,15.24001,0,0,-7.619995,7.619995,95,45,37,21,16,-16,-2.40384614467621,2.40384614467621,0,2,1,0,-2,2,1,-1,174,28,146,-146
Tom Breese,Cathal Pendred,Tom Breese,2015-10-24,1,0,-4,4,4,4.25,5.080002,-5.080002,15,-15,-5.080002,5.080002,3,29,15,21,-6,6,-0.25,0.25,1,0,0,0,1,-1,0,0,147,105,42,-42
Joe Doerksen,CB Dollaway,CB Dollaway,2010-09-25,0,1,5,-5,3.1875,1.888889,-5.080002,5.080002,0,0,-2.539993,2.539993,97,8,67,26,41,-41,1.29861116409302,-1.29861116409302,1,0,3,0,1,-1,3,-3,140,0,140,-140
Tim Boetsch,CB Dollaway,Tim Boetsch,2013-10-19,1,0,2,-2,1.615385,1.888889,-5.080002,5.080002,0,0,-5.079987,5.079987,119,237,34,26,8,-8,-0.273504257202148,0.273504257202148,0,1,2,0,-1,1,2,-2,105,1120,-1015,1015
Francis Carmont,CB Dollaway,CB Dollaway,2014-05-31,0,1,2,-2,2.083333,1.888889,2.539993,-2.539993,20,-20,5.080002,-5.080002,86,373,37,26,11,-11,0.194444417953491,-0.194444417953491,0,0,0,0,0,0,0,0,105,224,-119,119
Michael Bisping,CB Dollaway,Michael Bisping,2015-04-25,1,0,5,-5,3.333333,1.888889,-2.540009,2.540009,0,0,-2.539993,2.539993,23,75,39,26,13,-13,1.44444441795349,-1.44444441795349,0,1,1,0,-1,1,1,-1,169,329,-160,160
CB Dollaway,Cezar Ferreira,CB Dollaway,2014-03-23,1,0,1,-1,1.888889,1.625,2.540009,-2.540009,0,0,-5.080002,5.080002,8,0,26,21,5,-5,0.263888835906982,-0.263888835906982,2,0,2,0,2,-2,2,-2,428,0,428,-428
Andrew Craig,Cezar Ferreira,Cezar Ferreira,2014-06-28,0,1,-1,1,2.25,1.625,0,0,-15,15,-5.080002,5.080002,33,326,13,21,-8,8,0.625,-0.625,1,0,0,1,1,-1,-1,1,357,97,260,-260
Sam Alvey,Cezar Ferreira,Sam Alvey,2015-02-22,1,0,-2,2,1.833333,1.625,2.540009,-2.540009,0,0,-7.619995,7.619995,3,0,51,21,30,-30,0.208333373069763,-0.208333373069763,1,1,0,1,0,0,-1,1,107,239,-132,132
Oluwale Bamgbose,Cezar Ferreira,Cezar Ferreira,2016-04-16,0,1,-3,3,1.5,1.625,-5.080002,5.080002,0,0,0,0,54,411,10,21,-11,11,-0.125,0.125,1,0,1,2,1,-1,-1,1,55,419,-364,364
Travis Browne,Chad Griggs,Travis Browne,2012-04-21,1,0,-4,4,2.571429,3.666667,12.7,-12.7,50,-50,15.24001,-15.24001,94,0,25,14,11,-11,-1.09523820877075,1.09523820877075,2,0,0,0,2,-2,0,0,329,0,329,-329
Cyrille Diabate,Chad Griggs,Cyrille Diabate,2012-11-17,1,0,5,-5,1.9,3.666667,12.7,-12.7,0,0,20.32001,-20.32001,116,7,29,14,15,-15,-1.76666676998138,1.76666676998138,0,0,0,0,0,0,0,0,378,210,168,-168
Olivier Aubin-Mercier,Chad Laprise,Chad Laprise,2014-04-16,0,1,-2,2,2.2,3.25,-2.540009,2.540009,-15,15,-2.539993,2.539993,65,14,16,17,-1,1,-1.04999995231628,1.04999995231628,0,0,0,0,0,0,0,0,0,0,0,0
Yosdenis Cedeno,Chad Laprise,Chad Laprise,2014-10-04,0,1,1,-1,1.666667,3.25,-5.080002,5.080002,-15,15,-5.080002,5.080002,49,459,16,17,-1,1,-1.58333337306976,1.58333337306976,1,1,0,0,0,0,0,0,80,171,-91,91
Bryan Barberena,Chad Laprise,Chad Laprise,2015-04-25,0,1,-3,3,1.636364,3.25,5.080002,-5.080002,0,0,2.540009,-2.540009,34,10,29,17,12,-12,-1.61363637447357,1.61363637447357,1,2,0,0,-1,1,0,0,133,203,-70,70
Thibault Gouti,Chad Laprise,Chad Laprise,2016-08-27,0,1,-1,1,2.4,3.25,0,0,-15,15,2.540009,-2.540009,0,30,17,17,0,0,-0.849999904632568,0.849999904632568,0,3,0,0,-3,3,0,0,182,490,-308,308
Brian Camozzi,Chad Laprise,Chad Laprise,2017-07-08,0,1,-4,4,1.4,3.25,10.16,-10.16,0,0,17.78,-17.78,0,32,12,17,-5,5,-1.85000002384186,1.85000002384186,0,4,0,0,-4,4,0,0,0,315,-315,315
Galore Bofando,Chad Laprise,Chad Laprise,2017-12-16,0,1,4,-4,1.666667,3.25,2.539993,-2.539993,0,0,2.540009,-2.540009,0,142,8,17,-9,9,-1.58333337306976,1.58333337306976,1,5,0,0,-4,4,0,0,153,161,-8,8
Jose Aldo,Chad Mendes,Jose Aldo,2012-01-14,1,0,-1,1,3.875,3.6,2.539993,-2.539993,-10,10,10.16,-10.16,2,55,39,23,16,-16,0.275000095367432,-0.275000095367432,2,0,0,0,2,-2,0,0,98,0,98,-98
Cody McKenzie,Chad Mendes,Chad Mendes,2012-07-07,0,1,-3,3,1.6,3.6,15.24001,-15.24001,10,-10,15.24001,-15.24001,0,3,26,23,3,-3,-1.99999988079071,1.99999988079071,0,0,0,1,0,0,-1,1,294,175,119,-119
Darren Elkins,Chad Mendes,Chad Mendes,2013-04-20,0,1,1,-1,2.454545,3.6,10.16,-10.16,0,0,12.7,-12.7,0,3,38,23,15,-15,-1.14545440673828,1.14545440673828,3,1,0,1,2,-2,-1,1,154,287,-133,133
Clay Guida,Chad Mendes,Chad Mendes,2013-08-31,0,1,3,-3,1.9,3.6,2.539993,-2.539993,10,-10,10.16,-10.16,5,187,58,23,35,-35,-1.69999992847443,1.69999992847443,1,2,0,1,-1,1,-1,1,217,133,84,-84
Nik Lentz,Chad Mendes,Chad Mendes,2013-12-14,0,1,1,-1,2.5,3.6,5.080002,-5.080002,0,0,5.080002,-5.080002,6,315,42,23,19,-19,-1.09999990463257,1.09999990463257,5,3,0,1,2,-2,-1,1,329,105,224,-224
Jose Aldo,Chad Mendes,Jose Aldo,2014-10-25,1,0,-1,1,3.875,3.6,2.539993,-2.539993,-10,10,10.16,-10.16,67,129,39,23,16,-16,0.275000095367432,-0.275000095367432,6,4,0,1,2,-2,-1,1,266,315,-49,49
Ricardo Lamas,Chad Mendes,Chad Mendes,2015-04-04,0,1,3,-3,2.5,3.6,5.080002,-5.080002,0,0,12.7,-12.7,0,41,28,23,5,-5,-1.09999990463257,1.09999990463257,1,0,0,1,1,-1,-1,1,1239,161,1078,-1078
Conor McGregor,Chad Mendes,Conor McGregor,2015-07-11,1,0,-4,4,3.666667,3.6,7.619995,-7.619995,10,-10,20.32001,-20.32001,4,317,28,23,5,-5,6.6666841506958e-02,-6.6666841506958e-02,2,1,0,1,1,-1,-1,1,174,98,76,-76
Frankie Edgar,Chad Mendes,Frankie Edgar,2015-12-11,1,0,4,-4,2.090909,3.6,0,0,-10,10,5.080002,-5.080002,1,0,34,23,11,-11,-1.50909090042114,1.50909090042114,4,0,0,2,4,-4,-2,2,209,153,56,-56
Myles Jury,Chad Mendes,Chad Mendes,2018-07-14,0,1,-4,4,4.25,3.6,10.16,-10.16,0,0,17.78,-17.78,0,26,21,23,-2,2,0.650000095367432,-0.650000095367432,0,0,0,3,0,0,-3,3,938,946,-8,8
Joshua Burkman,Chad Reiner,Joshua Burkman,2007-01-25,1,0,1,-1,1.75,1.833333,-2.539993,2.539993,0,0,-0.1199951,0.1199951,736,87,44,51,-7,7,-8.33333730697632e-02,8.33333730697632e-02,1,0,0,0,1,-1,0,0,201,0,201,-201
Anthony Johnson,Chad Reiner,Anthony Johnson,2007-06-12,1,0,-2,2,3.666667,1.833333,7.62001,-7.62001,35,-35,15.12,-15.12,1,0,28,51,-23,23,1.83333337306976,-1.83333337306976,0,0,0,0,0,0,0,0,0,138,-138,138
Renato Sobral,Chael Sonnen,Renato Sobral,2005-10-07,1,0,2,-2,3.363636,1.933333,0,0,0,0,5.080002,-5.080002,163,182,48,44,4,-4,1.43030297756195,-1.43030297756195,1,0,0,0,1,-1,0,0,174,0,174,-174
Trevor Prangley,Chael Sonnen,Chael Sonnen,2006-04-06,0,1,4,-4,3.090909,1.933333,0,0,-20,20,5.080002,-5.080002,70,662,45,44,1,-1,1.15757572650909,-1.15757572650909,1,0,0,0,1,-1,0,0,656,181,475,-475
Jeremy Horn,Chael Sonnen,Jeremy Horn,2006-05-27,1,0,1,-1,4.136364,1.933333,0,0,-20,20,2.540009,-2.540009,0,347,113,44,69,-69,2.20303022861481,-2.20303022861481,1,1,1,0,0,0,1,-1,189,51,138,-138
Demian Maia,Chael Sonnen,Demian Maia,2009-02-21,1,0,0,0,2.545455,1.933333,0,0,-35,35,-2.539993,2.539993,9,87,39,44,-5,5,0.612121224403381,-0.612121224403381,1,0,0,0,1,-1,0,0,98,1001,-903,903
Dan Miller,Chael Sonnen,Chael Sonnen,2009-05-23,0,1,-5,5,1.75,1.933333,0,0,-20,20,2.540009,-2.540009,1,832,22,44,-22,22,-0.183333277702332,0.183333277702332,1,0,0,0,1,-1,0,0,105,91,14,-14
Yushin Okami,Chael Sonnen,Chael Sonnen,2009-10-24,0,1,-4,4,2.833333,1.933333,2.540009,-2.540009,-35,35,5.080002,-5.080002,19,311,46,44,2,-2,0.899999976158142,-0.899999976158142,4,1,0,0,3,-3,0,0,602,154,448,-448
Nate Marquardt,Chael Sonnen,Chael Sonnen,2010-02-06,0,1,-2,2,1.842105,1.933333,-2.539993,2.539993,-20,20,2.540009,-2.540009,57,781,54,44,10,-10,-9.12280082702637e-02,9.12280082702637e-02,0,2,1,0,-2,2,1,-1,945,105,840,-840
Anderson Silva,Chael Sonnen,Anderson Silva,2010-08-07,1,0,2,-2,3.090909,1.933333,2.540009,-2.540009,-20,20,10.16,-10.16,29,1193,45,44,1,-1,1.15757572650909,-1.15757572650909,0,3,0,0,-3,3,0,0,0,182,-182,182
Michael Bisping,Chael Sonnen,Chael Sonnen,2012-01-28,0,1,-2,2,3.333333,1.933333,0,0,-20,20,5.080002,-5.080002,252,451,39,44,-5,5,1.39999997615814,-1.39999997615814,3,0,1,0,3,-3,1,-1,56,539,-483,483
Anderson Silva,Chael Sonnen,Anderson Silva,2012-07-07,1,0,2,-2,3.090909,1.933333,2.540009,-2.540009,-20,20,10.16,-10.16,19,354,45,44,1,-1,1.15757572650909,-1.15757572650909,1,1,0,0,0,0,0,0,700,161,539,-539
Jon Jones,Chael Sonnen,Jon Jones,2013-04-27,1,0,-11,11,27,1.933333,7.619995,-7.619995,43,-43,27.94,-27.94,246,0,28,44,-16,16,25.0666667222977,-25.0666667222977,5,0,0,1,5,-5,-1,1,504,294,210,-210
Mauricio Rua,Chael Sonnen,Chael Sonnen,2013-08-17,0,1,-5,5,1.928571,1.933333,0,0,0,0,7.619995,-7.619995,50,229,41,44,-3,3,-4.76181507110596e-03,4.76181507110596e-03,1,0,0,2,1,-1,-2,2,378,112,266,-266
Rashad Evans,Chael Sonnen,Rashad Evans,2013-11-16,1,0,-2,2,2.375,1.933333,-2.539993,2.539993,0,0,5.080002,-5.080002,193,35,27,44,-17,17,0.441666722297668,-0.441666722297668,1,1,1,2,0,0,-1,1,154,91,63,-63
Leonard Garcia,Chan Sung Jung,Chan Sung Jung,2011-03-26,0,1,7,-7,1.384615,2.125,7.62001,-7.62001,0,0,-10.16,10.16,0,162,31,25,6,-6,-0.740384578704834,0.740384578704834,1,0,0,0,1,-1,0,0,112,0,112,-112
Mark Hominick,Chan Sung Jung,Chan Sung Jung,2011-12-10,0,1,5,-5,1.666667,2.125,2.540009,-2.540009,0,0,-10.16,10.16,0,3,32,25,7,-7,-0.458333373069763,0.458333373069763,1,1,0,0,0,0,0,0,322,259,63,-63
Dustin Poirier,Chan Sung Jung,Chan Sung Jung,2012-05-15,0,1,-2,2,3.625,2.125,5.080002,-5.080002,10,-10,0,0,231,302,37,25,12,-12,1.5,-1.5,1,2,0,0,-1,1,0,0,339,157,182,-182
Jose Aldo,Chan Sung Jung,Jose Aldo,2013-08-03,1,0,0,0,3.875,2.125,0,0,-10,10,-5.080002,5.080002,300,3,39,25,14,-14,1.75,-1.75,4,3,0,0,1,-1,0,0,182,445,-263,263
Dennis Bermudez,Chan Sung Jung,Chan Sung Jung,2017-02-04,0,1,1,-1,1.888889,2.125,-2.539993,2.539993,10,-10,-15.24001,15.24001,20,5,26,25,1,-1,-0.236111164093018,0.236111164093018,2,0,1,1,2,-2,0,0,182,1281,-1099,1099
Yair Rodriguez,Chan Sung Jung,Yair Rodriguez,2018-11-10,1,0,-5,5,4,2.125,10.16,-10.16,0,0,-2.540009,2.540009,19,60,20,25,-5,5,1.875,-1.875,1,1,0,1,0,0,-1,1,1246,644,602,-602
Renato Moicano,Chan Sung Jung,Chan Sung Jung,2019-06-22,0,1,-2,2,3.4,2.125,10.16,-10.16,10,-10,0,0,0,26,22,25,-3,3,1.27500009536743,-1.27500009536743,1,0,0,2,1,-1,-2,2,322,224,98,-98
Frankie Edgar,Chan Sung Jung,Chan Sung Jung,2019-12-21,0,1,6,-6,2.090909,2.125,-2.539993,2.539993,-10,10,-10.16,10.16,132,0,34,25,9,-9,-3.40909957885742e-02,3.40909957885742e-02,0,1,1,2,-1,1,-1,1,147,182,-35,35
Brian Ortega,Chan Sung Jung,Brian Ortega,2020-10-17,1,0,-4,4,5,2.125,2.540009,-2.540009,0,0,-7.62001,7.62001,57,0,18,25,-7,7,2.875,-2.875,2,2,0,2,0,0,-2,2,1043,301,742,-742
Dan Ige,Chan Sung Jung,Chan Sung Jung,2021-06-19,0,1,-5,5,2.428571,2.125,0,0,0,0,-2.540009,2.540009,113,610,24,25,-1,1,0.303571462631226,-0.303571462631226,1,0,0,2,1,-1,-2,2,98,245,-147,147
Max Holloway,Chan Sung Jung,Max Holloway,2023-08-26,1,0,-5,5,3.571429,2.125,10.16,-10.16,0,0,-7.62001,7.62001,57,15,32,25,7,-7,1.44642853736877,-1.44642853736877,0,1,0,2,-1,1,-2,2,420,798,-378,378
JJ Aldrich,Chan-Mi Jeon,JJ Aldrich,2017-06-10,1,0,5,-5,2,2.5,0,0,10,-10,5.179993,-5.179993,0,2,18,7,11,-11,-0.5,0.5,0,0,0,0,0,0,0,0,183,0,183,-183
Belal Muhammad,Chance Rencountre,Belal Muhammad,2018-06-01,1,0,-2,2,7.666667,3.5,-7.62001,7.62001,0,0,-7.619995,7.619995,123,0,26,18,8,-8,4.16666650772095,-4.16666650772095,0,0,0,0,0,0,0,0,0,0,0,0
Ismail Naurdiev,Chance Rencountre,Chance Rencountre,2019-07-06,0,1,-10,10,4.75,3.5,-10.16,10.16,0,0,-2.539993,2.539993,22,675,23,18,5,-5,1.25,-1.25,1,0,0,0,1,-1,0,0,133,400,-267,267
Lyman Good,Chance Rencountre,Lyman Good,2019-11-02,1,0,2,-2,3.5,3.5,-5.080002,5.080002,0,0,-2.539993,2.539993,10,24,27,18,9,-9,0,0,0,1,0,0,-1,1,0,0,273,119,154,-154
Jimmy Flick,Charles Johnson,Charles Johnson,2023-01-14,0,1,0,0,2.285714,2.6,-5.080002,5.080002,0,0,-5.080002,5.080002,24,99,23,18,5,-5,-0.314285516738892,0.314285516738892,0,0,0,0,0,0,0,0,0,0,0,0
Cody Durden,Charles Johnson,Cody Durden,2023-04-29,1,0,0,0,4,2.6,-5.080002,5.080002,0,0,-7.62001,7.62001,573,8,20,18,2,-2,1.40000009536743,-1.40000009536743,1,1,0,0,0,0,0,0,182,105,77,-77
Desmond Green,Charles Jourdain,Desmond Green,2019-05-18,1,0,6,-6,2.875,2.5,2.540009,-2.540009,10,-10,10.16,-10.16,121,0,31,21,10,-10,0.375,-0.375,1,0,0,0,1,-1,0,0,49,0,49,-49
Dooho Choi,Charles Jourdain,Charles Jourdain,2019-12-21,0,1,4,-4,3.5,2.5,2.540009,-2.540009,0,0,2.540009,-2.540009,68,21,18,21,-3,3,1,-1,0,0,1,0,0,0,1,-1,706,217,489,-489
Andre Fili,Charles Jourdain,Andre Fili,2020-06-13,1,0,5,-5,2.2,2.5,5.080002,-5.080002,0,0,12.70001,-12.70001,106,14,32,21,11,-11,-0.299999952316284,0.299999952316284,0,1,1,0,-1,1,1,-1,147,175,-28,28
Julian Erosa,Charles Jourdain,Julian Erosa,2021-09-04,1,0,7,-7,2.333333,2.5,10.16,-10.16,0,0,12.70001,-12.70001,155,0,40,21,19,-19,-0.166666746139526,0.166666746139526,2,0,2,0,2,-2,2,-2,196,448,-252,252
Andre Ewell,Charles Jourdain,Charles Jourdain,2021-12-18,0,1,7,-7,1.888889,2.5,-2.539993,2.539993,0,0,15.24001,-15.24001,35,147,26,21,5,-5,-0.611111164093018,0.611111164093018,0,0,1,0,0,0,1,-1,308,105,203,-203
Shane Burgos,Charles Jourdain,Shane Burgos,2022-07-16,1,0,5,-5,5,2.5,5.080002,-5.080002,0,0,15.24001,-15.24001,385,128,18,21,-3,3,2.5,-2.5,1,1,1,0,0,0,1,-1,252,210,42,-42
Kron Gracie,Charles Jourdain,Charles Jourdain,2023-05-06,0,1,7,-7,2.5,2.5,0,0,0,0,2.540009,-2.540009,43,408,7,21,-14,14,0,0,0,0,0,0,0,0,0,0,1302,294,1008,-1008
David Loiseau,Charles McCarthy,David Loiseau,2005-06-04,1,0,1,-1,2.090909,2,5.080002,-5.080002,0,0,12.7,-12.7,173,165,34,15,19,-19,9.09090042114258e-02,-9.09090042114258e-02,1,0,0,0,1,-1,0,0,119,0,119,-119
Michael Bisping,Charles McCarthy,Michael Bisping,2008-04-19,1,0,2,-2,3.333333,2,7.619995,-7.619995,0,0,10.16,-10.16,72,62,39,15,24,-24,1.33333325386047,-1.33333325386047,0,0,0,1,0,0,-1,1,154,1050,-896,896
Darren Elkins,Charles Oliveira,Charles Oliveira,2010-08-01,0,1,6,-6,2.454545,3.777778,0,0,-10,10,-7.62001,7.62001,27,0,38,43,-5,5,-1.32323217391968,1.32323217391968,1,0,0,0,1,-1,0,0,133,0,133,-133
Efrain Escudero,Charles Oliveira,Charles Oliveira,2010-09-15,0,1,4,-4,2.333333,3.777778,-2.540009,2.540009,0,0,-7.62001,7.62001,167,64,40,43,-3,3,-1.44444441795349,1.44444441795349,3,1,0,0,2,-2,0,0,109,45,64,-64
Jim Miller,Charles Oliveira,Jim Miller,2010-12-11,1,0,6,-6,2.117647,3.777778,-5.080002,5.080002,0,0,-7.62001,7.62001,91,0,53,43,10,-10,-1.66013050079346,1.66013050079346,2,2,0,0,0,0,0,0,87,87,0,0
Donald Cerrone,Charles Oliveira,Donald Cerrone,2011-08-14,1,0,7,-7,2.117647,3.777778,7.619995,-7.619995,0,0,-2.540009,2.540009,12,0,53,43,10,-10,-1.66013050079346,1.66013050079346,2,0,0,0,2,-2,0,0,64,246,-182,182
Jonathan Brookins,Charles Oliveira,Charles Oliveira,2012-06-01,0,1,4,-4,1.6,3.777778,5.080002,-5.080002,-10,10,0,0,67,59,26,43,-17,17,-2.17777764797211,2.17777764797211,1,0,0,1,1,-1,-1,1,107,292,-185,185
Frankie Edgar,Charles Oliveira,Frankie Edgar,2013-07-06,1,0,8,-8,2.090909,3.777778,-10.16,10.16,-20,20,-15.24001,15.24001,303,1,34,43,-9,9,-1.68686866760254,1.68686866760254,0,1,0,1,-1,1,-1,1,329,400,-71,71
Andy Ogle,Charles Oliveira,Charles Oliveira,2014-02-15,0,1,0,0,1.5,3.777778,-5.080002,5.080002,-10,10,-12.70001,12.70001,269,369,15,43,-28,28,-2.27777767181396,2.27777767181396,0,0,0,1,0,0,-1,1,0,224,-224,224
Hatsu Hioki,Charles Oliveira,Charles Oliveira,2014-06-28,0,1,6,-6,2.9,3.777778,2.539993,-2.539993,-10,10,-2.540009,2.540009,357,143,39,43,-4,4,-0.877777576446533,0.877777576446533,1,1,0,1,0,0,-1,1,119,133,-14,14
Nik Lentz,Charles Oliveira,Charles Oliveira,2015-05-30,0,1,5,-5,2.5,3.777778,-5.080002,5.080002,-10,10,-15.24001,15.24001,380,117,42,43,-1,1,-1.27777767181396,1.27777767181396,0,2,0,1,-2,2,-1,1,532,336,196,-196
Max Holloway,Charles Oliveira,Max Holloway,2015-08-23,1,0,-2,2,3.571429,3.777778,2.539993,-2.539993,-10,10,-12.70001,12.70001,6,0,32,43,-11,11,-0.20634913444519,0.20634913444519,2,3,0,1,-1,1,-1,1,127,85,42,-42
Myles Jury,Charles Oliveira,Charles Oliveira,2015-12-19,0,1,1,-1,4.25,3.777778,0,0,-10,10,-2.540009,2.540009,97,11,21,43,-22,22,0.472222328186035,-0.472222328186035,4,0,0,2,4,-4,-2,2,644,118,526,-526
Ricardo Lamas,Charles Oliveira,Ricardo Lamas,2016-11-05,1,0,7,-7,2.5,3.777778,-5.080002,5.080002,-10,10,-7.62001,7.62001,147,218,28,43,-15,15,-1.27777767181396,1.27777767181396,1,1,1,2,0,0,-1,1,350,322,28,-28
Will Brooks,Charles Oliveira,Charles Oliveira,2017-04-08,0,1,3,-3,4.5,3.777778,0,0,0,0,-5.080002,5.080002,0,102,22,43,-21,21,0.722222328186035,-0.722222328186035,0,0,1,2,0,0,-1,1,189,154,35,-35
Paul Felder,Charles Oliveira,Paul Felder,2017-12-02,1,0,5,-5,2.833333,3.777778,2.539993,-2.539993,0,0,-10.16,10.16,291,172,23,43,-20,20,-0.944444417953491,0.944444417953491,2,1,1,2,1,-1,-1,1,139,238,-99,99
Clay Guida,Charles Oliveira,Charles Oliveira,2018-06-09,0,1,8,-8,1.9,3.777778,-7.62001,7.62001,0,0,-10.16,10.16,0,2,58,43,15,-15,-1.87777769565582,1.87777769565582,2,0,2,3,2,-2,-1,1,210,189,21,-21
Christos Giagos,Charles Oliveira,Charles Oliveira,2018-09-22,0,1,0,0,1.818182,3.777778,0,0,0,0,-7.62001,7.62001,7,81,31,43,-12,12,-1.95959579944611,1.95959579944611,0,1,0,3,-1,1,-3,3,1204,105,1099,-1099
Jim Miller,Charles Oliveira,Charles Oliveira,2018-12-15,0,1,6,-6,2.117647,3.777778,-5.080002,5.080002,0,0,-7.62001,7.62001,0,47,53,43,10,-10,-1.66013050079346,1.66013050079346,1,2,0,3,-1,1,-3,3,98,84,14,-14
Nik Lentz,Charles Oliveira,Charles Oliveira,2019-05-18,0,1,5,-5,2.5,3.777778,-5.080002,5.080002,-10,10,-15.24001,15.24001,100,97,42,43,-1,1,-1.27777767181396,1.27777767181396,1,3,0,3,-2,2,-3,3,224,154,70,-70
Jared Gordon,Charles Oliveira,Charles Oliveira,2019-11-16,0,1,1,-1,3.166667,3.777778,-2.540009,2.540009,0,0,-15.24001,15.24001,5,2,25,43,-18,18,-0.611110925674438,0.611110925674438,1,4,1,3,-3,3,-2,2,140,182,-42,42
Kevin Lee,Charles Oliveira,Charles Oliveira,2020-03-14,0,1,-3,3,2.25,3.777778,-2.540009,2.540009,15,-15,7.619995,-7.619995,390,11,26,43,-17,17,-1.52777767181396,1.52777767181396,3,5,1,3,-2,2,-2,2,1099,119,980,-980
Tony Ferguson,Charles Oliveira,Charles Oliveira,2020-12-12,0,1,5,-5,2.888889,3.777778,2.539993,-2.539993,0,0,5.079987,-5.079987,5,699,35,43,-8,8,-0.888888835906982,0.888888835906982,0,6,1,3,-6,6,-2,2,217,273,-56,56
Michael Chandler,Charles Oliveira,Charles Oliveira,2021-05-15,0,1,4,-4,2.875,3.777778,-5.080002,5.080002,0,0,-7.62001,7.62001,147,102,31,43,-12,12,-0.902777671813965,0.902777671813965,1,7,0,3,-6,6,-3,3,112,154,-42,42
Justin Gaethje,Charles Oliveira,Charles Oliveira,2022-05-07,0,1,1,-1,6.25,3.777778,2.539993,-2.539993,0,0,-10.16,10.16,13,39,29,43,-14,14,2.47222232818604,-2.47222232818604,0,8,1,3,-8,8,-2,2,560,357,203,-203
Islam Makhachev,Charles Oliveira,Islam Makhachev,2022-10-22,1,0,-3,3,24,3.777778,0,0,0,0,-10.16,10.16,305,42,25,43,-18,18,20.222222328186,-20.222222328186,5,9,1,3,-4,4,-2,2,462,168,294,-294
Beneil Dariush,Charles Oliveira,Charles Oliveira,2023-06-10,0,1,1,-1,4.4,3.777778,0,0,0,0,-5.080002,5.080002,164,31,27,43,-16,16,0.622222423553467,-0.622222423553467,7,0,2,3,7,-7,-1,1,231,231,0,0
Blood Diamond,Charles Radtke,Charles Radtke,2023-09-09,0,1,2,-2,1,2.666667,5.080002,-5.080002,0,0,10.15999,-10.15999,21,581,6,11,-5,5,-1.66666674613953,1.66666674613953,0,0,0,0,0,0,0,0,574,0,574,-574
Yair Rodriguez,Charles Rosa,Yair Rodriguez,2015-06-13,1,0,-6,6,4,1.75,5.080002,-5.080002,0,0,5.080002,-5.080002,36,528,20,22,-2,2,2.25,-2.25,0,0,0,0,0,0,0,0,0,0,0,0
Kyle Bochniak,Charles Rosa,Charles Rosa,2016-01-17,0,1,-1,1,1.6,1.75,-5.080002,5.080002,0,0,2.540009,-2.540009,44,63,13,22,-9,9,-0.149999976158142,0.149999976158142,0,0,0,0,0,0,0,0,0,218,-218,218
Shane Burgos,Charles Rosa,Shane Burgos,2017-04-08,1,0,-4,4,5,1.75,5.080002,-5.080002,0,0,15.24001,-15.24001,10,44,18,22,-4,4,3.25,-3.25,0,1,0,0,-1,1,0,0,0,447,-447,447
Manny Bermudez,Charles Rosa,Charles Rosa,2019-10-18,0,1,-8,8,7,1.75,2.540009,-2.540009,0,0,5.080002,-5.080002,137,0,16,22,-6,6,5.25,-5.25,0,0,0,1,0,0,-1,1,62,923,-861,861
Bryce Mitchell,Charles Rosa,Bryce Mitchell,2020-05-09,1,0,-8,8,8,1.75,2.540009,-2.540009,0,0,2.540009,-2.540009,771,0,18,22,-4,4,6.25,-6.25,2,1,0,1,1,-1,-1,1,154,204,-50,50
Kevin Aguilar,Charles Rosa,Charles Rosa,2020-06-13,0,1,-2,2,3.4,1.75,-5.080002,5.080002,10,-10,10.16,-10.16,4,0,22,22,0,0,1.65000009536743,-1.65000009536743,0,0,1,1,0,0,0,0,112,35,77,-77
Darrick Minner,Charles Rosa,Darrick Minner,2021-02-20,1,0,-4,4,1.857143,1.75,-5.080002,5.080002,0,0,0,0,754,0,40,22,18,-18,0.107142806053162,-0.107142806053162,0,1,0,1,-1,1,-1,1,0,252,-252,252
Justin Jaynes,Charles Rosa,Charles Rosa,2021-06-26,0,1,-3,3,2,1.75,-5.080002,5.080002,0,0,-2.539993,2.539993,173,217,24,22,2,-2,0.25,-0.25,0,0,1,1,0,0,0,0,140,126,14,-14
Damon Jackson,Charles Rosa,Damon Jackson,2021-10-09,1,0,-2,2,3.666667,1.75,5.080002,-5.080002,0,0,5.080002,-5.080002,624,78,28,22,6,-6,1.91666674613953,-1.91666674613953,0,1,1,1,-1,1,0,0,308,105,203,-203
TJ Brown,Charles Rosa,TJ Brown,2022-01-15,1,0,-4,4,1.7,1.75,0,0,0,0,7.62001,-7.62001,459,162,27,22,5,-5,-4.99999523162842e-02,4.99999523162842e-02,1,0,0,1,1,-1,-1,1,259,98,161,-161
Amilcar Alves,Charlie Brenneman,Charlie Brenneman,2011-01-22,0,1,-7,7,1.25,2.375,5.080002,-5.080002,15,-15,8.73999,-8.73999,0,737,27,27,0,0,-1.125,1.125,0,0,0,0,0,0,0,0,147,0,147,-147
Kevin Holland,Charlie Ontiveros,Kevin Holland,2020-10-31,1,0,-2,2,2.5,1.222222,2.539993,-2.539993,15,-15,17.78,-17.78,133,0,35,20,15,-15,1.27777779102325,-1.27777779102325,3,0,0,0,3,-3,0,0,42,0,42,-42
Steve Garcia,Charlie Ontiveros,Steve Garcia,2021-10-09,1,0,-1,1,2.8,1.222222,-5.080002,5.080002,-10,10,2.539993,-2.539993,355,8,19,20,-1,1,1.57777774333954,-1.57777774333954,0,0,0,0,0,0,0,0,588,343,245,-245
Gabriel Benitez,Charlie Ontiveros,Gabriel Benitez,2022-08-13,1,0,3,-3,2.090909,1.222222,-15.24001,15.24001,0,0,-7.62001,7.62001,84,0,34,20,14,-14,0.86868679523468,-0.86868679523468,0,0,4,1,0,0,3,-3,175,308,-133,133
Ivan Menjivar,Charlie Valencia,Ivan Menjivar,2011-04-30,1,0,-8,8,2.083333,1.714286,7.619995,-7.619995,10,-10,0,0,13,0,37,19,18,-18,0.369047522544861,-0.369047522544861,0,0,0,0,0,0,0,0,2506,0,2506,-2506
Abdul Razak Alhassan,Charlie Ward,Abdul Razak Alhassan,2016-11-19,1,0,-4,4,2.4,1,-2.539993,2.539993,15,-15,2.419998,-2.419998,7,0,17,6,11,-11,1.40000009536743,-1.40000009536743,0,0,0,0,0,0,0,0,0,0,0,0
Galore Bofando,Charlie Ward,Galore Bofando,2017-07-16,1,0,-1,1,1.666667,1,0,0,0,0,-0.1199951,0.1199951,3,8,8,6,2,-2,0.666666626930237,-0.666666626930237,0,0,0,1,0,0,-1,1,0,239,-239,239
Mirsad Bektic,Chas Skelly,Mirsad Bektic,2014-04-19,1,0,-5,5,3.25,6.333333,-7.619995,7.619995,0,0,-5.080002,5.080002,295,93,17,22,-5,5,-3.08333349227905,3.08333349227905,0,0,0,0,0,0,0,0,0,0,0,0
Tom Niinimaki,Chas Skelly,Chas Skelly,2014-08-23,0,1,3,-3,2.75,6.333333,-5.080002,5.080002,0,0,-7.62001,7.62001,56,75,30,22,8,-8,-3.58333349227905,3.58333349227905,1,0,0,0,1,-1,0,0,266,126,140,-140
Jim Alers,Chas Skelly,Chas Skelly,2015-02-14,0,1,-1,1,4.333333,6.333333,-5.080002,5.080002,0,0,-2.540009,2.540009,95,143,16,22,-6,6,-2,2,1,1,0,0,0,0,0,0,309,175,134,-134
Darren Elkins,Chas Skelly,Darren Elkins,2016-03-05,1,0,1,-1,2.454545,6.333333,-2.539993,2.539993,0,0,-2.540009,2.540009,522,63,38,22,16,-16,-3.87878799438477,3.87878799438477,2,2,1,0,0,0,1,-1,133,385,-252,252
Maximo Blanco,Chas Skelly,Chas Skelly,2016-09-17,0,1,1,-1,1.5,6.333333,-7.619995,7.619995,0,0,-2.540009,2.540009,0,11,20,22,-2,2,-4.83333349227905,4.83333349227905,0,0,0,0,0,0,0,0,244,196,48,-48
Chris Gruetzemacher,Chas Skelly,Chas Skelly,2017-02-04,0,1,-1,1,3,6.333333,-7.619995,7.619995,10,-10,-10.16,10.16,0,280,20,22,-2,2,-3.33333349227905,3.33333349227905,1,1,0,0,0,0,0,0,421,140,281,-281
Jason Knight,Chas Skelly,Jason Knight,2017-05-13,1,0,-8,8,4,6.333333,-2.539993,2.539993,0,0,-2.540009,2.540009,105,231,25,22,3,-3,-2.33333349227905,2.33333349227905,0,2,0,0,-2,2,0,0,0,98,-98,98
Jordan Griffin,Chas Skelly,Chas Skelly,2019-09-14,0,1,-5,5,2,6.333333,-2.539993,2.539993,0,0,2.539993,-2.539993,176,514,27,22,5,-5,-4.33333349227905,4.33333349227905,0,0,0,1,0,0,-1,1,273,854,-581,581
Alex Caceres,Chase Hooper,Alex Caceres,2020-06-06,1,0,11,-11,1.5,4,-7.619995,7.619995,-10,10,-2.540009,2.540009,151,176,35,15,20,-20,-2.5,2.5,1,0,1,0,1,-1,1,-1,322,0,322,-322
Peter Barrett,Chase Hooper,Chase Hooper,2020-12-12,0,1,13,-13,2.2,4,-7.619995,7.619995,-10,10,-2.540009,2.540009,65,44,16,15,1,-1,-1.79999995231628,1.79999995231628,0,0,0,0,0,0,0,0,126,189,-63,63
Felipe Colares,Chase Hooper,Chase Hooper,2022-05-21,0,1,6,-6,2.5,4,-12.7,12.7,-10,10,-12.70001,12.70001,254,424,14,15,-1,1,-1.5,1.5,0,1,0,0,-1,1,0,0,224,525,-301,301
Steve Garcia,Chase Hooper,Steve Garcia,2022-10-29,1,0,7,-7,2.8,4,-2.539993,2.539993,-10,10,2.539993,-2.539993,17,0,19,15,4,-4,-1.20000004768372,1.20000004768372,1,2,0,0,-1,1,0,0,385,161,224,-224
Nick Fiore,Chase Hooper,Chase Hooper,2023-05-20,0,1,2,-2,3,4,-7.619995,7.619995,0,0,-5.080002,5.080002,287,234,8,15,-7,7,-1,1,0,0,0,1,0,0,-1,1,126,203,-77,77
Justin Ledet,Chase Sherman,Justin Ledet,2016-08-06,1,0,1,-1,2.25,1.333333,0,0,-45,45,5.080002,-5.080002,0,0,13,28,-15,15,0.916666626930237,-0.916666626930237,0,0,0,0,0,0,0,0,0,0,0,0
Walt Harris,Chase Sherman,Walt Harris,2017-01-15,1,0,6,-6,1.3,1.333333,2.540009,-2.540009,0,0,-2.539993,2.539993,2,0,23,28,-5,5,-3.3333420753479e-02,3.3333420753479e-02,0,0,2,0,0,0,2,-2,800,162,638,-638
Rashad Coulter,Chase Sherman,Chase Sherman,2017-05-13,0,1,8,-8,2.25,1.333333,-12.7,12.7,-45,45,-5.080002,5.080002,0,58,13,28,-15,15,0.916666626930237,-0.916666626930237,0,0,0,1,0,0,-1,1,0,118,-118,118
Damian Grabowski,Chase Sherman,Chase Sherman,2017-07-22,0,1,10,-10,4,1.333333,-7.619995,7.619995,-9,9,-7.619995,7.619995,1,12,25,28,-3,3,2.66666662693024,-2.66666662693024,0,1,2,1,-1,1,1,-1,357,70,287,-287
Shamil Abdurakhimov,Chase Sherman,Shamil Abdurakhimov,2017-11-25,1,0,8,-8,2.5,1.333333,-2.539993,2.539993,-15,15,-5.080002,5.080002,1,0,28,28,0,0,1.16666662693024,-1.16666662693024,0,2,2,1,-2,2,1,-1,351,126,225,-225
Augusto Sakai,Chase Sherman,Augusto Sakai,2018-09-22,1,0,-1,1,3.2,1.333333,-2.539993,2.539993,15,-15,-2.539993,2.539993,69,72,21,28,-7,7,1.86666667461395,-1.86666667461395,0,0,0,2,0,0,-2,2,0,301,-301,301
Andrei Arlovski,Chase Sherman,Andrei Arlovski,2021-04-17,1,0,11,-11,1.545455,1.333333,-2.539993,2.539993,-10,10,-2.539993,2.539993,39,0,56,28,28,-28,0.21212112903595,-0.21212112903595,0,0,7,3,0,0,4,-4,56,938,-882,882
Parker Porter,Chase Sherman,Parker Porter,2021-08-21,1,0,5,-5,1.555556,1.333333,-10.15999,10.15999,15,-15,-7.619995,7.619995,139,0,23,28,-5,5,0.222222208976746,-0.222222208976746,0,0,0,3,0,0,-3,3,0,126,-126,126
Jake Collier,Chase Sherman,Jake Collier,2022-01-15,1,0,1,-1,1.3,1.333333,-2.539993,2.539993,-20,20,0,0,67,0,23,28,-5,5,-3.3333420753479e-02,3.3333420753479e-02,0,0,2,3,0,0,-1,1,217,147,70,-70
Alexandr Romanov,Chase Sherman,Alexandr Romanov,2022-04-30,1,0,-1,1,8.5,1.333333,-5.079987,5.079987,12,-12,-7.619995,7.619995,118,0,19,28,-9,9,7.16666662693024,-7.16666662693024,1,0,0,3,1,-1,-3,3,203,105,98,-98
Waldo Cortes-Acosta,Chase Sherman,Waldo Cortes-Acosta,2022-11-19,1,0,-2,2,10,1.333333,0,0,10,-10,0,0,13,94,11,28,-17,17,8.66666662693024,-8.66666662693024,1,0,0,3,1,-1,-3,3,21,203,-182,182
Chris Cope,Che Mills,Che Mills,2011-11-05,0,1,-1,1,2,1.6,-2.539993,2.539993,0,0,-10.15999,10.15999,0,7,12,26,-14,14,0.399999976158142,-0.399999976158142,1,0,0,0,1,-1,0,0,154,0,154,-154
Rory MacDonald,Che Mills,Rory MacDonald,2012-04-21,1,0,-7,7,4.75,1.6,-2.539993,2.539993,0,0,0,0,351,16,23,26,-3,3,3.14999997615814,-3.14999997615814,1,1,0,0,0,0,0,0,259,168,91,-91
Duane Ludwig,Che Mills,Che Mills,2012-09-29,0,1,4,-4,1.5,1.6,-7.619995,7.619995,0,0,-15.23999,15.23999,0,125,35,26,9,-9,-0.100000023841858,0.100000023841858,0,0,0,1,0,0,-1,1,253,161,92,-92
Gilbert Aldana,Cheick Kongo,Cheick Kongo,2006-07-08,0,1,-3,3,3,2.7,-7.619995,7.619995,10,-10,-20.28,20.28,175,30,8,37,-29,29,0.299999952316284,-0.299999952316284,0,0,1,0,0,0,1,-1,154,0,154,-154
Mirko Filipovic,Cheick Kongo,Cheick Kongo,2007-09-08,0,1,0,0,3.181818,2.7,-5.079987,5.079987,-10,10,-22.86,22.86,125,394,46,37,9,-9,0.481818199157715,-0.481818199157715,0,1,1,0,-1,1,1,-1,140,427,-287,287
Heath Herring,Cheick Kongo,Heath Herring,2008-03-01,1,0,-3,3,1.75,2.7,0,0,10,-10,-10.16,10.16,351,497,44,37,7,-7,-0.950000047683716,0.950000047683716,0,2,0,0,-2,2,0,0,238,175,63,-63
Dan Evensen,Cheick Kongo,Cheick Kongo,2008-08-09,0,1,1,-1,2.75,2.7,-2.539993,2.539993,10,-10,-15.28,15.28,0,230,15,37,-22,22,4.99999523162842e-02,-4.99999523162842e-02,0,0,0,0,0,0,0,0,0,161,-161,161
Mostapha Al-Turk,Cheick Kongo,Cheick Kongo,2008-12-27,0,1,2,-2,1,2.7,-5.079987,5.079987,5,-5,-12.7,12.7,92,77,12,37,-25,25,-1.70000004768372,1.70000004768372,0,1,0,0,-1,1,0,0,0,140,-140,140
Antoni Hardonk,Cheick Kongo,Cheick Kongo,2009-04-18,0,1,0,0,1.333333,2.7,0,0,5,-5,-10.16,10.16,0,300,14,37,-23,23,-1.36666667461395,1.36666667461395,3,2,0,0,1,-1,0,0,112,112,0,0
Paul Buentello,Cheick Kongo,Cheick Kongo,2010-03-21,0,1,2,-2,2.058824,2.7,-5.079987,5.079987,5,-5,-12.7,12.7,0,507,52,37,15,-15,-0.641176462173462,0.641176462173462,0,3,0,0,-3,3,0,0,99,337,-238,238
Pat Barry,Cheick Kongo,Cheick Kongo,2011-06-26,0,1,-5,5,1.142857,2.7,-12.7,12.7,-5,5,-20.31999,20.31999,9,1,15,37,-22,22,-1.55714285373688,1.55714285373688,1,4,0,0,-3,3,0,0,155,462,-307,307
Mark Hunt,Cheick Kongo,Mark Hunt,2012-02-25,1,0,1,-1,0.9285714,2.7,-15.23999,15.23999,25,-25,-25.39999,25.39999,18,8,27,37,-10,10,-1.77142864465714,1.77142864465714,2,5,0,0,-3,3,0,0,154,244,-90,90
Shawn Jordan,Cheick Kongo,Cheick Kongo,2012-07-21,0,1,-10,10,2.375,2.7,-10.15999,10.15999,20,-20,-17.78,17.78,359,363,27,37,-10,10,-0.325000047683716,0.325000047683716,1,0,0,1,1,-1,-1,1,141,147,-6,6
Jack Jenkins,Chepe Mariscal,Chepe Mariscal,2023-09-09,0,1,-1,1,4,2.5,0,0,0,0,-2.539993,2.539993,7,166,15,21,-6,6,1.5,-1.5,1,0,0,0,1,-1,0,0,210,0,210,-210
Montserrat Conejo Ruiz,Cheyanne Vlismas,Montserrat Conejo Ruiz,2021-03-20,1,0,3,-3,3.333333,2.333333,-7.62001,7.62001,0,0,-5.080002,5.080002,593,64,13,10,3,-3,1,-1,0,0,0,0,0,0,0,0,0,0,0,0
Gloria de Paula,Cheyanne Vlismas,Cheyanne Vlismas,2021-07-31,0,1,0,0,1.2,2.333333,5.080002,-5.080002,0,0,10.15999,-10.15999,0,34,11,10,1,-1,-1.13333320617676,1.13333320617676,0,0,0,0,0,0,0,0,140,133,7,-7
Mallory Martin,Cheyanne Vlismas,Cheyanne Vlismas,2021-12-04,0,1,1,-1,1.4,2.333333,2.539993,-2.539993,0,0,0,0,166,0,12,10,2,-2,-0.933333277702332,0.933333277702332,0,1,0,0,-1,1,0,0,294,126,168,-168
Cory McKenna,Cheyanne Vlismas,Cory McKenna,2022-12-17,1,0,-4,4,4,2.333333,0,0,0,0,-12.7,12.7,581,3,10,10,0,0,1.66666674613953,-1.66666674613953,0,2,0,0,-2,2,0,0,273,378,-105,105
Marc-Andre Barriault,Chidi Njokuani,Chidi Njokuani,2022-02-05,0,1,-2,2,2.666667,2.2,-5.080002,5.080002,0,0,-15.23999,15.23999,0,4,22,32,-10,10,0.466666698455811,-0.466666698455811,1,0,0,0,1,-1,0,0,154,0,154,-154
Albert Duraev,Chidi Njokuani,Albert Duraev,2023-03-25,1,0,0,0,3.2,2.2,-10.16,10.16,0,0,-12.7,12.7,242,0,21,32,-11,11,1,-1,1,1,0,0,0,0,0,0,511,413,98,-98
Will Campuzano,Chris Cariaso,Chris Cariaso,2011-01-22,0,1,-5,5,2.333333,2.125,15.23999,-15.23999,0,0,15.24001,-15.24001,0,33,20,25,-5,5,0.208333253860474,-0.208333253860474,0,0,0,0,0,0,0,0,49,0,49,-49
Matt Brown,Chris Cope,Matt Brown,2012-02-04,1,0,3,-3,1.368421,2,0,0,0,0,7.619995,-7.619995,81,70,45,12,33,-33,-0.631578922271729,0.631578922271729,1,0,0,0,1,-1,0,0,223,0,223,-223
Brendan Allen,Chris Curtis,Chris Curtis,2021-12-04,0,1,-9,9,4.4,3,10.16,-10.16,0,0,0,0,18,43,27,40,-13,13,1.40000009536743,-1.40000009536743,2,0,1,0,2,-2,1,-1,133,0,133,-133
Joaquin Buckley,Chris Curtis,Chris Curtis,2022-12-10,0,1,-7,7,2.666667,3,0,0,-15,15,2.539993,-2.539993,0,6,22,40,-18,18,-0.333333253860474,0.333333253860474,0,1,2,0,-1,1,2,-2,98,371,-273,273
Shamil Abdurakhimov,Chris Daukaus,Chris Daukaus,2021-09-25,0,1,8,-8,2.5,1.714286,0,0,30,-30,0,0,0,48,28,19,9,-9,0.785714268684387,-0.785714268684387,0,0,3,0,0,0,3,-3,749,0,749,-749
Curtis Blaydes,Chris Daukaus,Curtis Blaydes,2022-03-26,1,0,-1,1,4.25,1.714286,2.539993,-2.539993,60,-60,10.16,-10.16,3,0,21,19,2,-2,2.53571426868439,-2.53571426868439,1,1,3,0,0,0,3,-3,182,182,0,0
Rashad Coulter,Chris de la Rocha,Chris de la Rocha,2018-06-09,0,1,-3,3,2.25,1.666667,-10.16,10.16,-45,45,-10.16,10.16,1,320,13,8,5,-5,0.583333373069763,-0.583333373069763,0,0,2,0,0,0,2,-2,203,0,203,-203
Juan Adams,Chris de la Rocha,Juan Adams,2018-12-15,1,0,-13,13,1.666667,1.666667,5.080002,-5.080002,15,-15,0,0,276,59,8,8,0,0,0,0,0,1,0,0,-1,1,0,0,0,189,-189,189
Scott Askham,Chris Dempsey,Scott Askham,2016-02-27,1,0,-1,1,3.5,2.2,12.7,-12.7,0,0,7.619995,-7.619995,43,199,18,16,2,-2,1.29999995231628,-1.29999995231628,0,0,0,0,0,0,0,0,126,0,126,-126
Yanal Ashmouz,Chris Duncan,Chris Duncan,2023-07-22,0,1,-2,2,7,11,-2.540009,2.540009,0,0,-7.619995,7.619995,0,48,8,12,-4,4,-4,4,1,0,0,0,1,-1,0,0,126,0,126,-126
Makwan Amirkhani,Chris Fishgold,Makwan Amirkhani,2019-06-01,1,0,4,-4,1.888889,4.5,5.080002,-5.080002,0,0,10.16,-10.16,179,0,26,22,4,-4,-2.61111116409302,2.61111116409302,4,0,0,0,4,-4,0,0,370,0,370,-370
Rafa Garcia,Chris Gruetzemacher,Chris Gruetzemacher,2021-07-31,0,1,-9,9,5.333333,3,-2.540009,2.540009,0,0,5.080002,-5.080002,386,3,19,20,-1,1,2.33333349227905,-2.33333349227905,0,0,0,0,0,0,0,0,140,0,140,-140
Raoni Barcelos,Chris Gutierrez,Raoni Barcelos,2018-11-30,1,0,4,-4,3.4,3.8,-5.080002,5.080002,0,0,0,0,323,0,22,24,-2,2,-0.399999856948853,0.399999856948853,1,0,0,0,1,-1,0,0,139,0,139,-139
Geraldo de Freitas,Chris Gutierrez,Chris Gutierrez,2019-08-10,0,1,-1,1,2,3.8,-5.080002,5.080002,0,0,12.70001,-12.70001,128,176,18,24,-6,6,-1.79999995231628,1.79999995231628,0,0,0,0,0,0,0,0,0,253,-253,253
Andre Ewell,Chris Gutierrez,Chris Gutierrez,2021-02-13,0,1,4,-4,1.888889,3.8,-2.539993,2.539993,10,-10,20.32001,-20.32001,9,71,26,24,2,-2,-1.9111111164093,1.9111111164093,2,1,1,0,1,-1,1,-1,147,553,-406,406
Felipe Colares,Chris Gutierrez,Chris Gutierrez,2021-10-09,0,1,-3,3,2.5,3.8,-2.539993,2.539993,10,-10,5.080002,-5.080002,239,90,14,24,-10,10,-1.29999995231628,1.29999995231628,1,2,0,0,-1,1,0,0,161,238,-77,77
Batgerel Danaa,Chris Gutierrez,Chris Gutierrez,2022-03-26,0,1,2,-2,2.4,3.8,-5.080002,5.080002,0,0,7.62001,-7.62001,24,13,17,24,-7,7,-1.39999985694885,1.39999985694885,2,3,0,0,-1,1,0,0,161,168,-7,7
Frankie Edgar,Chris Gutierrez,Chris Gutierrez,2022-11-12,0,1,10,-10,2.090909,3.8,-7.619995,7.619995,0,0,2.540009,-2.540009,0,1,34,24,10,-10,-1.70909094810486,1.70909094810486,0,4,4,0,-4,4,4,-4,371,231,140,-140
Davey Grant,Chris Holdsworth,Chris Holdsworth,2013-11-30,0,1,1,-1,2.142857,6,-7.619995,7.619995,0,0,-8.740005,8.740005,19,231,22,6,16,-16,-3.85714292526245,3.85714292526245,0,0,0,0,0,0,0,0,0,0,0,0
Chico Camus,Chris Holdsworth,Chris Holdsworth,2014-05-24,0,1,3,-3,2.428571,6,-12.7,12.7,-10,10,-16.36,16.36,7,616,24,6,18,-18,-3.57142853736877,3.57142853736877,1,1,0,0,0,0,0,0,266,175,91,-91
Vik Grujic,Chris Indich,Vik Grujic,2014-06-28,1,0,10,-10,1,1.5,2.539993,-2.539993,0,0,5.419998,-5.419998,102,57,12,10,2,-2,-0.5,0.5,0,0,0,0,0,0,0,0,73,0,73,-73
Paddy Holohan,Chris Kelades,Chris Kelades,2014-10-04,0,1,-7,7,6,3,7.62001,-7.62001,0,0,2.539993,-2.539993,388,374,14,12,2,-2,3,-3,1,0,0,0,1,-1,0,0,77,0,77,-77
Ray Borg,Chris Kelades,Ray Borg,2015-02-14,1,0,-12,12,2.6,3,-7.619995,7.619995,10,-10,-12.7,12.7,701,38,18,12,6,-6,-0.400000095367432,0.400000095367432,1,1,0,0,0,0,0,0,231,133,98,-98
Chris Beal,Chris Kelades,Chris Kelades,2015-08-23,0,1,-4,4,2,3,0,0,0,0,2.539993,-2.539993,347,160,15,12,3,-3,-1,1,0,0,0,0,0,0,0,0,211,190,21,-21
Patrick Cote,Chris Leben,Chris Leben,2005-08-06,0,1,0,0,2.090909,2,0,0,-15,15,5.080002,-5.080002,121,547,34,33,1,-1,9.09090042114258e-02,-9.09090042114258e-02,0,0,0,0,0,0,0,0,112,0,112,-112
Edwin DeWees,Chris Leben,Chris Leben,2005-10-03,0,1,-2,2,2.235294,2,5.080002,-5.080002,0,0,2.580002,-2.580002,67,112,55,33,22,-22,0.235294103622437,-0.235294103622437,0,1,1,0,-1,1,1,-1,738,58,680,-680
Luigi Fioravanti,Chris Leben,Chris Leben,2006-04-06,0,1,0,0,1.733333,2,-7.619995,7.619995,-15,15,-7.619995,7.619995,121,573,41,33,8,-8,-0.266666650772095,0.266666650772095,0,2,0,0,-2,2,0,0,0,185,-185,185
Michael Bisping,Chris Leben,Michael Bisping,2008-10-18,1,0,1,-1,3.333333,2,5.080002,-5.080002,0,0,5.080002,-5.080002,30,47,39,33,6,-6,1.33333325386047,-1.33333325386047,2,3,0,0,-1,1,0,0,133,926,-793,793
Yoshihiro Akiyama,Chris Leben,Chris Leben,2010-07-03,0,1,5,-5,2.333333,2,-2.539993,2.539993,-15,15,5.080002,-5.080002,513,23,20,33,-13,13,0.333333253860474,-0.333333253860474,1,0,0,0,1,-1,0,0,357,623,-266,266
Derek Brunson,Chris Leben,Derek Brunson,2012-12-29,1,0,-4,4,2.555556,2,5.080002,-5.080002,0,0,10.16,-10.16,441,0,32,33,-1,1,0.555555582046509,-0.555555582046509,0,1,0,0,-1,1,0,0,0,910,-910,910
Andrew Craig,Chris Leben,Andrew Craig,2013-07-06,1,0,-5,5,2.25,2,5.080002,-5.080002,-15,15,7.619995,-7.619995,205,301,13,33,-20,20,0.25,-0.25,0,0,0,0,0,0,0,0,168,189,-21,21
Uriah Hall,Chris Leben,Uriah Hall,2013-12-28,1,0,-4,4,1.636364,2,2.540009,-2.540009,0,0,15.24001,-15.24001,6,0,29,33,-4,4,-0.363636374473572,0.363636374473572,0,0,0,0,0,0,0,0,133,175,-42,42
Ben Earwood,Chris Lytle,Ben Earwood,2000-11-17,1,0,,,4,1.722222,-7.619995,7.619995,0,0,2.279999,-2.279999,587,0,15,49,-34,34,2.27777779102325,-2.27777779102325,0,0,0,0,0,0,0,0,0,0,0,0
Robbie Lawler,Chris Lytle,Robbie Lawler,2003-11-21,1,0,-8,8,1.875,1.722222,0,0,0,0,15.24001,-15.24001,291,24,46,49,-3,3,0.152777791023254,-0.152777791023254,0,0,0,0,0,0,0,0,210,1099,-889,889
Tiki Ghosn,Chris Lytle,Chris Lytle,2004-04-02,0,1,-2,2,1.428571,1.722222,-2.539993,2.539993,0,0,7.279999,-7.279999,27,49,17,49,-32,32,-0.29365074634552,0.29365074634552,0,0,1,0,0,0,1,-1,497,133,364,-364
Ronald Jhun,Chris Lytle,Chris Lytle,2004-08-21,0,1,3,-3,0.9230769,1.722222,0,0,0,0,10.28,-10.28,23,260,50,49,1,-1,-0.79914528131485,0.79914528131485,0,1,0,0,-1,1,0,0,0,141,-141,141
Matt Hughes,Chris Lytle,Matt Hughes,2007-03-03,1,0,1,-1,5,1.722222,-5.080002,5.080002,0,0,12.7,-12.7,789,45,54,49,5,-5,3.27777779102325,-3.27777779102325,0,2,1,0,-2,2,1,-1,105,924,-819,819
Jason Gilliam,Chris Lytle,Chris Lytle,2007-07-07,0,1,,,1.555556,1.722222,2.540009,-2.540009,0,0,13.28,-13.28,5,117,23,49,-26,26,-0.166666626930237,0.166666626930237,0,0,0,0,0,0,0,0,126,126,0,0
Thiago Alves,Chris Lytle,Thiago Alves,2007-11-17,1,0,-9,9,1.533333,1.722222,-5.080002,5.080002,0,0,5.080002,-5.080002,32,149,38,49,-11,11,-0.188888907432556,0.188888907432556,2,1,1,0,1,-1,1,-1,59,133,-74,74
Kyle Bradley,Chris Lytle,Chris Lytle,2008-02-02,0,1,-8,8,1.583333,1.722222,-5.080002,5.080002,-15,15,7.619995,-7.619995,0,4,31,49,-18,18,-0.138888835906982,0.138888835906982,0,0,0,1,0,0,-1,1,0,77,-77,77
Josh Koscheck,Chris Lytle,Josh Koscheck,2008-07-05,1,0,-3,3,1.545455,1.722222,-2.539993,2.539993,0,0,12.7,-12.7,598,13,28,49,-21,21,-0.176767706871033,0.176767706871033,0,1,0,1,-1,1,-1,1,315,154,161,-161
Marcus Davis,Chris Lytle,Marcus Davis,2009-01-17,1,0,1,-1,2,1.722222,-2.539993,2.539993,0,0,5.080002,-5.080002,6,3,33,49,-16,16,0.277777791023254,-0.277777791023254,1,0,1,1,1,-1,0,0,91,196,-105,105
Kevin Burns,Chris Lytle,Chris Lytle,2009-06-20,0,1,-5,5,1.714286,1.722222,-2.539993,2.539993,0,0,15.24001,-15.24001,21,14,19,49,-30,30,-7.93647766113281e-03,7.93647766113281e-03,0,0,1,1,0,0,0,0,189,154,35,-35
Brian Foster,Chris Lytle,Chris Lytle,2010-02-20,0,1,-10,10,2.7,1.722222,-5.080002,5.080002,0,0,7.619995,-7.619995,16,0,37,49,-12,12,0.97777783870697,-0.97777783870697,1,1,0,1,0,0,-1,1,91,245,-154,154
Matt Brown,Chris Lytle,Chris Lytle,2010-07-03,0,1,-6,6,1.368421,1.722222,2.540009,-2.540009,0,0,17.78,-17.78,101,146,45,49,-4,4,-0.353801131248474,0.353801131248474,3,2,0,1,1,-1,-1,1,231,133,98,-98
Brian Ebersole,Chris Lytle,Brian Ebersole,2011-02-26,1,0,-6,6,2.833333,1.722222,2.540009,-2.540009,0,0,12.7,-12.7,454,91,69,49,20,-20,1.11111104488373,-1.11111104488373,0,3,0,1,-3,3,-1,1,0,238,-238,238
Dan Hardy,Chris Lytle,Chris Lytle,2011-08-14,0,1,-7,7,2.5,1.722222,2.540009,-2.540009,0,0,15.24001,-15.24001,7,20,35,49,-14,14,0.777777791023254,-0.777777791023254,0,0,0,1,0,0,-1,1,141,169,-28,28
Kendall Grove,Chris Price,Kendall Grove,2006-10-10,1,0,0,0,1.352941,4.75,10.15999,-10.15999,0,0,9.660004,-9.660004,163,36,40,23,17,-17,-3.39705884456635,3.39705884456635,1,0,0,0,1,-1,0,0,108,0,108,-108
Ed Herman,Chris Price,Ed Herman,2007-01-25,1,0,2,-2,1.6875,4.75,-2.540009,2.540009,20,-20,4.580002,-4.580002,163,3,43,23,20,-20,-3.0625,3.0625,0,0,0,1,0,0,-1,1,107,107,0,0
Josh Koscheck,Chris Sanford,Josh Koscheck,2005-04-09,1,0,-10,10,1.545455,5,-2.539993,2.539993,-15,15,2.419998,-2.419998,189,0,28,6,22,-22,-3.45454549789429,3.45454549789429,0,0,0,0,0,0,0,0,0,0,0,0
Myles Jury,Chris Saunders,Myles Jury,2012-06-01,1,0,-3,3,4.25,2,5.080002,-5.080002,-10,10,10.42,-10.42,0,36,21,24,-3,3,2.25,-2.25,0,0,0,0,0,0,0,0,0,0,0,0
Adlan Amagov,Chris Spang,Adlan Amagov,2013-04-06,1,0,1,-1,7,2,0,0,0,0,2.039993,-2.039993,269,0,16,9,7,-7,5,-5,0,0,0,0,0,0,0,0,0,0,0,0
Daron Cruickshank,Chris Tickle,Daron Cruickshank,2012-06-01,1,0,-4,4,1.8,1,-2.539993,2.539993,0,0,4.880005,-4.880005,496,303,28,18,10,-10,0.799999952316284,-0.799999952316284,0,0,0,0,0,0,0,0,0,0,0,0
Gabriel Gonzaga,Chris Tuchscherer,Gabriel Gonzaga,2009-08-29,1,0,-3,3,1.545455,5.25,0,0,-16,16,0,0,117,0,28,25,3,-3,-3.70454549789429,3.70454549789429,2,0,1,0,2,-2,1,-1,287,0,287,-287
Tim Hague,Chris Tuchscherer,Chris Tuchscherer,2010-02-06,0,1,-8,8,1.615385,5.25,5.079987,-5.079987,2,-2,0,0,254,257,34,25,9,-9,-3.63461542129517,3.63461542129517,0,0,0,1,0,0,-1,1,0,161,-161,161
Brendan Schaub,Chris Tuchscherer,Brendan Schaub,2010-07-03,1,0,-7,7,2,5.25,5.079987,-5.079987,-13,13,5.080002,-5.080002,7,0,15,25,-10,10,-3.25,3.25,0,1,0,1,-1,1,-1,1,0,147,-147,147
Mark Hunt,Chris Tuchscherer,Mark Hunt,2011-02-26,1,0,1,-1,0.9285714,5.25,-10.16,10.16,7,-7,-10.15999,10.15999,2,105,27,25,2,-2,-4.32142859697342,4.32142859697342,0,0,0,2,0,0,-2,2,154,238,-84,84
Cain Carrizosa,Chris Wade,Chris Wade,2014-08-30,0,1,2,-2,3.333333,4,-5.080002,5.080002,0,0,-2.800003,2.800003,3,44,13,15,-2,2,-0.666666746139526,0.666666746139526,0,0,0,0,0,0,0,0,0,0,0,0
Zhang Lipeng,Chris Wade,Chris Wade,2015-01-18,0,1,-3,3,2.555556,4,2.539993,-2.539993,0,0,2.539993,-2.539993,226,540,32,15,17,-17,-1.44444441795349,1.44444441795349,2,1,0,0,1,-1,0,0,148,141,7,-7
Christos Giagos,Chris Wade,Chris Wade,2015-06-06,0,1,-2,2,1.818182,4,0,0,0,0,2.539993,-2.539993,171,388,31,15,16,-16,-2.18181812763214,2.18181812763214,0,2,0,0,-2,2,0,0,0,139,-139,139
Mehdi Baghdad,Chris Wade,Chris Wade,2016-01-17,0,1,2,-2,2.2,4,7.619995,-7.619995,0,0,11.33,-11.33,0,256,16,15,1,-1,-1.79999995231628,1.79999995231628,0,3,0,0,-3,3,0,0,0,225,-225,225
Rustam Khabilov,Chris Wade,Rustam Khabilov,2016-05-08,1,0,1,-1,6,4,-5.080002,5.080002,0,0,7.619995,-7.619995,397,162,28,15,13,-13,2,-2,1,4,0,0,-3,3,0,0,71,112,-41,41
Islam Makhachev,Chris Wade,Islam Makhachev,2016-09-17,1,0,-4,4,24,4,0,0,0,0,0,0,536,244,25,15,10,-10,20,-20,0,0,1,0,0,0,1,-1,350,132,218,-218
Frankie Perez,Chris Wade,Chris Wade,2017-07-22,0,1,-1,1,2.5,4,2.539993,-2.539993,0,0,7.619995,-7.619995,198,497,14,15,-1,1,-1.5,1.5,1,0,0,0,1,-1,0,0,699,308,391,-391
Alessio Sakara,Chris Weidman,Chris Weidman,2011-03-03,0,1,3,-3,1.727273,2.142857,-5.080002,5.080002,0,0,-15.23999,15.23999,3,479,30,22,8,-8,-0.415584325790405,0.415584325790405,3,0,0,0,3,-3,0,0,897,0,897,-897
Jesse Bongfeldt,Chris Weidman,Chris Weidman,2011-06-11,0,1,4,-4,3.2,2.142857,-5.080002,5.080002,0,0,-12.12,12.12,0,225,21,22,-1,1,1.05714297294617,-1.05714297294617,0,1,0,0,-1,1,0,0,0,100,-100,100
Tom Lawlor,Chris Weidman,Chris Weidman,2011-11-19,0,1,1,-1,1.666667,2.142857,-5.080002,5.080002,20,-20,-10.15999,10.15999,0,87,16,22,-6,6,-0.476190447807312,0.476190447807312,0,2,0,0,-2,2,0,0,677,161,516,-516
Demian Maia,Chris Weidman,Chris Weidman,2012-01-28,0,1,7,-7,2.545455,2.142857,-2.540009,2.540009,-15,15,-15.23999,15.23999,0,98,39,22,17,-17,0.402597427368164,-0.402597427368164,1,3,1,0,-2,2,1,-1,112,70,42,-42
Mark Munoz,Chris Weidman,Chris Weidman,2012-07-11,0,1,6,-6,2.333333,2.142857,-5.080002,5.080002,0,0,-17.78,17.78,0,312,20,22,-2,2,0.190476179122925,-0.190476179122925,1,4,0,0,-3,3,0,0,599,165,434,-434
Anderson Silva,Chris Weidman,Chris Weidman,2013-07-06,0,1,9,-9,3.090909,2.142857,0,0,0,0,-2.539993,2.539993,0,115,45,22,23,-23,0.948051929473877,-0.948051929473877,2,5,0,0,-3,3,0,0,364,360,4,-4
Anderson Silva,Chris Weidman,Chris Weidman,2013-12-28,0,1,9,-9,3.090909,2.142857,0,0,0,0,-2.539993,2.539993,0,262,45,22,23,-23,0.948051929473877,-0.948051929473877,0,6,1,0,-6,6,1,-1,175,175,0,0
Lyoto Machida,Chris Weidman,Chris Weidman,2014-07-05,0,1,6,-6,3,2.142857,-2.540009,2.540009,0,0,-10.15999,10.15999,19,278,32,22,10,-10,0.857142925262451,-0.857142925262451,2,7,1,0,-5,5,1,-1,140,189,-49,49
Vitor Belfort,Chris Weidman,Chris Weidman,2015-05-23,0,1,8,-8,1.857143,2.142857,-5.080002,5.080002,0,0,-10.15999,10.15999,0,73,40,22,18,-18,-0.285714268684387,0.285714268684387,3,8,3,0,-5,5,3,-3,560,322,238,-238
Luke Rockhold,Chris Weidman,Luke Rockhold,2015-12-12,1,0,0,0,2.666667,2.142857,2.539993,-2.539993,0,0,-2.539993,2.539993,332,267,22,22,0,0,0.523809671401978,-0.523809671401978,0,9,0,0,-9,9,0,0,0,203,-203,203
Yoel Romero,Chris Weidman,Yoel Romero,2016-11-12,1,0,7,-7,2.6,2.142857,-5.080002,5.080002,0,0,-12.7,12.7,113,25,18,22,-4,4,0.45714282989502,-0.45714282989502,3,0,0,1,3,-3,-1,1,336,336,0,0
Gegard Mousasi,Chris Weidman,Gegard Mousasi,2017-04-08,1,0,-1,1,7,2.142857,0,0,0,0,-5.080002,5.080002,38,201,48,22,26,-26,4.85714292526245,-4.85714292526245,2,0,0,2,2,-2,-2,2,273,147,126,-126
Kelvin Gastelum,Chris Weidman,Chris Weidman,2017-07-22,0,1,-8,8,2.25,2.142857,-12.70001,12.70001,-15,15,-17.78,17.78,7,454,26,22,4,-4,0.107142925262451,-0.107142925262451,2,0,0,3,2,-2,-3,3,224,105,119,-119
Jacare Souza,Chris Weidman,Jacare Souza,2018-11-03,1,0,4,-4,2.6,2.142857,-2.540009,2.540009,0,0,-15.23999,15.23999,7,43,36,22,14,-14,0.45714282989502,-0.45714282989502,0,1,1,3,-1,1,-2,2,567,469,98,-98
Dominick Reyes,Chris Weidman,Dominick Reyes,2019-10-18,1,0,-6,6,3,2.142857,5.079987,-5.079987,20,-20,-2.539993,2.539993,9,70,16,22,-6,6,0.857142925262451,-0.857142925262451,1,0,0,4,1,-1,-4,4,377,349,28,-28
Omari Akhmedov,Chris Weidman,Chris Weidman,2020-08-08,0,1,-4,4,3.5,2.142857,-5.080002,5.080002,0,0,-12.7,12.7,94,497,27,22,5,-5,1.35714292526245,-1.35714292526245,5,0,2,5,5,-5,-3,3,238,295,-57,57
Uriah Hall,Chris Weidman,Uriah Hall,2021-04-24,1,0,0,0,1.636364,2.142857,-5.080002,5.080002,0,0,2.540009,-2.540009,0,0,29,22,7,-7,-0.506493449211121,0.506493449211121,3,1,1,5,2,-2,-4,4,175,259,-84,84
Brad Tavares,Chris Weidman,Brad Tavares,2023-08-19,1,0,-4,4,2.222222,2.142857,-2.540009,2.540009,0,0,-10.15999,10.15999,0,81,29,22,7,-7,7.93652534484863e-02,-7.93652534484863e-02,1,0,1,6,1,-1,-5,5,2234,847,1387,-1387
Jon Fitch,Chris Wilson,Jon Fitch,2008-03-01,1,0,0,0,4.285714,1.8,-2.539993,2.539993,0,0,-2.539993,2.539993,478,8,37,28,9,-9,2.48571419715881,-2.48571419715881,3,0,0,0,3,-3,0,0,161,0,161,-161
Steve Bruno,Chris Wilson,Chris Wilson,2008-08-09,0,1,-5,5,2.5,1.8,-7.619995,7.619995,0,0,-10.5,10.5,68,540,21,28,-7,7,0.700000047683716,-0.700000047683716,0,0,0,0,0,0,0,0,0,161,-161,161
John Howard,Chris Wilson,John Howard,2009-01-31,1,0,-6,6,1.846154,1.8,-15.24001,15.24001,0,0,-7.619995,7.619995,361,191,37,28,9,-9,4.61539030075073e-02,-4.61539030075073e-02,0,1,0,0,-1,1,0,0,0,175,-175,175
Mike Pyle,Chris Wilson,Mike Pyle,2009-09-16,1,0,1,-1,1.928571,1.8,-2.539993,2.539993,0,0,-2.539993,2.539993,376,80,41,28,13,-13,0.128571510314941,-0.128571510314941,0,0,0,0,0,0,0,0,0,228,-228,228
Sean McCorkle,Christian Morecraft,Christian Morecraft,2011-03-26,0,1,10,-10,2.428571,2.666667,2.540009,-2.540009,5,-5,0,0,78,368,24,11,13,-13,-0.238095283508301,0.238095283508301,0,0,1,0,0,0,1,-1,105,0,105,-105
Matt Mitrione,Christian Morecraft,Matt Mitrione,2011-06-26,1,0,8,-8,2.4,2.666667,-7.619995,7.619995,5,-5,2.539993,-2.539993,53,109,17,11,6,-6,-0.266666650772095,0.266666650772095,0,1,0,0,-1,1,0,0,0,92,-92,92
Pat Barry,Christian Morecraft,Pat Barry,2012-01-20,1,0,7,-7,1.142857,2.666667,-17.78,17.78,-25,25,-17.78,17.78,25,81,15,11,4,-4,-1.52380955219269,1.52380955219269,0,0,1,1,0,0,0,0,111,208,-97,97
Jonathan Pearce,Christian Rodriguez,Jonathan Pearce,2022-02-19,1,0,5,-5,3.5,9,12.70001,-12.70001,10,-10,0,0,677,65,18,10,8,-8,-5.5,5.5,0,0,0,0,0,0,0,0,0,0,0,0
Cheick Kongo,Christian Wellisch,Cheick Kongo,2006-08-26,1,0,1,-1,2.7,1.6,5.079987,-5.079987,6,-6,12.7,-12.7,78,43,37,13,24,-24,1.10000002384186,-1.10000002384186,0,0,0,0,0,0,0,0,0,0,0,0
Anthony Perosh,Christian Wellisch,Christian Wellisch,2006-12-30,0,1,3,-3,1.5,1.6,2.539993,-2.539993,-29,29,-5.080002,5.080002,256,179,25,13,12,-12,-0.100000023841858,0.100000023841858,0,0,0,1,0,0,-1,1,0,126,-126,126
Scott Junk,Christian Wellisch,Christian Wellisch,2007-09-22,0,1,-4,4,2.666667,1.6,-2.540009,2.540009,31,-31,0.4199982,-0.4199982,74,48,11,13,-2,2,1.06666672229767,-1.06666672229767,0,1,0,1,-1,1,-1,1,0,266,-266,266
Shane Carwin,Christian Wellisch,Shane Carwin,2008-05-24,1,0,1,-1,6,1.6,0,0,31,-31,7.619995,-7.619995,0,0,14,13,1,-1,4.39999997615814,-4.39999997615814,0,2,0,1,-2,2,-1,1,0,245,-245,245
"Jake O'Brien",Christian Wellisch,"Jake O'Brien",2009-01-31,1,0,-9,9,3.75,1.6,2.539993,-2.539993,-29,29,-2.540009,2.540009,314,4,19,13,6,-6,2.14999997615814,-2.14999997615814,0,0,1,2,0,0,-1,1,196,252,-56,56
Montana De La Rosa,Christina Marks,Montana De La Rosa,2017-12-01,1,0,-10,10,1.5,0.8888889,0,0,0,0,-2.539993,2.539993,25,41,20,17,3,-3,0.611111104488373,-0.611111104488373,0,0,0,0,0,0,0,0,0,0,0,0
Gilbert Burns,Christos Giagos,Gilbert Burns,2014-10-25,1,0,4,-4,3.666667,1.818182,0,0,15,-15,0,0,216,0,28,31,-3,3,1.84848487377167,-1.84848487377167,1,0,0,0,1,-1,0,0,91,0,91,-91
Jorge de Oliveira,Christos Giagos,Christos Giagos,2015-03-21,0,1,10,-10,4.5,1.818182,-5.080002,5.080002,0,0,-5.339996,5.339996,0,161,11,31,-20,20,2.68181812763214,-2.68181812763214,0,0,0,0,0,0,0,0,133,147,-14,14
Noe Hernandez,Chuck Liddell,Chuck Liddell,1998-05-15,0,1,,,1,2.625,,,,,-3.999329e-02,3.999329e-02,0,0,10,29,-19,19,-1.625,1.625,0,0,0,0,0,0,0,0,0,0,0,0
Jeremy Horn,Chuck Liddell,Jeremy Horn,1999-03-05,1,0,-6,6,4.136364,2.625,-2.540009,2.540009,-20,20,-5.079987,5.079987,0,0,113,29,84,-84,1.51136350631714,-1.51136350631714,0,1,0,0,-1,1,0,0,294,294,0,0
Paul Jones,Chuck Liddell,Chuck Liddell,1999-09-24,0,1,7,-7,11,2.625,-12.70001,12.70001,-6,6,-15.03999,15.03999,40,124,12,29,-17,17,8.375,-8.375,1,0,0,0,1,-1,0,0,70,203,-133,133
Murilo Bustamante,Chuck Liddell,Chuck Liddell,2001-09-28,0,1,4,-4,1.875,2.625,0,0,-22,22,-2.039993,2.039993,53,108,23,29,-6,6,-0.75,0.75,0,1,0,0,-1,1,0,0,0,735,-735,735
Vitor Belfort,Chuck Liddell,Chuck Liddell,2002-06-22,0,1,-7,7,1.857143,2.625,-5.080002,5.080002,-20,20,-5.079987,5.079987,126,214,40,29,11,-11,-0.767857193946838,0.767857193946838,2,2,1,0,0,0,1,-1,1345,267,1078,-1078
Randy Couture,Chuck Liddell,Randy Couture,2003-06-06,1,0,6,-6,1.727273,2.625,-2.540009,2.540009,0,0,-2.539993,2.539993,202,124,30,29,1,-1,-0.897727251052856,0.897727251052856,0,3,1,0,-3,3,1,-1,252,349,-97,97
Randy Couture,Chuck Liddell,Chuck Liddell,2005-04-16,0,1,6,-6,1.727273,2.625,-2.540009,2.540009,0,0,-2.539993,2.539993,2,2,30,29,1,-1,-0.897727251052856,0.897727251052856,2,0,1,1,2,-2,0,0,568,680,-112,112
Jeremy Horn,Chuck Liddell,Chuck Liddell,2005-08-20,0,1,-6,6,4.136364,2.625,-2.540009,2.540009,-20,20,-5.079987,5.079987,3,77,113,29,84,-84,1.51136350631714,-1.51136350631714,0,1,0,1,-1,1,-1,1,1639,126,1513,-1513
Randy Couture,Chuck Liddell,Chuck Liddell,2006-02-04,0,1,6,-6,1.727273,2.625,-2.540009,2.540009,0,0,-2.539993,2.539993,56,0,30,29,1,-1,-0.897727251052856,0.897727251052856,1,2,2,1,-1,1,1,-1,168,168,0,0
Quinton Jackson,Chuck Liddell,Quinton Jackson,2007-05-26,1,0,-9,9,3.083333,2.625,-2.540009,2.540009,0,0,-7.619995,7.619995,4,0,49,29,20,-20,0.458333253860474,-0.458333253860474,0,3,0,1,-3,3,-1,1,0,476,-476,476
Keith Jardine,Chuck Liddell,Keith Jardine,2007-09-22,1,0,-6,6,1.545455,2.625,0,0,-20,20,0,0,6,0,28,29,-1,1,-1.07954549789429,1.07954549789429,2,0,0,2,2,-2,-2,2,595,119,476,-476
Rashad Evans,Chuck Liddell,Rashad Evans,2008-09-06,1,0,-10,10,2.375,2.625,-5.080002,5.080002,0,0,-2.539993,2.539993,0,0,27,29,-2,2,-0.25,0.25,4,0,0,2,4,-4,-2,2,590,350,240,-240
Rich Franklin,Chuck Liddell,Rich Franklin,2010-06-12,1,0,-5,5,4.142857,2.625,-2.540009,2.540009,-20,20,0,0,5,29,36,29,7,-7,1.51785707473755,-1.51785707473755,1,0,2,3,1,-1,-1,1,364,644,-280,280
Chris Cope,"Chuck O'Neil",Chris Cope,2011-06-04,1,0,3,-3,2,1.888889,-5.080002,5.080002,0,0,2.880005,-2.880005,35,104,12,26,-14,14,0.111111164093018,-0.111111164093018,0,0,0,0,0,0,0,0,0,0,0,0
Tanner Boser,Ciryl Gane,Ciryl Gane,2019-12-21,0,1,-1,1,2.1,6,-5.079987,5.079987,-40,40,-15.24001,15.24001,0,0,31,14,17,-17,-3.90000009536743,3.90000009536743,1,0,0,0,1,-1,0,0,64,0,64,-64
Junior Dos Santos,Ciryl Gane,Ciryl Gane,2020-12-12,0,1,6,-6,2.333333,6,0,0,-7,7,-10.16,10.16,0,25,30,14,16,-16,-3.66666674613953,3.66666674613953,0,1,5,0,-1,1,5,-5,119,357,-238,238
Ode Osbourne,CJ Vergara,Ode Osbourne,2021-11-06,1,0,-1,1,2,3,2.539993,-2.539993,0,0,12.7,-12.7,26,161,18,16,2,-2,-1,1,1,0,0,0,1,-1,0,0,273,0,273,-273
Kleydson Rodrigues,CJ Vergara,CJ Vergara,2022-05-07,0,1,-4,4,2.666667,3,-2.539993,2.539993,10,-10,-2.540009,2.540009,194,260,11,16,-5,5,-0.333333253860474,0.333333253860474,0,0,0,0,0,0,0,0,0,182,-182,182
Tatsuro Taira,CJ Vergara,Tatsuro Taira,2022-10-15,1,0,-9,9,14,3,2.539993,-2.539993,0,0,5.080002,-5.080002,379,36,14,16,-2,2,11,-11,0,1,0,0,-1,1,0,0,0,161,-161,161
Daniel Lacerda,CJ Vergara,CJ Vergara,2023-03-25,0,1,-5,5,2.2,3,0,0,0,0,5.080002,-5.080002,40,174,16,16,0,0,-0.799999952316284,0.799999952316284,0,0,1,0,0,0,1,-1,518,161,357,-357
Vinicius Salvador,CJ Vergara,CJ Vergara,2023-07-29,0,1,-5,5,2.333333,3,2.539993,-2.539993,0,0,5.080002,-5.080002,1,0,20,16,4,-4,-0.666666746139526,0.666666746139526,0,1,0,0,-1,1,0,0,0,126,-126,126
Ricardo Funch,Claude Patrick,Claude Patrick,2010-06-12,0,1,0,0,1.5,7,-2.539993,2.539993,0,0,-2.539993,2.539993,99,276,15,16,-1,1,-5.5,5.5,0,0,0,0,0,0,0,0,182,0,182,-182
Brian Ebersole,Claude Patrick,Brian Ebersole,2011-12-10,1,0,0,0,2.833333,7,2.540009,-2.540009,0,0,-5.080002,5.080002,539,85,69,16,53,-53,-4.16666674613953,4.16666674613953,2,1,0,0,1,-1,0,0,126,546,-420,420
Jessica Aguilar,Claudia Gadelha,Claudia Gadelha,2015-08-01,0,1,7,-7,2.5,3.6,-2.539993,2.539993,0,0,0,0,47,156,28,23,5,-5,-1.09999990463257,1.09999990463257,0,0,0,0,0,0,0,0,0,0,0,0
Cortney Casey,Claudia Gadelha,Claudia Gadelha,2016-11-19,0,1,2,-2,1,3.6,7.619995,-7.619995,10,-10,10.15999,-10.15999,19,385,20,23,-3,3,-2.59999990463257,2.59999990463257,2,1,0,0,1,-1,0,0,91,476,-385,385
Jessica Andrade,Claudia Gadelha,Jessica Andrade,2017-09-22,1,0,-3,3,2,3.6,-7.619995,7.619995,0,0,-2.540009,2.540009,515,8,36,23,13,-13,-1.59999990463257,1.59999990463257,0,2,1,0,-2,2,1,-1,132,307,-175,175
Carla Esparza,Claudia Gadelha,Claudia Gadelha,2018-06-09,0,1,1,-1,2.857143,3.6,-7.619995,7.619995,0,0,0,0,215,302,27,23,4,-4,-0.742856979370117,0.742856979370117,1,0,1,0,1,-1,1,-1,349,260,89,-89
Martin Bravo,Claudio Puelles,Martin Bravo,2016-11-05,1,0,3,-3,3.666667,4.333333,-5.080002,5.080002,-10,10,-2.540009,2.540009,2,34,14,16,-2,2,-0.666666746139526,0.666666746139526,0,0,0,0,0,0,0,0,0,0,0,0
Marcos Mariano,Claudio Puelles,Claudio Puelles,2019-09-21,0,1,9,-9,1,4.333333,7.619995,-7.619995,0,0,10.15999,-10.15999,48,800,12,16,-4,4,-3.33333349227905,3.33333349227905,0,0,0,1,0,0,-1,1,224,1050,-826,826
Jordan Leavitt,Claudio Puelles,Claudio Puelles,2021-06-05,0,1,1,-1,5.5,4.333333,-2.540009,2.540009,0,0,-2.540009,2.540009,126,601,13,16,-3,3,1.16666650772095,-1.16666650772095,1,1,0,1,0,0,-1,1,182,623,-441,441
Chris Gruetzemacher,Claudio Puelles,Claudio Puelles,2021-12-04,0,1,10,-10,3,4.333333,-5.080002,5.080002,0,0,-10.16,10.16,169,380,20,16,4,-4,-1.33333349227905,1.33333349227905,0,2,1,1,-2,2,0,0,399,182,217,-217
Clay Guida,Claudio Puelles,Claudio Puelles,2022-04-23,0,1,14,-14,1.9,4.333333,-7.62001,7.62001,0,0,-5.080002,5.080002,70,14,58,16,42,-42,-2.43333351612091,2.43333351612091,1,3,2,1,-2,2,1,-1,140,140,0,0
Dan Hooker,Claudio Puelles,Dan Hooker,2022-11-12,1,0,6,-6,1.916667,4.333333,5.080002,-5.080002,0,0,7.619995,-7.619995,128,8,35,16,19,-19,-2.41666686534882,2.41666686534882,0,4,0,1,-4,4,-1,1,378,203,175,-175
Abdul Razak Alhassan,Claudio Ribeiro,Abdul Razak Alhassan,2023-01-14,1,0,7,-7,2.4,2.75,-7.619995,7.619995,0,0,-10.16,10.16,188,16,17,15,2,-2,-0.349999904632568,0.349999904632568,0,0,1,0,0,0,1,-1,791,0,791,-791
Joseph Holmes,Claudio Ribeiro,Claudio Ribeiro,2023-05-06,0,1,-3,3,2,2.75,7.619995,-7.619995,0,0,7.619995,-7.619995,150,187,12,15,-3,3,-0.75,0.75,0,0,0,1,0,0,-1,1,189,112,77,-77
Roman Kopylov,Claudio Ribeiro,Roman Kopylov,2023-07-29,1,0,1,-1,6,2.75,-2.539993,2.539993,0,0,-5.080002,5.080002,3,16,14,15,-1,1,3.25,-3.25,1,1,0,1,0,0,-1,1,196,84,112,-112
Brad Scott,Claudio Silva,Claudio Silva,2014-03-08,0,1,-7,7,1.833333,3.5,5.080002,-5.080002,0,0,12.7,-12.7,68,318,17,18,-1,1,-1.66666662693024,1.66666662693024,0,0,0,0,0,0,0,0,449,0,449,-449
Leon Edwards,Claudio Silva,Claudio Silva,2014-11-08,0,1,-9,9,7,3.5,7.62001,-7.62001,0,0,7.62001,-7.62001,97,428,24,18,6,-6,3.5,-3.5,0,1,0,0,-1,1,0,0,0,245,-245,245
Danny Roberts,Claudio Silva,Claudio Silva,2019-03-16,0,1,-5,5,2.25,3.5,5.080002,-5.080002,0,0,7.62001,-7.62001,191,373,26,18,8,-8,-1.25,1.25,1,2,1,0,-1,1,1,-1,237,1589,-1352,1352
James Krause,Claudio Silva,James Krause,2020-10-17,1,0,-4,4,3.111111,3.5,7.62001,-7.62001,0,0,5.080002,-5.080002,14,58,37,18,19,-19,-0.388888835906982,0.388888835906982,2,3,0,0,-1,1,0,0,336,581,-245,245
Court McGee,Claudio Silva,Court McGee,2021-05-22,1,0,-2,2,1.833333,3.5,0,0,0,0,10.16,-10.16,483,108,34,18,16,-16,-1.66666662693024,1.66666662693024,0,0,1,0,0,0,1,-1,1288,217,1071,-1071
Nicolas Dalby,Claudio Silva,Nicolas Dalby,2022-07-23,1,0,-2,2,5.5,3.5,0,0,0,0,7.62001,-7.62001,257,437,26,18,8,-8,2,-2,0,0,0,0,0,0,0,0,392,427,-35,35
Gabriel Benitez,Clay Collard,Gabriel Benitez,2015-06-13,1,0,4,-4,2.090909,2,-7.619995,7.619995,10,-10,-5.080002,5.080002,57,287,34,21,13,-13,9.09090042114258e-02,-9.09090042114258e-02,1,0,0,0,1,-1,0,0,210,0,210,-210
Tyson Griffin,Clay Guida,Tyson Griffin,2007-06-16,1,0,-2,2,2,1.9,-2.539993,2.539993,-10,10,-5.080002,5.080002,109,471,24,58,-34,34,0.100000023841858,-0.100000023841858,1,0,0,0,1,-1,0,0,266,0,266,-266
Marcus Aurelio,Clay Guida,Clay Guida,2007-08-25,0,1,9,-9,2.2,1.9,7.62001,-7.62001,0,0,10.16,-10.16,0,206,32,58,-26,26,0.300000071525574,-0.300000071525574,0,0,0,0,0,0,0,0,0,70,-70,70
Mac Danzig,Clay Guida,Clay Guida,2008-09-17,0,1,2,-2,1.75,1.9,2.540009,-2.540009,0,0,0,0,34,516,33,58,-25,25,-0.149999976158142,0.149999976158142,1,1,0,0,0,0,0,0,284,389,-105,105
Nate Diaz,Clay Guida,Clay Guida,2009-01-31,0,1,-4,4,1.692308,1.9,12.70001,-12.70001,15,-15,15.23999,-15.23999,50,530,35,58,-23,23,-0.207692265510559,0.207692265510559,4,2,0,0,2,-2,0,0,136,136,0,0
Kenny Florian,Clay Guida,Kenny Florian,2009-12-12,1,0,5,-5,2.333333,1.9,7.62001,-7.62001,-10,10,10.16,-10.16,65,43,20,58,-38,38,0.433333277702332,-0.433333277702332,0,3,1,0,-3,3,1,-1,126,315,-189,189
Shannon Gugerty,Clay Guida,Clay Guida,2010-03-21,0,1,0,0,2.142857,1.9,7.62001,-7.62001,0,0,2.539993,-2.539993,2,448,22,58,-36,36,0.242857098579407,-0.242857098579407,1,0,0,0,1,-1,0,0,610,99,511,-511
Rafael Dos Anjos,Clay Guida,Clay Guida,2010-08-07,0,1,-3,3,2.133333,1.9,2.540009,-2.540009,15,-15,0,0,51,271,47,58,-11,11,0.233333468437195,-0.233333468437195,2,1,1,0,1,-1,1,-1,119,139,-20,20
Takanori Gomi,Clay Guida,Clay Guida,2011-01-01,0,1,3,-3,2.5,1.9,0,0,0,0,0,0,32,108,49,58,-9,9,0.600000023841858,-0.600000023841858,1,2,0,0,-1,1,0,0,153,147,6,-6
Dennis Bermudez,Clay Guida,Dennis Bermudez,2014-07-26,1,0,-5,5,1.888889,1.9,-2.539993,2.539993,0,0,-10.16,10.16,130,16,26,58,-32,32,-1.11111402511597e-02,1.11111402511597e-02,6,3,0,0,3,-3,0,0,133,1302,-1169,1169
Bobby Green,Clay Guida,Bobby Green,2020-06-20,1,0,-5,5,2.142857,1.9,7.62001,-7.62001,0,0,2.539993,-2.539993,71,272,44,58,-14,14,0.242857098579407,-0.242857098579407,0,0,1,0,0,0,1,-1,217,2156,-1939,1939
Rafa Garcia,Clay Guida,Rafa Garcia,2023-04-15,1,0,-13,13,5.333333,1.9,0,0,0,0,0,0,20,0,19,58,-39,39,3.43333351612091,-3.43333351612091,0,0,0,0,0,0,0,0,259,1029,-770,770
Justin Edwards,Clay Harvison,Clay Harvison,2011-06-04,0,1,-2,2,1.8,2.166667,-7.619995,7.619995,-15,15,-10.16,10.16,413,230,14,19,-5,5,-0.366666793823242,0.366666793823242,0,0,0,0,0,0,0,0,0,0,0,0
Seth Baczynski,Clay Harvison,Seth Baczynski,2011-09-17,1,0,-1,1,1.428571,2.166667,5.080002,-5.080002,0,0,2.539993,-2.539993,152,0,34,19,15,-15,-0.738095283508301,0.738095283508301,0,1,0,0,-1,1,0,0,455,105,350,-350
Dustin Jacoby,Clifford Starks,Clifford Starks,2011-10-29,0,1,-7,7,2.714286,4.333333,7.619995,-7.619995,20,-20,-5.080002,5.080002,0,352,26,16,10,-10,-1.61904788017273,1.61904788017273,0,0,0,0,0,0,0,0,0,0,0,0
Ed Herman,Clifford Starks,Ed Herman,2012-02-04,1,0,1,-1,1.6875,4.333333,2.539993,-2.539993,20,-20,-2.539993,2.539993,83,179,43,16,27,-27,-2.64583349227905,2.64583349227905,1,1,1,0,0,0,1,-1,174,98,76,-76
Yoel Romero,Clifford Starks,Yoel Romero,2013-04-20,1,0,4,-4,2.6,4.333333,0,0,0,0,-12.7,12.7,3,0,18,16,2,-2,-1.73333358764648,1.73333358764648,0,0,0,0,0,0,0,0,0,441,-441,441
Dylan Andrews,Clint Hester,Clint Hester,2013-12-06,0,1,7,-7,2.571429,1.833333,-2.540009,2.540009,-20,20,-7.619995,7.619995,146,210,25,17,8,-8,0.738095164299011,-0.738095164299011,1,0,0,0,1,-1,0,0,237,0,237,-237
Andy Enz,Clint Hester,Clint Hester,2014-02-01,0,1,-5,5,2.5,1.833333,2.539993,-2.539993,-20,20,2.539993,-2.539993,0,71,14,17,-3,3,0.666666626930237,-0.666666626930237,0,1,0,0,-1,1,0,0,0,57,-57,57
Antonio Braga Neto,Clint Hester,Clint Hester,2014-06-28,0,1,-1,1,3,1.833333,2.539993,-2.539993,-20,20,0,0,472,147,12,17,-5,5,1.16666662693024,-1.16666662693024,1,2,0,0,-1,1,0,0,385,147,238,-238
Mickey Gall,CM Punk,Mickey Gall,2016-09-10,1,0,-13,13,1.4,0,2.540009,-2.540009,0,0,2.540009,-2.540009,131,0,12,1,11,-11,1.39999997615814,-1.39999997615814,1,0,0,0,1,-1,0,0,217,0,217,-217
JP Buys,Cody Durden,Cody Durden,2022-06-25,0,1,-5,5,1.5,4,-5.079987,5.079987,10,-10,0,0,0,26,15,20,-5,5,-2.5,2.5,0,0,1,0,0,0,1,-1,280,0,280,-280
Curtis Blaydes,Cody East,Curtis Blaydes,2016-10-01,1,0,-3,3,4.25,4,2.539993,-2.539993,20,-20,10.2,-10.2,268,24,21,15,6,-6,0.25,-0.25,0,0,1,0,0,0,1,-1,174,0,174,-174
Marcus Brimage,Cody Garbrandt,Cody Garbrandt,2015-01-03,0,1,6,-6,1,2.6,-10.16,10.16,0,0,15.23999,-15.23999,17,29,14,18,-4,4,-1.59999990463257,1.59999990463257,1,0,1,0,1,-1,1,-1,57,0,57,-57
Henry Briones,Cody Garbrandt,Cody Garbrandt,2015-07-11,0,1,10,-10,2,2.6,0,0,0,0,10.15999,-10.15999,0,53,24,18,6,-6,-0.599999904632568,0.599999904632568,1,1,0,0,0,0,0,0,238,189,49,-49
Thomas Almeida,Cody Garbrandt,Cody Garbrandt,2016-05-29,0,1,0,0,4.4,2.6,-2.540009,2.540009,10,-10,12.7,-12.7,0,2,27,18,9,-9,1.80000019073486,-1.80000019073486,4,2,0,0,2,-2,0,0,204,323,-119,119
Dominick Cruz,Cody Garbrandt,Cody Garbrandt,2016-12-30,0,1,6,-6,6,2.6,0,0,0,0,7.619995,-7.619995,1,39,28,18,10,-10,3.40000009536743,-3.40000009536743,5,3,0,0,2,-2,0,0,209,215,-6,6
TJ Dillashaw,Cody Garbrandt,TJ Dillashaw,2017-11-04,1,0,5,-5,3.6,2.6,-5.080002,5.080002,0,0,5.079987,-5.079987,7,4,23,18,5,-5,1,-1,7,4,1,0,3,-3,1,-1,309,309,0,0
TJ Dillashaw,Cody Garbrandt,TJ Dillashaw,2018-08-04,1,0,5,-5,3.6,2.6,-5.080002,5.080002,0,0,5.079987,-5.079987,29,0,23,18,5,-5,1,-1,8,0,1,1,8,-8,0,0,273,273,0,0
Raphael Assuncao,Cody Garbrandt,Cody Garbrandt,2020-06-06,0,1,9,-9,2.8,2.6,-7.619995,7.619995,0,0,2.539993,-2.539993,0,3,38,18,20,-20,0.200000047683716,-0.200000047683716,0,0,1,2,0,0,-1,1,294,672,-378,378
Rob Font,Cody Garbrandt,Rob Font,2021-05-22,1,0,4,-4,2.857143,2.6,0,0,0,0,15.23999,-15.23999,73,182,27,18,9,-9,0.257143020629883,-0.257143020629883,3,1,0,2,2,-2,-2,2,154,350,-196,196
Johnny Bedford,Cody Gibson,Cody Gibson,2014-06-28,0,1,5,-5,1.615385,2.222222,0,0,0,0,0,0,0,4,34,29,5,-5,-0.606837749481201,0.606837749481201,0,0,0,0,0,0,0,0,427,0,427,-427
Manvel Gamburyan,Cody Gibson,Manvel Gamburyan,2014-09-27,1,0,6,-6,1.5,2.222222,-12.7,12.7,0,0,-10.16,10.16,92,162,25,29,-4,4,-0.722222328186035,0.722222328186035,0,1,0,0,-1,1,0,0,140,91,49,-49
Yves Edwards,Cody McKenzie,Yves Edwards,2011-01-22,1,0,11,-11,1.909091,1.6,-7.62001,7.62001,0,0,2.539993,-2.539993,121,172,64,26,38,-38,0.309090852737427,-0.309090852737427,1,0,1,0,1,-1,1,-1,129,0,129,-129
Marcus LeVesseur,Cody McKenzie,Cody McKenzie,2012-05-15,0,1,5,-5,3.142857,1.6,-7.62001,7.62001,0,0,-5.080002,5.080002,130,2,29,26,3,-3,1.54285705089569,-1.54285705089569,0,0,0,0,0,0,0,0,0,479,-479,479
Leonard Garcia,Cody McKenzie,Cody McKenzie,2013-04-27,0,1,8,-8,1.384615,1.6,-5.080002,5.080002,-10,10,-10.16,10.16,20,551,31,26,5,-5,-0.215384602546692,0.215384602546692,0,1,0,0,-1,1,0,0,119,347,-228,228
James Moontasri,Cody Pfister,James Moontasri,2015-02-14,1,0,2,-2,1.8,2.166667,0,0,15,-15,-5.080002,5.080002,148,143,14,19,-5,5,-0.366666793823242,0.366666793823242,0,0,0,0,0,0,0,0,0,0,0,0
Yosdenis Cedeno,Cody Pfister,Cody Pfister,2015-07-11,0,1,6,-6,1.666667,2.166667,-5.080002,5.080002,0,0,-10.16,10.16,72,427,16,19,-3,3,-0.50000011920929,0.50000011920929,0,0,0,0,0,0,0,0,280,147,133,-133
Sage Northcutt,Cody Pfister,Sage Northcutt,2015-12-10,1,0,-6,6,5.5,2.166667,5.080002,-5.080002,15,-15,-5.080002,5.080002,116,196,13,19,-6,6,3.33333325386047,-3.33333325386047,1,1,0,0,0,0,0,0,68,152,-84,84
Scott Holtzman,Cody Pfister,Scott Holtzman,2016-07-13,1,0,6,-6,2.333333,2.166667,-2.540009,2.540009,0,0,-10.16,10.16,381,212,20,19,1,-1,0.166666507720947,-0.166666507720947,0,0,0,0,0,0,0,0,0,216,-216,216
Tom Duquesnoy,Cody Stamann,Cody Stamann,2017-10-07,0,1,-3,3,8,3.5,2.539993,-2.539993,0,0,10.16,-10.16,17,169,18,27,-9,9,4.5,-4.5,1,0,0,0,1,-1,0,0,175,0,175,-175
Bryan Caraway,Cody Stamann,Cody Stamann,2018-03-03,0,1,5,-5,2.333333,3.5,5.080002,-5.080002,0,0,10.16,-10.16,299,0,30,27,3,-3,-1.16666674613953,1.16666674613953,3,1,0,0,2,-2,0,0,643,147,496,-496
Alejandro Perez,Cody Stamann,Cody Stamann,2019-03-02,0,1,0,0,2.555556,3.5,0,0,0,0,7.619995,-7.619995,29,82,32,27,5,-5,-0.944444417953491,0.944444417953491,2,2,0,0,0,0,0,0,231,364,-133,133
Brian Kelleher,Cody Stamann,Cody Stamann,2020-06-06,0,1,3,-3,1.714286,3.5,0,0,0,0,5.080002,-5.080002,44,108,38,27,11,-11,-1.78571426868439,1.78571426868439,1,3,1,0,-2,2,1,-1,140,462,-322,322
Jimmie Rivera,Cody Stamann,Jimmie Rivera,2020-07-15,1,0,1,-1,4.6,3.5,-5.080002,5.080002,0,0,10.16,-10.16,119,265,28,27,1,-1,1.09999990463257,-1.09999990463257,0,4,0,0,-4,4,0,0,403,39,364,-364
Merab Dvalishvili,Cody Stamann,Merab Dvalishvili,2021-05-01,1,0,-1,1,4,3.5,0,0,0,0,10.16,-10.16,102,177,20,27,-7,7,0.5,-0.5,4,0,0,0,4,-4,0,0,322,290,32,-32
Said Nurmagomedov,Cody Stamann,Said Nurmagomedov,2022-01-22,1,0,-3,3,5.666667,3.5,5.080002,-5.080002,0,0,15.24001,-15.24001,2,10,20,27,-7,7,2.16666650772095,-2.16666650772095,3,0,0,0,3,-3,0,0,462,266,196,-196
Luan Lacerda,Cody Stamann,Cody Stamann,2023-01-21,0,1,-3,3,4,3.5,2.539993,-2.539993,0,0,17.78,-17.78,94,0,15,27,-12,12,0.5,-0.5,0,0,0,0,0,0,0,0,0,364,-364,364
Douglas Silva de Andrade,Cody Stamann,Douglas Silva de Andrade,2023-05-13,1,0,4,-4,5.8,3.5,2.539993,-2.539993,0,0,10.16,-10.16,0,119,34,27,7,-7,2.30000019073486,-2.30000019073486,0,1,1,0,-1,1,1,-1,1596,112,1484,-1484
Warlley Alves,Colby Covington,Warlley Alves,2015-12-12,1,0,-3,3,2.5,5.666667,0,0,0,0,0,0,0,63,21,20,1,-1,-3.16666650772095,3.16666650772095,2,0,0,0,2,-2,0,0,133,0,133,-133
Bryan Barberena,Colby Covington,Colby Covington,2016-12-17,0,1,-1,1,1.636364,5.666667,2.540009,-2.540009,0,0,0,0,0,547,29,20,9,-9,-4.03030288219452,4.03030288219452,1,0,0,0,1,-1,0,0,322,371,-49,49
Renan Barao,Cole Escovedo,Renan Barao,2011-05-28,1,0,-5,5,3.777778,1.888889,-2.539993,2.539993,10,-10,-5.080002,5.080002,513,12,43,26,17,-17,1.88888883590698,-1.88888883590698,0,0,0,0,0,0,0,0,0,0,0,0
Alex Caceres,Cole Escovedo,Alex Caceres,2011-11-12,1,0,-7,7,1.5,1.888889,7.62001,-7.62001,10,-10,2.539993,-2.539993,51,116,35,26,9,-9,-0.388888835906982,0.388888835906982,0,0,0,0,0,0,0,0,90,168,-78,78
Leonard Garcia,Cole Miller,Cole Miller,2007-09-19,0,1,5,-5,1.384615,1.909091,-7.619995,7.619995,0,0,-12.7,12.7,145,678,31,32,-1,1,-0.524475455284119,0.524475455284119,0,0,0,0,0,0,0,0,165,0,165,-165
Jorge Gurgel,Cole Miller,Cole Miller,2008-07-05,0,1,7,-7,1.4,1.909091,-15.24001,15.24001,10,-10,-10.16,10.16,241,126,24,32,-8,8,-0.509090900421143,0.509090900421143,1,1,0,0,0,0,0,0,126,290,-164,164
Junie Browning,Cole Miller,Cole Miller,2009-04-01,0,1,0,0,0.8333333,1.909091,-10.16,10.16,10,-10,-7.419998,7.419998,66,0,11,32,-21,21,-1.07575756311417,1.07575756311417,1,2,0,0,-1,1,0,0,109,270,-161,161
Efrain Escudero,Cole Miller,Efrain Escudero,2009-09-19,1,0,-2,2,2.333333,1.909091,-10.16,10.16,10,-10,-5.080002,5.080002,5,0,40,32,8,-8,0.424242377281189,-0.424242377281189,1,3,0,0,-2,2,0,0,280,171,109,-109
Dan Lauzon,Cole Miller,Cole Miller,2010-01-02,0,1,-4,4,2.833333,1.909091,-7.619995,7.619995,10,-10,-7.419998,7.419998,46,6,23,32,-9,9,0.924242377281189,-0.924242377281189,0,0,0,1,0,0,-1,1,0,105,-105,105
Manvel Gamburyan,Cole Miller,Manvel Gamburyan,2013-08-17,1,0,3,-3,1.5,1.909091,-20.31999,20.31999,-10,10,-15.24001,15.24001,471,6,25,32,-7,7,-0.409090876579285,0.409090876579285,1,1,0,1,0,0,-1,1,378,1323,-945,945
Max Holloway,Cole Miller,Max Holloway,2015-02-14,1,0,-7,7,3.571429,1.909091,-5.080002,5.080002,0,0,-10.16,10.16,154,31,32,32,0,0,1.66233766078949,-1.66233766078949,0,0,0,1,0,0,-1,1,546,546,0,0
Alex Caceres,Cole Miller,Alex Caceres,2016-06-04,1,0,-5,5,1.5,1.909091,-7.619995,7.619995,0,0,0,0,181,152,35,32,3,-3,-0.409090876579285,0.409090876579285,1,0,1,1,1,-1,0,0,126,476,-350,350
Mizuto Hirota,Cole Miller,Mizuto Hirota,2016-12-17,1,0,3,-3,1.8,1.909091,-15.24001,15.24001,10,-10,-15.24001,15.24001,588,63,28,32,-4,4,-0.109090924263,0.109090924263,0,0,0,1,0,0,-1,1,1386,196,1190,-1190
Mitch Gagnon,Cole Smith,Cole Smith,2019-05-04,0,1,4,-4,2.4,3.5,-15.23999,15.23999,0,0,-5.079987,5.079987,126,482,17,9,8,-8,-1.09999990463257,1.09999990463257,0,0,0,0,0,0,0,0,875,0,875,-875
Miles Johns,Cole Smith,Miles Johns,2019-09-14,1,0,-5,5,7,3.5,-10.16,10.16,0,0,-2.539993,2.539993,172,511,16,9,7,-7,3.5,-3.5,0,1,0,0,-1,1,0,0,0,133,-133,133
Hunter Azure,Cole Smith,Hunter Azure,2020-09-05,1,0,-3,3,4.5,3.5,-7.619995,7.619995,10,-10,5.080002,-5.080002,482,193,11,9,2,-2,1,-1,0,0,1,0,0,0,1,-1,115,357,-242,242
Claudio Silva,Cole Williams,Claudio Silva,2019-08-03,1,0,1,-1,3.5,3.666667,-2.540009,2.540009,0,0,-5.080002,5.080002,84,0,18,14,4,-4,-0.166666746139526,0.166666746139526,1,0,0,0,1,-1,0,0,433,0,433,-433
Antoni Hardonk,Colin Robinson,Antoni Hardonk,2008-01-19,1,0,-8,8,1.333333,0.8333333,0,0,2,-2,5.119995,-5.119995,4,0,14,22,-8,8,0.500000059604645,-0.500000059604645,0,0,0,0,0,0,0,0,147,0,147,-147
Luke Barnatt,Collin Hart,Luke Barnatt,2013-04-13,1,0,2,-2,3.25,2,12.7,-12.7,0,0,6.580002,-6.580002,42,213,17,9,8,-8,1.25,-1.25,0,0,0,0,0,0,0,0,0,0,0,0
Mike Ricci,Colton Smith,Colton Smith,2012-12-15,0,1,1,-1,2.2,1.75,0,0,0,0,12.7,-12.7,34,746,16,11,5,-5,0.450000047683716,-0.450000047683716,0,0,0,0,0,0,0,0,0,0,0,0
Michael Chiesa,Colton Smith,Michael Chiesa,2013-11-06,1,0,-1,1,2.571429,1.75,2.539993,-2.539993,15,-15,10.16,-10.16,81,191,25,11,14,-14,0.821428537368774,-0.821428537368774,0,1,0,0,-1,1,0,0,102,326,-224,224
Diego Ferreira,Colton Smith,Diego Ferreira,2014-06-28,1,0,3,-3,3.6,1.75,-7.62001,7.62001,0,0,7.62001,-7.62001,10,10,23,11,12,-12,1.84999990463257,-1.84999990463257,0,0,0,0,0,0,0,0,0,234,-234,234
Marcus Brimage,Conor McGregor,Conor McGregor,2013-04-06,0,1,4,-4,1,3.666667,-12.7,12.7,-20,20,-7.62001,7.62001,0,5,14,28,-14,14,-2.66666674613953,2.66666674613953,1,0,0,0,1,-1,0,0,196,0,196,-196
Max Holloway,Conor McGregor,Conor McGregor,2013-08-17,0,1,-4,4,3.571429,3.666667,5.080002,-5.080002,-10,10,-12.70001,12.70001,0,388,32,28,4,-4,-9.5238208770752e-02,9.5238208770752e-02,2,1,0,0,1,-1,0,0,371,133,238,-238
Diego Brandao,Conor McGregor,Conor McGregor,2014-07-19,0,1,1,-1,2,3.666667,-5.080002,5.080002,-10,10,-25.40001,25.40001,22,142,33,28,5,-5,-1.66666674613953,1.66666674613953,0,2,1,0,-2,2,1,-1,203,336,-133,133
Jose Aldo,Conor McGregor,Conor McGregor,2015-12-12,0,1,2,-2,3.875,3.666667,-5.080002,5.080002,-20,20,-10.16,10.16,0,2,39,28,11,-11,0.208333253860474,-0.208333253860474,7,3,0,0,4,-4,0,0,413,511,-98,98
Nate Diaz,Conor McGregor,Nate Diaz,2016-03-05,1,0,3,-3,1.692308,3.666667,7.62001,-7.62001,15,-15,5.079987,-5.079987,70,39,35,28,7,-7,-1.97435903549194,1.97435903549194,1,4,1,0,-3,3,1,-1,77,84,-7,7
Nate Diaz,Conor McGregor,Conor McGregor,2016-08-20,0,1,3,-3,1.692308,3.666667,7.62001,-7.62001,15,-15,5.079987,-5.079987,350,91,35,28,7,-7,-1.97435903549194,1.97435903549194,2,0,1,0,2,-2,1,-1,168,168,0,0
Eddie Alvarez,Conor McGregor,Conor McGregor,2016-11-12,0,1,4,-4,4.833333,3.666667,0,0,0,0,-12.70001,12.70001,57,53,35,28,7,-7,1.16666674613953,-1.16666674613953,3,1,0,0,2,-2,0,0,128,84,44,-44
Donald Cerrone,Conor McGregor,Conor McGregor,2020-01-18,0,1,5,-5,2.117647,3.666667,10.16,-10.16,0,0,-2.540009,2.540009,0,13,53,28,25,-25,-1.54901957511902,1.54901957511902,0,2,6,0,-2,2,6,-6,126,1162,-1036,1036
Nick Catone,Constantinos Philippou,Nick Catone,2011-03-19,1,0,-2,2,2.5,2.6,2.540009,-2.540009,0,0,-2.539993,2.539993,518,0,14,18,-4,4,-9.99999046325684e-02,9.99999046325684e-02,1,0,0,0,1,-1,0,0,432,0,432,-432
Jared Hamman,Constantinos Philippou,Constantinos Philippou,2011-12-10,0,1,-3,3,2.333333,2.6,10.16,-10.16,0,0,5.080002,-5.080002,5,46,20,18,2,-2,-0.266666650772095,0.266666650772095,0,0,0,0,0,0,0,0,451,266,185,-185
Court McGee,Constantinos Philippou,Constantinos Philippou,2012-03-02,0,1,-5,5,1.833333,2.6,0,0,-15,15,5.080002,-5.080002,38,2,34,18,16,-16,-0.766666531562805,0.766666531562805,1,1,0,0,0,0,0,0,167,83,84,-84
Riki Fukuda,Constantinos Philippou,Constantinos Philippou,2012-07-07,0,1,-1,1,2.666667,2.6,2.540009,-2.540009,0,0,0,0,116,7,33,18,15,-15,6.6666841506958e-02,-6.6666841506958e-02,0,2,0,0,-2,2,0,0,497,127,370,-370
Tim Boetsch,Constantinos Philippou,Constantinos Philippou,2012-12-29,0,1,-2,2,1.615385,2.6,2.540009,-2.540009,0,0,2.540009,-2.540009,189,169,34,18,16,-16,-0.984615325927734,0.984615325927734,4,3,1,0,1,-1,1,-1,161,175,-14,14
Francis Carmont,Constantinos Philippou,Francis Carmont,2013-09-21,1,0,-2,2,2.083333,2.6,10.16,-10.16,20,-20,12.7,-12.7,750,0,37,18,19,-19,-0.516666650772095,0.516666650772095,4,4,0,0,0,0,0,0,154,266,-112,112
Lorenz Larkin,Constantinos Philippou,Constantinos Philippou,2014-05-10,0,1,-7,7,3,2.6,0,0,-15,15,-2.539993,2.539993,0,76,24,18,6,-6,0.400000095367432,-0.400000095367432,0,0,0,0,0,0,0,0,115,231,-116,116
Gegard Mousasi,Constantinos Philippou,Gegard Mousasi,2015-05-16,1,0,-6,6,7,2.6,7.62001,-7.62001,0,0,7.619995,-7.619995,652,0,48,18,30,-30,4.40000009536743,-4.40000009536743,0,1,0,0,-1,1,0,0,253,371,-118,118
Justin Buchholz,Corey Hill,Justin Buchholz,2008-07-05,1,0,-5,5,1.5,0.6666667,-10.15999,10.15999,0,0,-17.78,17.78,11,152,25,15,10,-10,0.833333313465118,-0.833333313465118,0,0,0,0,0,0,0,0,164,0,164,-164
Dale Hartt,Corey Hill,Dale Hartt,2008-12-10,1,0,-1,1,2,0.6666667,-15.23999,15.23999,0,0,-27.94,27.94,7,141,9,15,-6,6,1.33333331346512,-1.33333331346512,0,0,0,0,0,0,0,0,0,158,-158,158
Jessica Aguilar,Cortney Casey,Cortney Casey,2017-05-13,0,1,5,-5,2.5,1,-10.15999,10.15999,-10,10,-10.15999,10.15999,388,81,28,20,8,-8,1.5,-1.5,0,0,0,0,0,0,0,0,651,0,651,-651
Cynthia Calvillo,Cortney Casey,Cynthia Calvillo,2019-02-17,1,0,0,0,1.5,1,-7.619995,7.619995,-10,10,-7.619995,7.619995,58,0,15,20,-5,5,0.5,-0.5,0,1,0,0,-1,1,0,0,414,645,-231,231
JJ Aldrich,Cortney Casey,JJ Aldrich,2021-03-13,1,0,-5,5,2,1,-5.079987,5.079987,0,0,0,0,344,2,18,20,-2,2,1,-1,0,0,1,0,0,0,1,-1,420,755,-335,335
Kay Hansen,Cory McKenna,Cory McKenna,2020-11-14,0,1,0,0,1.166667,4,-2.540009,2.540009,0,0,12.7,-12.7,322,185,13,10,3,-3,-2.83333337306976,2.83333337306976,1,0,0,0,1,-1,0,0,140,0,140,-140
Miranda Granger,Cory McKenna,Cory McKenna,2022-08-06,0,1,7,-7,2.333333,4,10.15999,-10.15999,0,0,25.39999,-25.39999,5,280,10,10,0,0,-1.66666674613953,1.66666674613953,0,1,0,0,-1,1,0,0,630,630,0,0
Austin Arnett,Cory Sandhagen,Cory Sandhagen,2018-01-27,0,1,1,-1,2.666667,4.25,2.540009,-2.540009,10,-10,5.080002,-5.080002,68,115,22,21,1,-1,-1.58333325386047,1.58333325386047,0,0,0,0,0,0,0,0,0,0,0,0
Iuri Alcantara,Cory Sandhagen,Cory Sandhagen,2018-08-25,0,1,12,-12,3.5,4.25,-5.080002,5.080002,0,0,2.539993,-2.539993,73,251,45,21,24,-24,-0.75,0.75,1,1,0,0,0,0,0,0,203,210,-7,7
Mario Bautista,Cory Sandhagen,Cory Sandhagen,2019-01-19,0,1,-1,1,6.5,4.25,-5.080002,5.080002,0,0,-2.540009,2.540009,54,39,15,21,-6,6,2.25,-2.25,0,2,0,0,-2,2,0,0,0,147,-147,147
John Lineker,Cory Sandhagen,Cory Sandhagen,2019-04-27,0,1,1,-1,3.444444,4.25,-20.31999,20.31999,0,0,-7.62001,7.62001,14,36,40,21,19,-19,-0.805555582046509,0.805555582046509,7,3,0,0,4,-4,0,0,546,98,448,-448
Raphael Assuncao,Cory Sandhagen,Cory Sandhagen,2019-08-17,0,1,10,-10,2.8,4.25,-15.23999,15.23999,0,0,-10.16,10.16,131,226,38,21,17,-17,-1.45000004768372,1.45000004768372,0,4,1,0,-4,4,1,-1,196,112,84,-84
Marlon Moraes,Cory Sandhagen,Cory Sandhagen,2020-10-10,0,1,4,-4,2.3,4.25,-12.7,12.7,0,0,-7.62001,7.62001,9,4,33,21,12,-12,-1.95000004768372,1.95000004768372,2,5,0,0,-3,3,0,0,862,420,442,-442
Frankie Edgar,Cory Sandhagen,Cory Sandhagen,2021-02-06,0,1,11,-11,2.090909,4.25,-12.7,12.7,0,0,-5.080002,5.080002,0,0,34,21,13,-13,-2.15909099578857,2.15909099578857,1,6,2,0,-5,5,2,-2,168,119,49,-49
TJ Dillashaw,Cory Sandhagen,TJ Dillashaw,2021-07-24,1,0,6,-6,3.6,4.25,-12.7,12.7,0,0,-7.62001,7.62001,502,0,23,21,2,-2,-0.650000095367432,0.650000095367432,9,7,1,0,2,-2,1,-1,1085,168,917,-917
Rob Font,Cory Sandhagen,Cory Sandhagen,2023-08-05,0,1,5,-5,2.857143,4.25,-7.619995,7.619995,0,0,2.539993,-2.539993,68,1178,27,21,6,-6,-1.39285707473755,1.39285707473755,1,0,0,0,1,-1,0,0,119,742,-623,623
David Heath,Cory Walmsley,David Heath,2006-08-26,1,0,,,2.571429,4,-2.540009,2.540009,0,0,-2.119995,2.119995,140,2,25,10,15,-15,-1.42857146263123,1.42857146263123,0,0,0,0,0,0,0,0,0,0,0,0
Kris McCray,Court McGee,Court McGee,2010-06-19,0,1,3,-3,1.6,1.833333,2.540009,-2.540009,0,0,2.539993,-2.539993,0,324,13,34,-21,21,-0.233333349227905,0.233333349227905,0,0,0,0,0,0,0,0,0,0,0,0
Ryan Jensen,Court McGee,Court McGee,2010-10-23,0,1,8,-8,2.625,1.833333,5.080002,-5.080002,15,-15,2.539993,-2.539993,38,57,29,34,-5,5,0.791666626930237,-0.791666626930237,0,1,1,0,-1,1,1,-1,294,126,168,-168
Ryan LaFlare,Court McGee,Ryan LaFlare,2013-12-14,1,0,1,-1,4.666667,1.833333,5.080002,-5.080002,0,0,-2.539993,2.539993,59,147,17,34,-17,17,2.83333313465118,-2.83333313465118,1,2,0,0,-1,1,0,0,35,1148,-1113,1113
Marcio Alexandre Junior,Court McGee,Court McGee,2015-12-12,0,1,-5,5,4.25,1.833333,2.540009,-2.540009,15,-15,0,0,5,425,21,34,-13,13,2.41666662693024,-2.41666662693024,0,0,0,0,0,0,0,0,357,728,-371,371
Alex Garcia,Court McGee,Court McGee,2018-10-27,0,1,-2,2,2.5,1.833333,-5.080002,5.080002,0,0,-7.619995,7.619995,186,397,21,34,-13,13,0.666666626930237,-0.666666626930237,0,1,1,0,-1,1,1,-1,189,1050,-861,861
Dhiego Lima,Court McGee,Dhiego Lima,2019-04-27,1,0,-4,4,1.888889,1.833333,7.62001,-7.62001,0,0,0,0,41,60,26,34,-8,8,5.55554628372192e-02,-5.55554628372192e-02,0,2,1,0,-2,2,1,-1,378,182,196,-196
Sean Brady,Court McGee,Sean Brady,2019-10-18,1,0,-8,8,15,1.833333,-2.539993,2.539993,0,0,-7.619995,7.619995,42,84,16,34,-18,18,13.1666666269302,-13.1666666269302,0,0,0,0,0,0,0,0,0,174,-174,174
Carlos Condit,Court McGee,Carlos Condit,2020-10-03,1,0,1,-1,2.285714,1.833333,7.62001,-7.62001,0,0,0,0,2,0,46,34,12,-12,0.452381014823914,-0.452381014823914,0,0,1,0,0,0,1,-1,903,351,552,-552
Ramiz Brahimaj,Court McGee,Court McGee,2022-01-15,0,1,-8,8,2.5,1.833333,-2.539993,2.539993,0,0,-7.619995,7.619995,30,657,14,34,-20,20,0.666666626930237,-0.666666626930237,1,0,1,0,1,-1,1,-1,147,469,-322,322
Matt Brown,Court McGee,Matt Brown,2023-05-13,1,0,4,-4,1.368421,1.833333,2.540009,-2.540009,0,0,0,0,2,117,45,34,11,-11,-0.464912295341492,0.464912295341492,1,1,2,0,0,0,2,-2,693,483,210,-210
Chris Brennan,Courtney Turner,Chris Brennan,1998-03-13,1,0,,,1.615385,0,-15.24001,15.24001,0,0,-16,16,0,0,34,3,31,-31,1.61538457870483,-1.61538457870483,0,0,0,0,0,0,0,0,0,0,0,0
Martin Kampmann,Crafton Wallace,Martin Kampmann,2006-08-17,1,0,-6,6,2.857143,3,0,0,-15,15,-2.119995,2.119995,150,0,27,24,3,-3,-0.142857074737549,0.142857074737549,0,0,0,0,0,0,0,0,0,0,0,0
Nate Marquardt,Crafton Wallace,Nate Marquardt,2006-10-10,1,0,-3,3,1.842105,3,0,0,0,0,2.960007,-2.960007,215,45,54,24,30,-30,-1.15789473056793,1.15789473056793,1,0,0,0,1,-1,0,0,430,54,376,-376
Neil Magny,Craig White,Neil Magny,2018-05-27,1,0,3,-3,2.333333,1.555556,2.539993,-2.539993,0,0,10.16,-10.16,117,109,40,23,17,-17,0.777777671813965,-0.777777671813965,1,0,0,0,1,-1,0,0,1008,0,1008,-1008
Diego Sanchez,Craig White,Diego Sanchez,2018-09-08,1,0,8,-8,2.384615,1.555556,-10.16,10.16,0,0,-10.15999,10.15999,860,8,44,23,21,-21,0.829059839248657,-0.829059839248657,2,0,0,1,2,-2,-1,1,2877,104,2773,-2773
Kyung Ho Kang,Cristian Quinonez,Kyung Ho Kang,2023-06-17,1,0,8,-8,2.111111,4.5,2.539993,-2.539993,0,0,7.619995,-7.619995,40,0,28,22,6,-6,-2.38888883590698,2.38888883590698,0,0,0,0,0,0,0,0,574,0,574,-574
Tonya Evinger,Cristiane Justino,Cristiane Justino,2017-07-29,0,1,4,-4,2.375,10.5,-2.540009,2.540009,-10,10,5.080002,-5.080002,48,40,27,23,4,-4,-8.125,8.125,0,0,0,0,0,0,0,0,0,0,0,0
Holly Holm,Cristiane Justino,Cristiane Justino,2017-12-30,0,1,4,-4,2.142857,10.5,0,0,-10,10,2.539993,-2.539993,204,44,22,23,-1,1,-8.35714292526245,8.35714292526245,0,1,0,0,-1,1,0,0,525,154,371,-371
Reza Madadi,Cristiano Marcello,Cristiano Marcello,2012-10-13,0,1,0,0,2.333333,2.166667,5.080002,-5.080002,0,0,2.539993,-2.539993,131,0,20,19,1,-1,0.166666507720947,-0.166666507720947,0,0,0,0,0,0,0,0,0,0,0,0
Maryna Moroz,Cristina Stanciu,Maryna Moroz,2016-04-10,1,0,2,-2,2.2,2.5,10.15999,-10.15999,10,-10,7.179993,-7.179993,258,198,16,7,9,-9,-0.299999952316284,0.299999952316284,1,0,0,0,1,-1,0,0,365,0,365,-365
Cortney Casey,Cristina Stanciu,Cortney Casey,2016-07-13,1,0,7,-7,1,2.5,10.15999,-10.15999,10,-10,7.179993,-7.179993,58,0,20,7,13,-13,-1.5,1.5,0,0,0,0,0,0,0,0,228,94,134,-134
Ricardo Lamas,Cub Swanson,Ricardo Lamas,2011-11-12,1,0,1,-1,2.5,2.230769,0,0,0,0,2.539993,-2.539993,174,42,28,42,-14,14,0.269230842590332,-0.269230842590332,0,0,0,0,0,0,0,0,0,0,0,0
George Roop,Cub Swanson,Cub Swanson,2012-01-28,0,1,2,-2,1.153846,2.230769,12.7,-12.7,-10,10,5.080002,-5.080002,7,69,28,42,-14,14,-1.07692301273346,1.07692301273346,0,0,0,0,0,0,0,0,903,77,826,-826
Ross Pearson,Cub Swanson,Cub Swanson,2012-06-22,0,1,-1,1,1.25,2.230769,0,0,10,-10,-2.540009,2.540009,157,5,36,42,-6,6,-0.980769157409668,0.980769157409668,3,1,0,0,2,-2,0,0,814,146,668,-668
Charles Oliveira,Cub Swanson,Cub Swanson,2012-09-22,0,1,-6,6,3.777778,2.230769,5.080002,-5.080002,10,-10,10.16,-10.16,46,2,43,42,1,-1,1.5470085144043,-1.5470085144043,1,2,0,0,-1,1,0,0,238,92,146,-146
Dustin Poirier,Cub Swanson,Cub Swanson,2013-02-16,0,1,-5,5,3.625,2.230769,2.539993,-2.539993,10,-10,5.080002,-5.080002,242,181,37,42,-5,5,1.39423084259033,-1.39423084259033,0,3,0,0,-3,3,0,0,277,147,130,-130
Dennis Siver,Cub Swanson,Cub Swanson,2013-07-06,0,1,5,-5,2.090909,2.230769,-5.080002,5.080002,0,0,0,0,194,63,34,42,-8,8,-0.139860153198242,0.139860153198242,3,4,0,0,-1,1,0,0,735,140,595,-595
Jeremy Stephens,Cub Swanson,Cub Swanson,2014-06-28,0,1,-2,2,1.473684,2.230769,2.539993,-2.539993,0,0,2.539993,-2.539993,193,14,47,42,5,-5,-0.757084965705872,0.757084965705872,1,5,0,0,-4,4,0,0,1512,357,1155,-1155
Frankie Edgar,Cub Swanson,Frankie Edgar,2014-11-22,1,0,2,-2,2.090909,2.230769,-5.080002,5.080002,-10,10,-5.080002,5.080002,968,0,34,42,-8,8,-0.139860153198242,0.139860153198242,2,6,0,0,-4,4,0,0,139,147,-8,8
Max Holloway,Cub Swanson,Max Holloway,2015-04-18,1,0,-8,8,3.571429,2.230769,7.619995,-7.619995,0,0,-2.540009,2.540009,89,7,32,42,-10,10,1.34065937995911,-1.34065937995911,1,0,0,0,1,-1,0,0,63,147,-84,84
Hacran Dias,Cub Swanson,Cub Swanson,2016-04-16,0,1,-1,1,3.833333,2.230769,0,0,10,-10,-2.540009,2.540009,0,176,29,42,-13,13,1.60256409645081,-1.60256409645081,2,0,0,0,2,-2,0,0,294,364,-70,70
Tatsuya Kawajiri,Cub Swanson,Cub Swanson,2016-08-06,0,1,6,-6,3.272727,2.230769,-2.540009,2.540009,0,0,-2.540009,2.540009,327,122,47,42,5,-5,1.04195809364319,-1.04195809364319,3,1,0,0,2,-2,0,0,239,112,127,-127
Dooho Choi,Cub Swanson,Cub Swanson,2016-12-10,0,1,-8,8,3.5,2.230769,5.080002,-5.080002,0,0,0,0,53,150,18,42,-24,24,1.26923084259033,-1.26923084259033,3,2,0,0,1,-1,0,0,155,126,29,-29
Artem Lobov,Cub Swanson,Cub Swanson,2017-04-22,0,1,-3,3,0.8666667,2.230769,2.539993,-2.539993,0,0,-12.7,12.7,109,143,28,42,-14,14,-1.36410248279572,1.36410248279572,0,3,0,0,-3,3,0,0,441,133,308,-308
Brian Ortega,Cub Swanson,Brian Ortega,2017-12-09,1,0,-8,8,5,2.230769,0,0,0,0,-2.540009,2.540009,30,14,18,42,-24,24,2.76923084259033,-2.76923084259033,1,4,0,0,-3,3,0,0,917,231,686,-686
Frankie Edgar,Cub Swanson,Frankie Edgar,2018-04-21,1,0,2,-2,2.090909,2.230769,-5.080002,5.080002,-10,10,-5.080002,5.080002,51,0,34,42,-8,8,-0.139860153198242,0.139860153198242,0,0,1,0,0,0,1,-1,49,133,-84,84
Renato Moicano,Cub Swanson,Renato Moicano,2018-08-04,1,0,-5,5,3.4,2.230769,7.619995,-7.619995,10,-10,5.080002,-5.080002,81,0,22,42,-20,20,1.16923093795776,-1.16923093795776,0,0,0,0,0,0,0,0,371,105,266,-266
Shane Burgos,Cub Swanson,Shane Burgos,2019-05-04,1,0,-7,7,5,2.230769,7.619995,-7.619995,0,0,12.7,-12.7,0,97,18,42,-24,24,2.76923084259033,-2.76923084259033,1,0,1,0,1,-1,1,-1,182,273,-91,91
Kron Gracie,Cub Swanson,Cub Swanson,2019-10-12,0,1,-4,4,2.5,2.230769,2.539993,-2.539993,0,0,0,0,4,36,7,42,-35,35,0.269230842590332,-0.269230842590332,0,0,0,0,0,0,0,0,0,161,-161,161
Daniel Pineda,Cub Swanson,Cub Swanson,2020-12-12,0,1,-2,2,1.866667,2.230769,-2.540009,2.540009,0,0,-2.540009,2.540009,35,94,43,42,1,-1,-0.364102482795715,0.364102482795715,0,1,0,0,-1,1,0,0,2464,427,2037,-2037
Giga Chikadze,Cub Swanson,Giga Chikadze,2021-05-01,1,0,-5,5,5,2.230769,10.16,-10.16,0,0,10.16,-10.16,5,0,18,42,-24,24,2.76923084259033,-2.76923084259033,5,2,0,0,3,-3,0,0,175,140,35,-35
Darren Elkins,Cub Swanson,Cub Swanson,2021-12-18,0,1,-1,1,2.454545,2.230769,5.080002,-5.080002,0,0,2.539993,-2.539993,0,9,38,42,-4,4,0.223776340484619,-0.223776340484619,2,0,2,1,2,-2,1,-1,147,231,-84,84
Jonathan Martinez,Cub Swanson,Jonathan Martinez,2022-10-15,1,0,-10,10,4.5,2.230769,0,0,-10,10,0,0,210,20,22,42,-20,20,2.26923084259033,-2.26923084259033,3,1,0,1,2,-2,-1,1,147,301,-154,154
Hakeem Dawodu,Cub Swanson,Cub Swanson,2023-08-12,0,1,-7,7,3.25,2.230769,0,0,0,0,7.619995,-7.619995,190,85,17,42,-25,25,1.01923084259033,-1.01923084259033,0,0,0,2,0,0,-2,2,336,301,35,-35
Patrick Cote,Cung Le,Cung Le,2012-07-07,0,1,-8,8,2.090909,3,5.080002,-5.080002,-15,15,12.7,-12.7,70,73,34,12,22,-22,-0.909090995788574,0.909090995788574,0,0,1,0,0,0,1,-1,623,0,623,-623
Rich Franklin,Cung Le,Cung Le,2012-11-10,0,1,-2,2,4.142857,3,10.16,-10.16,0,0,15.23999,-15.23999,0,2,36,12,24,-24,1.14285707473755,-1.14285707473755,1,1,2,0,0,0,2,-2,140,126,14,-14
Michael Bisping,Cung Le,Michael Bisping,2014-08-23,1,0,-7,7,3.333333,3,10.16,-10.16,0,0,12.7,-12.7,3,0,39,12,27,-27,0.333333253860474,-0.333333253860474,0,2,1,0,-2,2,1,-1,129,651,-522,522
Spencer Fisher,Curt Warburton,Spencer Fisher,2010-10-16,1,0,,,2.666667,2.166667,-12.70001,12.70001,0,0,-12.7,12.7,126,461,33,19,14,-14,0.5,-0.5,0,0,2,0,0,0,2,-2,119,0,119,-119
Maciej Jewtuszko,Curt Warburton,Curt Warburton,2011-02-26,0,1,,,4,2.166667,0,0,0,0,0.5800018,-0.5800018,0,498,15,19,-4,4,1.83333325386047,-1.83333325386047,0,0,0,0,0,0,0,0,0,133,-133,133
Joe Lauzon,Curt Warburton,Joe Lauzon,2011-06-26,1,0,,,1.75,2.166667,-5.080002,5.080002,0,0,-5.080002,5.080002,27,0,44,19,25,-25,-0.416666746139526,0.416666746139526,0,1,0,0,-1,1,0,0,218,120,98,-98
Shamil Abdurakhimov,Curtis Blaydes,Curtis Blaydes,2019-09-07,0,1,10,-10,2.5,4.25,-2.539993,2.539993,-30,30,-10.16,10.16,0,367,28,21,7,-7,-1.75,1.75,3,0,2,0,3,-3,2,-2,140,0,140,-140
Tom Aspinall,Curtis Blaydes,Curtis Blaydes,2022-07-23,0,1,-2,2,4.333333,4.25,2.540009,-2.540009,-9,9,-5.080002,5.080002,0,1,16,21,-5,5,8.33334922790527e-02,-8.33334922790527e-02,4,1,0,0,3,-3,0,0,126,1050,-924,924
Thiago Alves,Curtis Millender,Curtis Millender,2018-02-18,0,1,4,-4,1.533333,3.4,-12.70001,12.70001,0,0,-15.23999,15.23999,14,15,38,22,16,-16,-1.86666679382324,1.86666679382324,1,0,2,0,1,-1,2,-2,316,0,316,-316
Max Griffin,Curtis Millender,Curtis Millender,2018-07-07,0,1,2,-2,1.9,3.4,-7.62001,7.62001,0,0,0,0,257,19,29,22,7,-7,-1.50000011920929,1.50000011920929,1,1,0,0,0,0,0,0,133,139,-6,6
Siyar Bahadurzada,Curtis Millender,Curtis Millender,2018-12-29,0,1,3,-3,3,3.4,-7.62001,7.62001,0,0,-7.619995,7.619995,194,17,32,22,10,-10,-0.400000095367432,0.400000095367432,3,2,0,0,1,-1,0,0,252,175,77,-77
Phil Baroni,Curtis Stout,Phil Baroni,2001-02-23,1,0,-3,3,0.8333333,0.9166667,-10.16,10.16,-15,15,-5.119995,5.119995,584,0,33,23,10,-10,-8.33333730697632e-02,8.33333730697632e-02,0,0,0,0,0,0,0,0,0,0,0,0
Trevor Prangley,Curtis Stout,Trevor Prangley,2004-06-19,1,0,1,-1,3.090909,0.9166667,0,0,0,0,2.5,-2.5,309,4,45,23,22,-22,2.17424231767654,-2.17424231767654,0,0,0,0,0,0,0,0,0,1212,-1212,1212
Poliana Botelho,Cynthia Calvillo,Cynthia Calvillo,2018-11-17,0,1,-2,2,1.6,1.5,10.16,-10.16,10,-10,7.619995,-7.619995,0,111,13,15,-2,2,0.100000023841858,-0.100000023841858,2,0,0,0,2,-2,0,0,182,0,182,-182
Jessica Andrade,Cynthia Calvillo,Jessica Andrade,2021-09-25,1,0,-4,4,2,1.5,-7.619995,7.619995,0,0,-5.080002,5.080002,0,0,36,15,21,-21,0.5,-0.5,0,1,3,0,-1,1,3,-3,154,1043,-889,889
Luiz Cane,Cyrille Diabate,Cyrille Diabate,2010-05-29,0,1,-7,7,2.428571,1.9,-10.15999,10.15999,-20,20,-10.16,10.16,65,10,24,29,-5,5,0.528571486473083,-0.528571486473083,0,0,1,0,0,0,1,-1,189,0,189,-189
Steve Cantwell,Cyrille Diabate,Cyrille Diabate,2011-03-03,0,1,-13,13,1.166667,1.9,-10.15999,10.15999,-20,20,-15.24001,15.24001,85,97,13,29,-16,16,-0.733333349227905,0.733333349227905,0,1,0,0,-1,1,0,0,533,278,255,-255
Tom DeBlass,Cyrille Diabate,Cyrille Diabate,2012-04-14,0,1,-9,9,4.5,1.9,-15.23999,15.23999,-20,20,-19.74001,19.74001,439,326,11,29,-18,18,2.60000002384186,-2.60000002384186,0,2,0,0,-2,2,0,0,0,408,-408,408
Khadis Ibragimov,Da Woon Jung,Da Woon Jung,2019-08-31,0,1,-1,1,2,3,-2.539993,2.539993,0,0,0,0,190,5,12,20,-8,8,-1,1,0,0,0,0,0,0,0,0,0,0,0,0
Mike Rodriguez,Da Woon Jung,Da Woon Jung,2019-12-21,0,1,5,-5,1.571429,3,0,0,0,0,10.16,-10.16,0,2,18,20,-2,2,-1.42857146263123,1.42857146263123,0,1,0,0,-1,1,0,0,0,112,-112,112
William Knight,Da Woon Jung,Da Woon Jung,2021-04-10,0,1,6,-6,2.2,3,-15.23999,15.23999,0,0,-12.7,12.7,9,724,16,20,-4,4,-0.799999952316284,0.799999952316284,0,2,0,0,-2,2,0,0,0,476,-476,476
Kennedy Nzechukwu,Da Woon Jung,Da Woon Jung,2021-11-13,0,1,2,-2,3,3,2.540009,-2.540009,0,0,12.70001,-12.70001,0,0,16,20,-4,4,0,0,2,3,0,0,-1,1,0,0,252,217,35,-35
Dustin Jacoby,Da Woon Jung,Dustin Jacoby,2022-07-16,1,0,6,-6,2.714286,3,-2.539993,2.539993,0,0,-5.080002,5.080002,0,0,26,20,6,-6,-0.285714387893677,0.285714387893677,3,4,0,0,-1,1,0,0,133,245,-112,112
Devin Clark,Da Woon Jung,Devin Clark,2023-02-04,1,0,3,-3,1.75,3,-10.15999,10.15999,0,0,-7.619995,7.619995,302,348,22,20,2,-2,-1.25,1.25,0,0,3,1,0,0,2,-2,175,203,-28,28
Carlos Ulberg,Da Woon Jung,Carlos Ulberg,2023-09-09,1,0,3,-3,10,3,0,0,0,0,-2.539993,2.539993,101,15,11,20,-9,9,7,-7,0,0,0,1,0,0,-1,1,0,217,-217,217
Farid Basharat,"Da'Mon Blackshear",Farid Basharat,2023-03-04,1,0,-3,3,11,2.333333,-5.080002,5.080002,0,0,-2.540009,2.540009,328,158,11,20,-9,9,8.66666674613953,-8.66666674613953,0,0,0,0,0,0,0,0,0,0,0,0
Mario Bautista,"Da'Mon Blackshear",Mario Bautista,2023-08-19,1,0,1,-1,6.5,2.333333,-2.540009,2.540009,0,0,-7.62001,7.62001,244,180,15,20,-5,5,4.16666674613953,-4.16666674613953,4,0,1,0,4,-4,1,-1,161,168,-7,7
Jeremy Horn,Daiju Takase,Jeremy Horn,1999-07-16,1,0,2,-2,4.136364,0.8,2.539993,-2.539993,15,-15,2.960007,-2.960007,177,0,113,27,86,-86,3.33636349439621,-3.33636349439621,1,0,0,0,1,-1,0,0,133,0,133,-133
Fabiano Iha,Daiju Takase,Fabiano Iha,2000-12-16,1,0,8,-8,1.8,0.8,-10.16,10.16,-15,15,-12,12,116,0,14,27,-13,13,0.999999940395355,-0.999999940395355,0,0,0,1,0,0,-1,1,281,519,-238,238
Viacheslav Borshchev,Dakota Bush,Viacheslav Borshchev,2022-01-15,1,0,3,-3,2.333333,2,2.539993,-2.539993,0,0,-10.16,10.16,28,90,10,12,-2,2,0.333333253860474,-0.333333253860474,0,0,0,0,0,0,0,0,0,0,0,0
Magomed Ankalaev,Dalcha Lungiambula,Magomed Ankalaev,2019-11-09,1,0,-5,5,18,1.833333,17.78,-17.78,20,-20,-2.539993,2.539993,334,20,19,17,2,-2,16.1666666269302,-16.1666666269302,1,0,0,0,1,-1,0,0,420,0,420,-420
Marc-Andre Barriault,Dalcha Lungiambula,Marc-Andre Barriault,2021-09-04,1,0,-3,3,2.666667,1.833333,12.7,-12.7,0,0,-5.079987,5.079987,31,32,22,17,5,-5,0.833333373069763,-0.833333373069763,0,0,0,1,0,0,-1,1,623,665,-42,42
Cody Brundage,Dalcha Lungiambula,Cody Brundage,2022-03-12,1,0,-7,7,1.8,1.833333,10.16,-10.16,0,0,-10.15999,10.15999,35,112,14,17,-3,3,-3.3333420753479e-02,3.3333420753479e-02,0,0,0,1,0,0,-1,1,168,189,-21,21
Shannon Gugerty,Dale Hartt,Shannon Gugerty,2008-07-19,1,0,-3,3,2.142857,2,0,0,0,0,5.080002,-5.080002,190,0,22,9,13,-13,0.142857074737549,-0.142857074737549,0,0,0,0,0,0,0,0,0,0,0,0
Brian Bowles,Damacio Page,Brian Bowles,2011-03-03,1,0,2,-2,3.333333,1.9,2.539993,-2.539993,0,0,10.16,-10.16,8,18,13,29,-16,16,1.43333327770233,-1.43333327770233,0,0,0,0,0,0,0,0,0,0,0,0
Alex Caceres,Damacio Page,Alex Caceres,2012-07-11,1,0,-5,5,1.5,1.9,10.16,-10.16,10,-10,17.78,-17.78,13,327,35,29,6,-6,-0.399999976158142,0.399999976158142,0,0,0,0,0,0,0,0,158,496,-338,338
Edgar Garcia,DaMarques Johnson,DaMarques Johnson,2009-12-12,0,1,-2,2,2.8,1,-7.619995,7.619995,0,0,-10.16,10.16,109,0,19,30,-11,11,1.79999995231628,-1.79999995231628,0,0,0,0,0,0,0,0,0,0,0,0
Brad Blackburn,DaMarques Johnson,DaMarques Johnson,2010-04-10,0,1,5,-5,1.384615,1,-7.619995,7.619995,0,0,-5.080002,5.080002,191,39,31,30,1,-1,0.384615421295166,-0.384615421295166,0,1,0,0,-1,1,0,0,89,119,-30,30
Mike Guymon,DaMarques Johnson,DaMarques Johnson,2011-01-22,0,1,8,-8,2.5,1,-2.539993,2.539993,0,0,-2.539993,2.539993,0,185,21,30,-9,9,1.5,-1.5,0,2,0,0,-2,2,0,0,91,287,-196,196
Clay Harvison,DaMarques Johnson,DaMarques Johnson,2011-11-12,0,1,2,-2,2.166667,1,0,0,0,0,-2.539993,2.539993,0,2,19,30,-11,11,1.16666674613953,-1.16666674613953,0,3,0,0,-3,3,0,0,0,294,-294,294
Yaotzin Meza,Damian Stasiak,Yaotzin Meza,2015-04-11,1,0,9,-9,1.909091,1.666667,10.15999,-10.15999,10,-10,2.539993,-2.539993,611,163,32,16,16,-16,0.242424249649048,-0.242424249649048,0,0,0,0,0,0,0,0,308,0,308,-308
Filip Pejic,Damian Stasiak,Damian Stasiak,2016-04-10,0,1,-3,3,6,1.666667,7.619995,-7.619995,0,0,-2.800003,2.800003,22,102,14,16,-2,2,4.33333337306976,-4.33333337306976,0,0,0,0,0,0,0,0,0,365,-365,365
Davey Grant,Damian Stasiak,Damian Stasiak,2016-10-08,0,1,4,-4,2.142857,1.666667,7.619995,-7.619995,0,0,-2.540009,2.540009,89,255,22,16,6,-6,0.476190447807312,-0.476190447807312,1,1,0,0,0,0,0,0,224,181,43,-43
Pedro Munhoz,Damian Stasiak,Pedro Munhoz,2017-05-28,1,0,3,-3,2.5,1.666667,2.539993,-2.539993,0,0,-12.7,12.7,147,13,28,16,12,-12,0.833333373069763,-0.833333373069763,1,2,0,0,-1,1,0,0,190,232,-42,42
Brian Kelleher,Damian Stasiak,Brian Kelleher,2017-10-21,1,0,4,-4,1.714286,1.666667,2.539993,-2.539993,0,0,-10.16,10.16,273,105,38,16,22,-22,4.7619104385376e-02,-4.7619104385376e-02,0,0,0,0,0,0,0,0,91,146,-55,55
Pingyuan Liu,Damian Stasiak,Pingyuan Liu,2018-07-22,1,0,-3,3,1.857143,1.666667,2.539993,-2.539993,0,0,5.080002,-5.080002,120,377,20,16,4,-4,0.190476179122925,-0.190476179122925,0,0,0,1,0,0,-1,1,0,274,-274,274
Cesar Arzamendia,Damien Brown,Damien Brown,2016-07-30,0,1,-6,6,2.666667,1.416667,2.539993,-2.539993,0,0,11.23,-11.23,3,51,11,29,-18,18,1.25000011920929,-1.25000011920929,0,0,1,0,0,0,1,-1,252,0,252,-252
Christos Giagos,Damir Hadzovic,Christos Giagos,2019-06-01,1,0,-3,3,1.818182,2,2.540009,-2.540009,0,0,2.539993,-2.539993,323,124,31,21,10,-10,-0.181818127632141,0.181818127632141,1,0,0,0,1,-1,0,0,182,0,182,-182
Marc Diakiese,Damir Hadzovic,Marc Diakiese,2022-07-23,1,0,-6,6,2.285714,2,2.540009,-2.540009,0,0,7.619995,-7.619995,815,0,23,21,2,-2,0.285714387893677,-0.285714387893677,0,0,0,0,0,0,0,0,735,1148,-413,413
Alex Gorgees,Damir Ismagulov,Damir Ismagulov,2018-12-01,0,1,-4,4,6,8,10.16,-10.16,0,0,0,0,0,586,7,27,-20,20,-2,2,0,0,0,0,0,0,0,0,0,0,0,0
Joel Alvarez,Damir Ismagulov,Damir Ismagulov,2019-02-23,0,1,-3,3,6.666667,8,12.7,-12.7,0,0,7.619995,-7.619995,0,0,23,27,-4,4,-1.33333349227905,1.33333349227905,0,1,0,0,-1,1,0,0,0,84,-84,84
Rafael Alves,Damir Ismagulov,Damir Ismagulov,2021-05-22,0,1,0,0,1.666667,8,-5.080002,5.080002,0,0,-15.24001,15.24001,16,460,32,27,5,-5,-6.33333337306976,6.33333337306976,0,2,0,0,-2,2,0,0,0,819,-819,819
Grant Dawson,Damir Ismagulov,Grant Dawson,2023-07-01,1,0,-3,3,20,8,0,0,0,0,-5.080002,5.080002,744,8,21,27,-6,6,12,-12,7,3,0,0,4,-4,0,0,238,770,-532,532
Mirsad Bektic,Damon Jackson,Damon Jackson,2020-09-19,0,1,-3,3,3.25,3.666667,-7.619995,7.619995,0,0,-2.539993,2.539993,564,56,17,28,-11,11,-0.416666746139526,0.416666746139526,0,0,2,0,0,0,2,-2,224,0,224,-224
Dan Argueta,Damon Jackson,Damon Jackson,2022-06-04,0,1,-5,5,4.5,3.666667,-10.16,10.16,-10,10,-7.619995,7.619995,164,625,11,28,-17,17,0.833333253860474,-0.833333253860474,0,1,0,0,-1,1,0,0,0,623,-623,623
Dan Ige,Damon Jackson,Dan Ige,2023-01-14,1,0,-3,3,2.428571,3.666667,-10.16,10.16,0,0,0,0,18,1,24,28,-4,4,-1.2380952835083,1.2380952835083,0,2,0,0,-2,2,0,0,574,224,350,-350
Nick Aguirre,Dan Argueta,Dan Argueta,2023-01-14,0,1,-3,3,7,4.5,5.080002,-5.080002,0,0,15.24001,-15.24001,75,614,8,11,-3,3,2.5,-2.5,0,0,0,0,0,0,0,0,0,0,0,0
Matt Arroyo,Dan Cramer,Dan Cramer,2009-01-31,0,1,3,-3,1,2.75,-10.16,10.16,0,0,-8.119995,8.119995,145,653,6,15,-9,9,-1.75,1.75,0,0,1,0,0,0,1,-1,224,0,224,-224
Pat Barry,Dan Evensen,Pat Barry,2008-12-27,1,0,-5,5,1.142857,2.75,-10.16,10.16,-15,15,-5.039993,5.039993,39,38,15,15,0,0,-1.60714280605316,1.60714280605316,0,0,0,0,0,0,0,0,0,0,0,0
Akihiro Gono,Dan Hardy,Dan Hardy,2008-10-18,0,1,8,-8,1.666667,2.5,-12.70001,12.70001,0,0,-15.24001,15.24001,66,2,56,35,21,-21,-0.833333373069763,0.833333373069763,1,0,0,0,1,-1,0,0,336,0,336,-336
Marcus Davis,Dan Hardy,Dan Hardy,2009-06-13,0,1,8,-8,2,2.5,-5.080002,5.080002,0,0,-10.16,10.16,364,266,33,35,-2,2,-0.5,0.5,2,1,1,0,1,-1,1,-1,147,238,-91,91
Carlos Condit,Dan Hardy,Carlos Condit,2010-10-16,1,0,-2,2,2.285714,2.5,5.080002,-5.080002,0,0,2.539993,-2.539993,3,0,46,35,11,-11,-0.214285612106323,0.214285612106323,2,2,0,0,0,0,0,0,126,490,-364,364
Allan Goes,Dan Henderson,Dan Henderson,1998-05-15,0,1,0,0,2,2.133333,2.540009,-2.540009,20,-20,-1.960007,1.960007,0,0,15,47,-32,32,-0.133333444595337,0.133333444595337,0,0,0,0,0,0,0,0,0,0,0,0
Rich Franklin,Dan Henderson,Dan Henderson,2009-01-17,0,1,-4,4,4.142857,2.133333,5.080002,-5.080002,0,0,5.079987,-5.079987,93,306,36,47,-11,11,2.00952363014221,-2.00952363014221,2,1,2,0,1,-1,2,-2,133,3900,-3767,3767
Michael Bisping,Dan Henderson,Dan Henderson,2009-07-11,0,1,-8,8,3.333333,2.133333,5.080002,-5.080002,0,0,2.539993,-2.539993,6,27,39,47,-8,8,1.19999980926514,-1.19999980926514,3,2,0,0,1,-1,0,0,266,175,91,-91
Rashad Evans,Dan Henderson,Rashad Evans,2013-06-15,1,0,-9,9,2.375,2.133333,2.540009,-2.540009,20,-20,2.539993,-2.539993,222,1,27,47,-20,20,0.241666555404663,-0.241666555404663,0,3,1,0,-3,3,1,-1,133,1435,-1302,1302
Vitor Belfort,Dan Henderson,Vitor Belfort,2013-11-09,1,0,-7,7,1.857143,2.133333,2.540009,-2.540009,0,0,0,0,12,0,40,47,-7,7,-0.276190638542175,0.276190638542175,2,0,3,0,2,-2,3,-3,175,147,28,-28
Daniel Cormier,Dan Henderson,Daniel Cormier,2014-05-24,1,0,-8,8,7.333333,2.133333,0,0,50,-50,-5.080002,5.080002,676,4,25,47,-22,22,5.20000004768372,-5.20000004768372,3,0,0,1,3,-3,-1,1,91,196,-105,105
Tim Boetsch,Dan Henderson,Dan Henderson,2015-06-06,0,1,-10,10,1.615385,2.133333,2.540009,-2.540009,0,0,0,0,0,5,34,47,-13,13,-0.517948865890503,0.517948865890503,0,0,2,1,0,0,1,-1,126,378,-252,252
Vitor Belfort,Dan Henderson,Vitor Belfort,2015-11-07,1,0,-7,7,1.857143,2.133333,2.540009,-2.540009,0,0,0,0,7,0,40,47,-7,7,-0.276190638542175,0.276190638542175,0,1,4,1,-1,1,3,-3,168,154,14,-14
Michael Bisping,Dan Henderson,Michael Bisping,2016-10-08,1,0,-9,9,3.333333,2.133333,5.080002,-5.080002,0,0,2.539993,-2.539993,1,103,39,47,-8,8,1.19999980926514,-1.19999980926514,4,0,1,2,4,-4,-1,1,126,336,-210,210
Ian Entwistle,Dan Hooker,Dan Hooker,2014-06-28,0,1,3,-3,3,1.916667,-17.78,17.78,-20,20,-22.5,22.5,21,113,12,35,-23,23,1.08333337306976,-1.08333337306976,0,0,0,0,0,0,0,0,0,0,0,0
Maximo Blanco,Dan Hooker,Maximo Blanco,2014-09-20,1,0,6,-6,1.5,1.916667,-10.16,10.16,-10,10,-10.16,10.16,155,105,20,35,-15,15,-0.416666626930237,0.416666626930237,1,1,0,0,0,0,0,0,112,84,28,-28
Hatsu Hioki,Dan Hooker,Dan Hooker,2015-05-09,0,1,6,-6,2.9,1.916667,-2.540009,2.540009,-10,10,-5.080002,5.080002,120,9,39,35,4,-4,0.983333468437195,-0.983333468437195,0,0,0,0,0,0,0,0,315,231,84,-84
Mark Eddiva,Dan Hooker,Dan Hooker,2016-03-19,0,1,4,-4,2,1.916667,-10.16,10.16,-10,10,-17.78,17.78,17,13,9,35,-26,26,8.33333730697632e-02,-8.33333730697632e-02,0,1,1,0,-1,1,1,-1,308,315,-7,7
Marc Diakiese,Dan Hooker,Dan Hooker,2017-12-30,0,1,-3,3,2.285714,1.916667,-5.080002,5.080002,0,0,-5.080002,5.080002,23,192,23,35,-12,12,0.36904776096344,-0.36904776096344,0,2,0,0,-2,2,0,0,176,651,-475,475
Gilbert Burns,Dan Hooker,Dan Hooker,2018-07-07,0,1,3,-3,3.666667,1.916667,-5.080002,5.080002,15,-15,-10.16,10.16,0,15,28,35,-7,7,1.75000011920929,-1.75000011920929,2,3,0,0,-1,1,0,0,84,189,-105,105
Edson Barboza,Dan Hooker,Edson Barboza,2018-12-15,1,0,4,-4,2.090909,1.916667,-2.540009,2.540009,-10,10,0,0,103,5,34,35,-1,1,0.174242377281189,-0.174242377281189,0,4,2,0,-4,4,2,-2,238,161,77,-77
Paul Felder,Dan Hooker,Dan Hooker,2020-02-22,0,1,5,-5,2.833333,1.916667,-2.540009,2.540009,0,0,-12.7,12.7,3,305,23,35,-12,12,0.916666626930237,-0.916666626930237,1,0,1,1,1,-1,0,0,370,434,-64,64
Michael Chandler,Dan Hooker,Michael Chandler,2021-01-23,1,0,4,-4,2.875,1.916667,-10.16,10.16,0,0,-10.16,10.16,9,0,31,35,-4,4,0.958333373069763,-0.958333373069763,0,1,0,1,-1,1,-1,1,0,336,-336,336
Nasrat Haqparast,Dan Hooker,Dan Hooker,2021-09-25,0,1,-5,5,3,1.916667,-5.080002,5.080002,0,0,-7.619995,7.619995,3,424,20,35,-15,15,1.08333337306976,-1.08333337306976,2,0,0,2,2,-2,-2,2,413,245,168,-168
Arnold Allen,Dan Hooker,Arnold Allen,2022-03-19,1,0,-4,4,9.5,1.916667,-10.16,10.16,-10,10,-12.7,12.7,2,0,21,35,-14,14,7.58333337306976,-7.58333337306976,8,1,0,2,7,-7,-2,2,343,175,168,-168
Julio Arce,Dan Ige,Julio Arce,2018-01-20,1,0,2,-2,3,2.428571,0,0,-10,10,-2.539993,2.539993,44,76,24,24,0,0,0.571428537368774,-0.571428537368774,0,0,0,0,0,0,0,0,0,0,0,0
Jordan Griffin,Dan Ige,Dan Ige,2018-12-15,0,1,1,-1,2,2.428571,7.62001,-7.62001,0,0,5.080002,-5.080002,240,413,27,24,3,-3,-0.428571462631226,0.428571462631226,0,0,0,0,0,0,0,0,0,329,-329,329
Danny Henry,Dan Ige,Dan Ige,2019-03-16,0,1,3,-3,3,2.428571,12.70001,-12.70001,0,0,5.080002,-5.080002,0,31,16,24,-8,8,0.571428537368774,-0.571428537368774,1,1,0,0,0,0,0,0,608,91,517,-517
Kevin Aguilar,Dan Ige,Dan Ige,2019-06-22,0,1,3,-3,3.4,2.428571,0,0,10,-10,5.080002,-5.080002,139,247,22,24,-2,2,0.971428632736206,-0.971428632736206,2,2,0,0,0,0,0,0,84,98,-14,14
Mirsad Bektic,Dan Ige,Dan Ige,2020-02-08,0,1,0,0,3.25,2.428571,2.540009,-2.540009,0,0,-2.539993,2.539993,393,54,17,24,-7,7,0.821428537368774,-0.821428537368774,0,3,2,0,-3,3,2,-2,210,231,-21,21
Edson Barboza,Dan Ige,Dan Ige,2020-05-16,0,1,6,-6,2.090909,2.428571,10.16,-10.16,0,0,10.16,-10.16,115,126,34,24,10,-10,-0.3376624584198,0.3376624584198,0,4,3,0,-4,4,3,-3,252,98,154,-154
Josh Emmett,Dan Ige,Josh Emmett,2021-12-11,1,0,6,-6,4.5,2.428571,-2.539993,2.539993,0,0,-2.539993,2.539993,47,21,22,24,-2,2,2.07142853736877,-2.07142853736877,1,5,1,0,-4,4,1,-1,987,574,413,-413
Movsar Evloev,Dan Ige,Movsar Evloev,2022-06-04,1,0,-2,2,17,2.428571,0,0,0,0,2.540009,-2.540009,407,10,17,24,-7,7,14.5714285373688,-14.5714285373688,2,0,0,0,2,-2,0,0,497,175,322,-322
Spencer Fisher,Dan Lauzon,Spencer Fisher,2006-10-14,1,0,12,-12,2.666667,2.833333,-7.62001,7.62001,0,0,-5.279999,5.279999,11,219,33,23,10,-10,-0.166666507720947,0.166666507720947,1,0,0,0,1,-1,0,0,140,0,140,-140
Efrain Escudero,Dan Lauzon,Efrain Escudero,2010-05-29,1,0,2,-2,2.333333,2.833333,-2.540009,2.540009,0,0,2.339996,-2.339996,94,45,40,23,17,-17,-0.5,0.5,2,0,0,1,2,-2,-1,1,252,1323,-1071,1071
Rob Kimmons,Dan Miller,Dan Miller,2008-09-17,0,1,0,0,2.777778,1.75,-7.619995,7.619995,0,0,-2.540009,2.540009,8,62,34,22,12,-12,1.02777767181396,-1.02777767181396,1,0,0,0,1,-1,0,0,88,0,88,-88
Matt Horwich,Dan Miller,Dan Miller,2008-10-25,0,1,3,-3,1.2,1.75,0,0,0,0,3.039993,-3.039993,222,627,55,22,33,-33,-0.549999952316284,0.549999952316284,0,1,0,0,-1,1,0,0,0,38,-38,38
Demian Maia,Dan Miller,Demian Maia,2010-02-06,1,0,4,-4,2.545455,1.75,0,0,-15,15,-5.080002,5.080002,316,11,39,22,17,-17,0.795454502105713,-0.795454502105713,0,2,1,0,-2,2,1,-1,161,469,-308,308
Michael Bisping,Dan Miller,Michael Bisping,2010-05-29,1,0,3,-3,3.333333,1.75,0,0,0,0,2.539993,-2.539993,0,45,39,22,17,-17,1.58333325386047,-1.58333325386047,0,0,1,0,0,0,1,-1,98,112,-14,14
Joe Doerksen,Dan Miller,Dan Miller,2010-12-11,0,1,4,-4,3.1875,1.75,-2.539993,2.539993,0,0,2.539993,-2.539993,77,715,67,22,45,-45,1.4375,-1.4375,0,0,3,0,0,0,3,-3,77,196,-119,119
Nate Marquardt,Dan Miller,Nate Marquardt,2011-03-19,1,0,2,-2,1.842105,1.75,-2.539993,2.539993,0,0,0,0,438,119,54,22,32,-32,9.21052694320679e-02,-9.21052694320679e-02,0,1,1,0,-1,1,1,-1,126,98,28,-28
Ricardo Funch,Dan Miller,Dan Miller,2012-06-22,0,1,1,-1,1.5,1.75,-7.619995,7.619995,-15,15,0,0,411,78,15,22,-7,7,-0.25,0.25,0,0,1,0,0,0,1,-1,160,461,-301,301
Jordan Mein,Dan Miller,Jordan Mein,2013-03-16,1,0,-8,8,2.583333,1.75,-2.539993,2.539993,-15,15,-2.540009,2.540009,18,33,43,22,21,-21,0.833333253860474,-0.833333253860474,0,1,0,0,-1,1,0,0,0,267,-267,267
Gilbert Burns,Dan Moret,Gilbert Burns,2018-04-14,1,0,0,0,3.666667,2.166667,-5.080002,5.080002,15,-15,-5.080002,5.080002,84,0,28,19,9,-9,1.5,-1.5,1,0,0,0,1,-1,0,0,210,0,210,-210
Jared Gordon,Dan Moret,Jared Gordon,2019-06-29,1,0,-2,2,3.166667,2.166667,-7.62001,7.62001,0,0,-12.7,12.7,584,130,25,19,6,-6,1,-1,0,0,1,1,0,0,0,0,196,441,-245,245
Anthony Macias,Dan Severn,Dan Severn,1994-12-16,0,1,,,1.444444,5.31579,-12.70001,12.70001,-65,65,-13,13,0,0,44,120,-76,76,-3.87134528160095,3.87134528160095,0,0,0,0,0,0,0,0,0,0,0,0
Marcus Bossett,Dan Severn,Dan Severn,1994-12-16,0,1,,,0.3333333,5.31579,-2.540009,2.540009,-35,35,-3,3,0,0,4,120,-116,116,-4.982456356287,4.982456356287,0,1,0,0,-1,1,0,0,0,0,0,0
Royce Gracie,Dan Severn,Royce Gracie,1994-12-16,1,0,-8,8,7.5,5.31579,-2.540009,2.540009,-75,75,3,-3,0,0,17,120,-103,103,2.18421030044556,-2.18421030044556,5,2,0,0,3,-3,0,0,0,0,0,0
Dave Beneteau,Dan Severn,Dan Severn,1995-04-07,0,1,,,1.2,5.31579,0,0,0,0,0,0,0,0,11,120,-109,109,-4.11578965187073,4.11578965187073,0,0,0,0,0,0,0,0,0,112,-112,112
Joe Charles,Dan Severn,Dan Severn,1995-04-07,0,1,,,0.4615385,5.31579,-2.540009,2.540009,10,-10,-10,10,0,0,19,120,-101,101,-4.8542512357235,4.8542512357235,1,1,0,0,0,0,0,0,112,0,112,-112
David Abbott,Dan Severn,Dan Severn,1995-12-16,0,1,,,0.6666667,5.31579,-5.080002,5.080002,15,-15,-8.5,8.5,0,0,25,120,-95,95,-4.64912301301956,4.64912301301956,0,2,0,0,-2,2,0,0,155,253,-98,98
Mark Coleman,Dan Severn,Mark Coleman,1997-02-07,1,0,-6,6,1.6,5.31579,-2.540009,2.540009,-45,45,-0.5,0.5,0,0,26,120,-94,94,-3.71578967571259,3.71578967571259,5,3,0,0,2,-2,0,0,140,419,-279,279
Pedro Rizzo,Dan Severn,Pedro Rizzo,2000-09-22,1,0,-16,16,1.818182,5.31579,-2.540009,2.540009,-9,9,-3,3,11,0,31,120,-89,89,-3.49760782718658,3.49760782718658,1,0,0,0,1,-1,0,0,504,1323,-819,819
Marcelo Guimaraes,Dan Stittgen,Marcelo Guimaraes,2012-07-11,1,0,-2,2,4.5,2.4,-2.539993,2.539993,15,-15,-2.580002,2.580002,455,13,11,17,-6,6,2.09999990463257,-2.09999990463257,0,0,0,0,0,0,0,0,0,0,0,0
Misha Cirkunov,Daniel Jolly,Misha Cirkunov,2015-08-23,1,0,-2,2,1.666667,1.666667,5.080002,-5.080002,0,0,5.080002,-5.080002,175,29,24,8,16,-16,0,0,0,0,0,0,0,0,0,0,0,0,0,0
Sam Alvey,Daniel Kelly,Sam Alvey,2015-05-09,1,0,-8,8,1.833333,3.25,5.080002,-5.080002,0,0,12.7,-12.7,4,0,51,17,34,-34,-1.41666662693024,1.41666662693024,2,0,0,0,2,-2,0,0,76,0,76,-76
Antonio Carlos Junior,Daniel Kelly,Daniel Kelly,2016-03-19,0,1,-12,12,2.2,3.25,5.080002,-5.080002,0,0,22.86,-22.86,298,73,16,17,-1,1,-1.04999995231628,1.04999995231628,1,0,0,1,1,-1,-1,1,266,315,-49,49
Chris Camozzi,Daniel Kelly,Daniel Kelly,2016-11-26,0,1,-9,9,1.846154,3.25,5.080002,-5.080002,0,0,12.7,-12.7,0,404,37,17,20,-20,-1.40384614467621,1.40384614467621,0,1,0,1,-1,1,-1,1,112,252,-140,140
Rashad Evans,Daniel Kelly,Daniel Kelly,2017-03-04,0,1,-2,2,2.375,3.25,0,0,20,-20,12.7,-12.7,7,11,27,17,10,-10,-0.875,0.875,0,2,2,1,-2,2,1,-1,322,98,224,-224
Derek Brunson,Daniel Kelly,Derek Brunson,2017-06-10,1,0,-6,6,2.555556,3.25,2.539993,-2.539993,0,0,17.78,-17.78,2,0,32,17,15,-15,-0.694444417953491,0.694444417953491,0,3,2,1,-3,3,1,-1,119,98,21,-21
Tom Breese,Daniel Kelly,Tom Breese,2018-05-27,1,0,-14,14,4,3.25,7.619995,-7.619995,0,0,7.619995,-7.619995,1,0,15,17,-2,2,0.75,-0.75,0,0,0,2,0,0,-2,2,722,351,371,-371
Francisco Figueiredo,Daniel Lacerda,Francisco Figueiredo,2022-04-30,1,0,7,-7,2.6,2.2,0,0,0,0,-5.080002,5.080002,0,28,18,16,2,-2,0.399999856948853,-0.399999856948853,0,0,0,0,0,0,0,0,287,0,287,-287
Victor Altamirano,Daniel Lacerda,Victor Altamirano,2022-08-20,1,0,5,-5,4,2.2,5.080002,-5.080002,0,0,0,0,115,3,15,16,-1,1,1.79999995231628,-1.79999995231628,0,0,0,0,0,0,0,0,175,112,63,-63
Davey Grant,Daniel Marcos,Daniel Marcos,2023-07-22,0,1,7,-7,2.142857,15,2.540009,-2.540009,0,0,0,0,6,13,22,15,7,-7,-12.8571429252625,12.8571429252625,1,0,0,0,1,-1,0,0,434,0,434,-434
Nandor Guelmino,Daniel Omielanczuk,Daniel Omielanczuk,2013-09-21,0,1,6,-6,2.2,2.375,7.619995,-7.619995,-17,17,5.039993,-5.039993,228,262,16,27,-11,11,-0.174999952316284,0.174999952316284,0,0,0,0,0,0,0,0,0,0,0,0
Anthony Hamilton,Daniel Omielanczuk,Anthony Hamilton,2015-04-11,1,0,2,-2,1.666667,2.375,12.7,-12.7,13,-13,5.079987,-5.079987,746,90,24,27,-3,3,-0.708333373069763,0.708333373069763,1,1,0,0,0,0,0,0,224,567,-343,343
Chris de la Rocha,Daniel Omielanczuk,Daniel Omielanczuk,2015-07-18,0,1,4,-4,1.666667,2.375,7.619995,-7.619995,3,-3,15.23999,-15.23999,2,0,8,27,-19,19,-0.708333373069763,0.708333373069763,0,0,0,0,0,0,0,0,0,98,-98,98
Jarjis Danho,Daniel Omielanczuk,Daniel Omielanczuk,2016-02-27,0,1,-1,1,7,2.375,7.619995,-7.619995,18,-18,0,0,165,45,8,27,-19,19,4.625,-4.625,0,1,0,0,-1,1,0,0,0,224,-224,224
Aleksei Oleinik,Daniel Omielanczuk,Daniel Omielanczuk,2016-07-13,0,1,6,-6,3.529412,2.375,5.080002,-5.080002,-7,7,15.23999,-15.23999,563,237,77,27,50,-50,1.15441179275513,-1.15441179275513,1,2,0,0,-1,1,0,0,599,137,462,-462
Timothy Johnson,Daniel Omielanczuk,Timothy Johnson,2017-03-18,1,0,-2,2,3,2.375,7.619995,-7.619995,18,-18,7.619995,-7.619995,522,35,16,27,-11,11,0.625,-0.625,0,3,0,0,-3,3,0,0,119,248,-129,129
Curtis Blaydes,Daniel Omielanczuk,Curtis Blaydes,2017-07-08,1,0,-8,8,4.25,2.375,10.15999,-10.15999,18,-18,15.23999,-15.23999,335,3,21,27,-6,6,1.875,-1.875,1,0,1,0,1,-1,1,-1,280,112,168,-168
Mike Brown,Daniel Pineda,Mike Brown,2012-05-26,1,0,10,-10,2.888889,1.866667,-2.539993,2.539993,0,0,2.540009,-2.540009,404,188,35,43,-8,8,1.02222216129303,-1.02222216129303,1,0,0,0,1,-1,0,0,294,0,294,-294
Antonio Carvalho,Daniel Pineda,Antonio Carvalho,2012-07-21,1,0,7,-7,2.5,1.866667,5.080002,-5.080002,0,0,2.540009,-2.540009,3,0,21,43,-22,22,0.633333325386047,-0.633333325386047,0,0,0,0,0,0,0,0,0,56,-56,56
Justin Lawrence,Daniel Pineda,Daniel Pineda,2013-04-13,0,1,-5,5,2.5,1.866667,2.540009,-2.540009,0,0,-5.080002,5.080002,0,79,14,43,-29,29,0.633333325386047,-0.633333325386047,0,0,0,1,0,0,-1,1,0,266,-266,266
Diego Brandao,Daniel Pineda,Diego Brandao,2013-08-17,1,0,-2,2,2,1.866667,0,0,0,0,-12.7,12.7,266,168,33,43,-10,10,0.133333325386047,-0.133333325386047,2,1,0,1,1,-1,-1,1,133,126,7,-7
Herbert Burns,Daniel Pineda,Daniel Pineda,2020-08-15,0,1,-3,3,2.75,1.866667,5.080002,-5.080002,0,0,10.16,-10.16,159,373,15,43,-28,28,0.883333325386047,-0.883333325386047,2,0,0,1,2,-2,-1,1,70,2555,-2485,2485
Tucker Lutz,Daniel Pineda,Daniel Pineda,2023-03-25,0,1,-9,9,3,1.866667,2.540009,-2.540009,0,0,7.62001,-7.62001,87,140,16,43,-27,27,1.13333332538605,-1.13333332538605,0,1,0,1,-1,1,-1,1,490,952,-462,462
Alex Caceres,Daniel Pineda,Alex Caceres,2023-06-03,1,0,-3,3,1.5,1.866667,7.62001,-7.62001,0,0,10.16,-10.16,266,237,35,43,-8,8,-0.366666674613953,0.366666674613953,1,2,1,1,-1,1,0,0,168,70,98,-98
John Howard,Daniel Roberts,John Howard,2010-03-21,1,0,-2,2,1.846154,2.142857,-7.62001,7.62001,0,0,-5.080002,5.080002,49,55,37,22,15,-15,-0.296703219413757,0.296703219413757,2,0,0,0,2,-2,0,0,225,0,225,-225
Forrest Petz,Daniel Roberts,Daniel Roberts,2010-07-03,0,1,5,-5,2.6,2.142857,-2.540009,2.540009,0,0,-7.62001,7.62001,56,433,36,22,14,-14,0.45714282989502,-0.45714282989502,0,0,0,1,0,0,-1,1,0,104,-104,104
Mike Guymon,Daniel Roberts,Daniel Roberts,2010-10-23,0,1,6,-6,2.5,2.142857,5.080002,-5.080002,0,0,0,0,17,2,21,22,-1,1,0.357142925262451,-0.357142925262451,1,1,0,1,0,0,-1,1,168,112,56,-56
Claude Patrick,Daniel Roberts,Claude Patrick,2011-04-30,1,0,0,0,7,2.142857,2.539993,-2.539993,0,0,2.539993,-2.539993,289,249,16,22,-6,6,4.85714292526245,-4.85714292526245,1,2,0,1,-1,1,-1,1,196,189,7,-7
Rich Attonito,Daniel Roberts,Rich Attonito,2011-06-26,1,0,4,-4,2,2.142857,0,0,0,0,-5.080002,5.080002,344,79,15,22,-7,7,-0.142857074737549,0.142857074737549,0,0,0,1,0,0,-1,1,204,57,147,-147
Charlie Brenneman,Daniel Roberts,Charlie Brenneman,2012-01-20,1,0,-1,1,2.375,2.142857,0,0,-15,15,-10.16,10.16,788,19,27,22,5,-5,0.232142925262451,-0.232142925262451,0,0,2,1,0,0,1,-1,111,208,-97,97
Tim Means,Daniel Rodriguez,Daniel Rodriguez,2020-02-15,0,1,2,-2,2.2,4.25,2.540009,-2.540009,0,0,2.539993,-2.539993,11,4,48,21,27,-27,-2.04999995231628,2.04999995231628,0,0,1,0,0,0,1,-1,343,0,343,-343
Gabe Green,Daniel Rodriguez,Daniel Rodriguez,2020-05-30,0,1,-6,6,2.2,4.25,-7.619995,7.619995,0,0,-2.540009,2.540009,11,27,16,21,-5,5,-2.04999995231628,2.04999995231628,0,1,0,0,-1,1,0,0,0,105,-105,105
Dwight Grant,Daniel Rodriguez,Daniel Rodriguez,2020-08-22,0,1,2,-2,1.833333,4.25,0,0,15,-15,5.079987,-5.079987,53,2,17,21,-4,4,-2.41666662693024,2.41666662693024,2,2,0,0,0,0,0,0,497,84,413,-413
Nicolas Dalby,Daniel Rodriguez,Nicolas Dalby,2020-11-21,1,0,3,-3,5.5,4.25,-5.080002,5.080002,0,0,0,0,88,41,26,21,5,-5,1.25,-1.25,1,3,0,0,-2,2,0,0,420,91,329,-329
Mike Perry,Daniel Rodriguez,Daniel Rodriguez,2021-04-10,0,1,-5,5,1.75,4.25,-7.619995,7.619995,0,0,-7.62001,7.62001,169,0,22,21,1,-1,-2.5,2.5,0,0,0,0,0,0,0,0,1211,140,1071,-1071
Preston Parsons,Daniel Rodriguez,Daniel Rodriguez,2021-07-17,0,1,-8,8,2.5,4.25,-5.080002,5.080002,0,0,-7.62001,7.62001,15,9,14,21,-7,7,-1.75,1.75,0,1,0,0,-1,1,0,0,0,98,-98,98
Kevin Lee,Daniel Rodriguez,Daniel Rodriguez,2021-08-28,0,1,-6,6,2.25,4.25,-10.16,10.16,0,0,7.619995,-7.619995,214,45,26,21,5,-5,-2,2,0,2,1,0,-2,2,1,-1,532,42,490,-490
Li Jingliang,Daniel Rodriguez,Daniel Rodriguez,2022-09-10,0,1,-1,1,2.375,4.25,-2.539993,2.539993,0,0,-7.62001,7.62001,2,0,27,21,6,-6,-1.875,1.875,2,3,0,0,-1,1,0,0,56,378,-322,322
Neil Magny,Daniel Rodriguez,Neil Magny,2022-11-05,1,0,0,0,2.333333,4.25,5.080002,-5.080002,0,0,15.23999,-15.23999,248,76,40,21,19,-19,-1.91666674613953,1.91666674613953,0,4,1,0,-4,4,1,-1,133,56,77,-77
Ian Garry,Daniel Rodriguez,Ian Garry,2023-05-13,1,0,-11,11,13,4.25,5.080002,-5.080002,0,0,0,0,10,0,13,21,-8,8,8.75,-8.75,4,0,0,0,4,-4,0,0,70,189,-119,119
Julio Arce,Daniel Santos,Julio Arce,2022-04-09,1,0,5,-5,3,6,0,0,0,0,7.62001,-7.62001,18,46,24,14,10,-10,-3,3,0,0,1,0,0,0,1,-1,147,0,147,-147
John Castaneda,Daniel Santos,Daniel Santos,2022-10-01,0,1,3,-3,3.333333,6,-2.539993,2.539993,0,0,10.16,-10.16,124,52,26,14,12,-12,-2.66666674613953,2.66666674613953,2,0,0,0,2,-2,0,0,238,175,63,-63
Johnny Munoz,Daniel Santos,Daniel Santos,2023-06-03,0,1,2,-2,4,6,5.080002,-5.080002,0,0,10.16,-10.16,79,647,15,14,1,-1,-2,2,2,1,0,0,1,-1,0,0,210,245,-35,35
CB Dollaway,Daniel Sarafian,CB Dollaway,2013-01-19,1,0,-1,1,1.888889,1.666667,12.70001,-12.70001,0,0,7.619995,-7.619995,146,117,26,16,10,-10,0.222222208976746,-0.222222208976746,1,0,2,0,1,-1,2,-2,238,0,238,-238
Eddie Mendez,Daniel Sarafian,Daniel Sarafian,2013-06-08,0,1,-1,1,2.666667,1.666667,2.540009,-2.540009,0,0,-5.419998,5.419998,22,66,11,16,-5,5,1.00000011920929,-1.00000011920929,0,0,0,0,0,0,0,0,0,140,-140,140
Cezar Ferreira,Daniel Sarafian,Cezar Ferreira,2013-11-09,1,0,-3,3,1.625,1.666667,10.16,-10.16,0,0,12.7,-12.7,507,119,21,16,5,-5,-4.16666269302368e-02,4.16666269302368e-02,2,1,0,0,1,-1,0,0,98,154,-56,56
Kiichi Kunimoto,Daniel Sarafian,Kiichi Kunimoto,2014-06-14,1,0,2,-2,2.571429,1.666667,2.540009,-2.540009,-15,15,-5.080002,5.080002,112,0,25,16,9,-9,0.904761910438538,-0.904761910438538,0,0,0,0,0,0,0,0,0,217,-217,217
Antonio Dos Santos,Daniel Sarafian,Daniel Sarafian,2014-12-20,0,1,-6,6,1.5,1.666667,2.540009,-2.540009,0,0,-5.419998,5.419998,77,20,10,16,-6,6,-0.166666626930237,0.166666626930237,0,0,0,0,0,0,0,0,0,189,-189,189
Oluwale Bamgbose,Daniel Sarafian,Oluwale Bamgbose,2016-02-21,1,0,-5,5,1.5,1.666667,5.080002,-5.080002,0,0,12.7,-12.7,5,0,10,16,-6,6,-0.166666626930237,0.166666626930237,0,1,1,0,-1,1,1,-1,197,428,-231,231
Mark Godbeer,Daniel Spitz,Mark Godbeer,2017-03-04,1,0,7,-7,3.25,2,-7.62001,7.62001,-5,5,-12.7,12.7,73,64,17,9,8,-8,1.25,-1.25,0,0,0,0,0,0,0,0,105,0,105,-105
Anthony Hamilton,Daniel Spitz,Daniel Spitz,2017-09-16,0,1,10,-10,1.666667,2,-5.080002,5.080002,15,-15,-15.24001,15.24001,0,2,24,9,15,-15,-0.333333373069763,0.333333373069763,0,0,0,0,0,0,0,0,281,196,85,-85
Walt Harris,Daniel Spitz,Walt Harris,2018-06-01,1,0,7,-7,1.3,2,-5.080002,5.080002,5,-5,-12.7,12.7,10,0,23,9,14,-14,-0.700000047683716,0.700000047683716,0,1,2,0,-1,1,2,-2,237,258,-21,21
Tanner Boser,Daniel Spitz,Tanner Boser,2019-10-18,1,0,-1,1,2.1,2,-12.7,12.7,-40,40,-17.78,17.78,0,0,31,9,22,-22,9.99999046325684e-02,-9.99999046325684e-02,0,0,0,1,0,0,-1,1,0,504,-504,504
Danny Henry,Daniel Teymur,Danny Henry,2017-07-16,1,0,-1,1,3,1.75,17.78,-17.78,0,0,10.16,-10.16,353,150,16,11,5,-5,1.25,-1.25,0,0,0,0,0,0,0,0,0,0,0,0
Julio Arce,Daniel Teymur,Julio Arce,2018-06-01,1,0,-2,2,3,1.75,5.079987,-5.079987,-10,10,2.540009,-2.540009,80,92,24,11,13,-13,1.25,-1.25,1,0,0,0,1,-1,0,0,132,320,-188,188
Chris Fishgold,Daniel Teymur,Chris Fishgold,2019-02-23,1,0,-5,5,4.5,1.75,7.619995,-7.619995,0,0,-2.539993,2.539993,187,78,22,11,11,-11,2.75,-2.75,0,0,1,0,0,0,1,-1,119,267,-148,148
Sung Bin Jo,Daniel Teymur,Daniel Teymur,2019-06-01,0,1,-5,5,9,1.75,17.78,-17.78,0,0,7.62001,-7.62001,9,236,10,11,-1,1,7.25,-7.25,0,0,0,0,0,0,0,0,0,98,-98,98
Chase Hooper,Daniel Teymur,Chase Hooper,2019-12-14,1,0,-11,11,4,1.75,20.31999,-20.31999,10,-10,12.70001,-12.70001,194,40,15,11,4,-4,2.25,-2.25,0,1,0,0,-1,1,0,0,0,196,-196,196
Trey Ogden,Daniel Zellhuber,Trey Ogden,2022-09-17,1,0,9,-9,2.666667,14,-5.080002,5.080002,0,0,-12.7,12.7,38,0,22,15,7,-7,-11.3333332538605,11.3333332538605,0,0,0,0,0,0,0,0,0,0,0,0
Lando Vannata,Daniel Zellhuber,Daniel Zellhuber,2023-04-15,0,1,8,-8,1.714286,14,-10.16,10.16,0,0,-15.24001,15.24001,6,104,19,15,4,-4,-12.2857142686844,12.2857142686844,0,0,0,0,0,0,0,0,0,210,-210,210
Christos Giagos,Daniel Zellhuber,Daniel Zellhuber,2023-09-16,0,1,9,-9,1.818182,14,-7.619995,7.619995,0,0,-15.24001,15.24001,11,17,31,15,16,-16,-12.1818181276321,12.1818181276321,1,1,1,0,0,0,1,-1,147,154,-7,7
Maryna Moroz,Danielle Taylor,Maryna Moroz,2016-08-06,1,0,-2,2,2.2,2.25,17.78,-17.78,10,-10,17.78,-17.78,0,1,16,13,3,-3,-4.99999523162842e-02,4.99999523162842e-02,2,0,0,0,2,-2,0,0,118,0,118,-118
Seo Hee Ham,Danielle Taylor,Danielle Taylor,2016-11-26,0,1,2,-2,2.125,2.25,5.080002,-5.080002,0,0,5.080002,-5.080002,8,0,25,13,12,-12,-0.125,0.125,0,0,0,0,0,0,0,0,252,112,140,-140
Jessica Penne,Danielle Taylor,Danielle Taylor,2017-04-22,0,1,7,-7,1.75,2.25,12.70001,-12.70001,0,0,17.78,-17.78,29,0,22,13,9,-9,-0.5,0.5,0,1,0,0,-1,1,0,0,0,147,-147,147
JJ Aldrich,Danielle Taylor,JJ Aldrich,2018-01-14,1,0,-3,3,2,2.25,12.70001,-12.70001,10,-10,17.78,-17.78,112,0,18,13,5,-5,-0.25,0.25,1,2,0,0,-1,1,0,0,218,267,-49,49
Jesse Lennox,Danillo Villefort,Jesse Lennox,2009-08-08,1,0,1,-1,3.5,3,-10.16,10.16,-15,15,-2.119995,2.119995,67,62,18,20,-2,2,0.5,-0.5,0,0,0,0,0,0,0,0,0,0,0,0
Joel Alvarez,Danilo Belluardo,Joel Alvarez,2019-06-01,1,0,2,-2,6.666667,2.4,7.619995,-7.619995,0,0,7.619995,-7.619995,17,262,23,17,6,-6,4.26666641235352,-4.26666641235352,0,0,0,0,0,0,0,0,98,0,98,-98
Khadis Ibragimov,Danilo Marques,Danilo Marques,2020-09-26,0,1,-9,9,2,2.75,-7.619995,7.619995,0,0,2.539993,-2.539993,90,436,12,15,-3,3,-0.75,0.75,0,0,0,0,0,0,0,0,392,0,392,-392
Jailton Almeida,Danilo Marques,Jailton Almeida,2022-02-05,1,0,-6,6,9.5,2.75,-7.619995,7.619995,0,0,5.080002,-5.080002,168,0,21,15,6,-6,6.75,-6.75,0,1,0,0,-1,1,0,0,0,497,-497,497
Shamar Bailey,Danny Castillo,Danny Castillo,2011-11-19,0,1,-3,3,1.454545,1.7,0,0,0,0,10.16,-10.16,0,276,27,27,0,0,-0.245454549789429,0.245454549789429,0,0,0,0,0,0,0,0,63,0,63,-63
Edson Barboza,Danny Castillo,Edson Barboza,2013-12-14,1,0,-7,7,2.090909,1.7,5.080002,-5.080002,-10,10,10.16,-10.16,53,184,34,27,7,-7,0.39090895652771,-0.39090895652771,2,1,1,0,1,-1,1,-1,161,756,-595,595
Charlie Brenneman,Danny Castillo,Danny Castillo,2014-04-26,0,1,-1,1,2.375,1.7,2.540009,-2.540009,0,0,-2.539993,2.539993,130,58,27,27,0,0,0.674999952316284,-0.674999952316284,0,0,3,0,0,0,3,-3,101,133,-32,32
TJ Brown,Danny Chavez,Danny Chavez,2020-08-15,0,1,-3,3,1.7,2.2,2.539993,-2.539993,0,0,12.70001,-12.70001,63,125,27,16,11,-11,-0.5,0.5,0,0,0,0,0,0,0,0,168,0,168,-168
Hakeem Dawodu,Danny Henry,Danny Henry,2018-03-17,0,1,-3,3,3.25,3,-10.16,10.16,0,0,0,0,0,13,17,16,1,-1,0.25,-0.25,0,0,0,0,0,0,0,0,0,0,0,0
Makwan Amirkhani,Danny Henry,Makwan Amirkhani,2020-07-11,1,0,0,0,1.888889,3,-5.080002,5.080002,0,0,-2.539993,2.539993,47,0,26,16,10,-10,-1.11111116409302,1.11111116409302,0,1,1,0,-1,1,1,-1,252,847,-595,595
Chris Cariaso,Danny Martinez,Chris Cariaso,2014-02-01,1,0,4,-4,2.125,2.625,-7.619995,7.619995,0,0,-7.619995,7.619995,0,451,25,29,-4,4,-0.5,0.5,1,0,0,0,1,-1,0,0,115,0,115,-115
Scott Jorgensen,Danny Martinez,Scott Jorgensen,2014-06-07,1,0,3,-3,1.25,2.625,-2.539993,2.539993,10,-10,-2.539993,2.539993,438,72,27,29,-2,2,-1.375,1.375,0,0,1,0,0,0,1,-1,175,126,49,-49
Sirwan Kakai,Danny Martinez,Sirwan Kakai,2015-06-27,1,0,-5,5,2.4,2.625,-2.539993,2.539993,10,-10,-0.1799927,0.1799927,318,7,17,29,-12,12,-0.224999904632568,0.224999904632568,0,0,0,0,0,0,0,0,0,385,-385,385
Igor Araujo,Danny Mitchell,Igor Araujo,2014-03-08,1,0,6,-6,2.777778,2.111111,-2.540009,2.540009,0,0,6.580002,-6.580002,532,209,34,28,6,-6,0.666666507720947,-0.666666507720947,0,0,0,0,0,0,0,0,0,0,0,0
Nathan Coy,Danny Roberts,Danny Roberts,2015-12-10,0,1,9,-9,2.142857,2.25,-7.619995,7.619995,0,0,-12.70001,12.70001,43,0,22,26,-4,4,-0.107142925262451,0.107142925262451,0,0,0,0,0,0,0,0,0,0,0,0
Mike Perry,Danny Roberts,Mike Perry,2016-10-08,1,0,-4,4,1.75,2.25,-7.619995,7.619995,0,0,-7.62001,7.62001,102,0,22,26,-4,4,-0.5,0.5,0,1,0,0,-1,1,0,0,0,303,-303,303
Bobby Nash,Danny Roberts,Danny Roberts,2017-07-16,0,1,-3,3,2,2.25,-2.539993,2.539993,0,0,0,0,181,10,12,26,-14,14,-0.25,0.25,0,0,0,1,0,0,-1,1,0,281,-281,281
Oliver Enkamp,Danny Roberts,Danny Roberts,2018-03-17,0,1,-4,4,3.5,2.25,-2.539993,2.539993,0,0,7.619995,-7.619995,24,2,9,26,-17,17,1.25,-1.25,0,1,0,1,-1,1,-1,1,293,244,49,-49
Michel Pereira,Danny Roberts,Michel Pereira,2019-05-18,1,0,-6,6,2.545455,2.25,0,0,15,-15,-2.540009,2.540009,2,0,39,26,13,-13,0.295454502105713,-0.295454502105713,0,2,0,1,-2,2,-1,1,0,427,-427,427
Zelim Imadaev,Danny Roberts,Danny Roberts,2019-11-09,0,1,-8,8,2.666667,2.25,-2.539993,2.539993,0,0,5.079987,-5.079987,150,139,11,26,-15,15,0.416666746139526,-0.416666746139526,0,0,0,2,0,0,-2,2,0,175,-175,175
Ramazan Emeev,Danny Roberts,Danny Roberts,2021-10-16,0,1,0,0,3.333333,2.25,-7.619995,7.619995,0,0,5.079987,-5.079987,177,158,26,26,0,0,1.08333325386047,-1.08333325386047,2,1,0,2,1,-1,-2,2,273,707,-434,434
Jack Della Maddalena,Danny Roberts,Jack Della Maddalena,2022-11-19,1,0,-9,9,8,2.25,-5.080002,5.080002,0,0,-2.540009,2.540009,34,15,18,26,-8,8,5.75,-5.75,2,2,0,2,0,0,-2,2,161,399,-238,238
Jonny Parsons,Danny Roberts,Jonny Parsons,2023-07-22,1,0,-5,5,4.5,2.25,-10.16,10.16,0,0,-12.70001,12.70001,86,5,11,26,-15,15,2.25,-2.25,0,0,0,3,0,0,-3,3,0,245,-245,245
Matthew Riddle,Dante Rivera,Matthew Riddle,2008-06-21,1,0,-11,11,2.666667,2.285714,0,0,-15,15,5.039993,-5.039993,549,149,11,23,-12,12,0.38095235824585,-0.38095235824585,0,0,0,0,0,0,0,0,0,0,0,0
Norma Dumont,Danyelle Wolf,Norma Dumont,2022-09-10,1,0,-8,8,5,1,-10.16,10.16,0,0,-7.62001,7.62001,401,0,12,2,10,-10,4,-4,3,0,0,0,3,-3,0,0,329,0,329,-329
Bryan Barberena,Darian Weeks,Bryan Barberena,2021-12-04,1,0,4,-4,1.636364,1.666667,2.540009,-2.540009,0,0,0,0,21,198,29,8,21,-21,-3.03030014038086e-02,3.03030014038086e-02,0,0,2,0,0,0,2,-2,126,0,126,-126
Ian Garry,Darian Weeks,Ian Garry,2022-04-09,1,0,-4,4,13,1.666667,10.16,-10.16,0,0,5.080002,-5.080002,39,172,13,8,5,-5,11.3333333730698,-11.3333333730698,1,0,0,0,1,-1,0,0,154,126,28,-28
Yohan Lainesse,Darian Weeks,Yohan Lainesse,2022-09-10,1,0,2,-2,4.5,1.666667,5.080002,-5.080002,0,0,10.15999,-10.15999,17,109,11,8,3,-3,2.83333337306976,-2.83333337306976,0,0,0,0,0,0,0,0,0,154,-154,154
Jeremy Kimball,Darko Stosic,Darko Stosic,2018-07-22,0,1,1,-1,1.875,3.25,0,0,0,0,-10.15999,10.15999,0,12,23,17,6,-6,-1.375,1.375,0,0,1,0,0,0,1,-1,232,0,232,-232
Devin Clark,Darko Stosic,Devin Clark,2019-06-01,1,0,2,-2,1.75,3.25,0,0,0,0,-2.539993,2.539993,172,310,22,17,5,-5,-1.5,1.5,0,1,2,0,-1,1,2,-2,175,314,-139,139
Kennedy Nzechukwu,Darko Stosic,Kennedy Nzechukwu,2019-08-03,1,0,0,0,3,3.25,12.7,-12.7,0,0,17.78001,-17.78001,0,129,16,17,-1,1,-0.25,0.25,0,0,0,0,0,0,0,0,0,63,-63,63
Jamahal Hill,Darko Stosic,Jamahal Hill,2020-01-25,1,0,1,-1,12,3.25,10.15999,-10.15999,0,0,7.62001,-7.62001,2,139,13,17,-4,4,8.75,-8.75,0,0,0,0,0,0,0,0,0,175,-175,175
Scott Holtzman,Darrell Horcher,Scott Holtzman,2017-12-09,1,0,4,-4,2.333333,3.25,-2.540009,2.540009,0,0,-2.540009,2.540009,589,100,20,17,3,-3,-0.916666746139526,0.916666746139526,2,0,0,0,2,-2,0,0,231,0,231,-231
John Dodson,Darrell Montague,John Dodson,2013-10-19,1,0,4,-4,1.833333,2.6,-7.619995,7.619995,10,-10,-2.539993,2.539993,21,0,34,18,16,-16,-0.766666531562805,0.766666531562805,0,0,0,0,0,0,0,0,266,0,266,-266
Kyoji Horiguchi,Darrell Montague,Kyoji Horiguchi,2014-05-10,1,0,-3,3,9.5,2.6,-2.539993,2.539993,0,0,-2.539993,2.539993,166,56,21,18,3,-3,6.90000009536743,-6.90000009536743,1,0,0,1,1,-1,-1,1,203,203,0,0
Willie Gates,Darrell Montague,Willie Gates,2015-07-12,1,0,1,-1,1.714286,2.6,5.080002,-5.080002,0,0,12.70001,-12.70001,13,0,19,18,1,-1,-0.885714173316956,0.885714173316956,0,0,0,1,0,0,-1,1,211,428,-217,217
Diego Brandao,Darren Elkins,Darren Elkins,2012-05-26,0,1,-4,4,2,2.454545,-7.62001,7.62001,0,0,-17.78,17.78,250,392,33,38,-5,5,-0.454545497894287,0.454545497894287,0,0,0,0,0,0,0,0,0,0,0,0
Antonio Carvalho,Darren Elkins,Darren Elkins,2013-03-16,0,1,5,-5,2.5,2.454545,-2.540009,2.540009,0,0,-2.539993,2.539993,6,21,21,38,-17,17,4.54545021057129e-02,-4.54545021057129e-02,2,1,0,0,1,-1,0,0,119,294,-175,175
Hacran Dias,Darren Elkins,Hacran Dias,2014-12-20,1,0,0,0,3.833333,2.454545,-5.080002,5.080002,10,-10,-5.080002,5.080002,473,163,29,38,-9,9,1.37878775596619,-1.37878775596619,0,2,0,0,-2,2,0,0,175,644,-469,469
Mirsad Bektic,Darren Elkins,Darren Elkins,2017-03-04,0,1,-6,6,3.25,2.454545,-5.080002,5.080002,0,0,-2.539993,2.539993,544,82,17,38,-21,21,0.795454502105713,-0.795454502105713,4,0,0,0,4,-4,0,0,147,805,-658,658
Dennis Bermudez,Darren Elkins,Darren Elkins,2017-07-22,0,1,-3,3,1.888889,2.454545,-10.16,10.16,10,-10,-12.7,12.7,156,246,26,38,-12,12,-0.565656661987305,0.565656661987305,0,1,2,0,-1,1,2,-2,168,140,28,-28
Tristan Connelly,Darren Elkins,Darren Elkins,2022-04-30,0,1,-1,1,1.75,2.454545,0,0,0,0,-7.619995,7.619995,58,472,22,38,-16,16,-0.704545497894287,0.704545497894287,0,2,0,0,-2,2,0,0,371,1743,-1372,1372
Francimar Barroso,Darren Stewart,Francimar Barroso,2017-03-18,1,0,11,-11,2.714286,1.5,2.539993,-2.539993,0,0,2.539993,-2.539993,159,238,26,20,6,-6,1.21428561210632,-1.21428561210632,0,0,0,0,0,0,0,0,314,0,314,-314
Karl Roberson,Darren Stewart,Karl Roberson,2017-11-11,1,0,1,-1,1.5,1.5,2.539993,-2.539993,0,0,0,0,74,34,15,20,-5,5,0,0,0,0,0,0,0,0,0,0,0,238,-238,238
Julian Marquez,Darren Stewart,Julian Marquez,2017-12-16,1,0,1,-1,2.25,1.5,5.080002,-5.080002,-20,20,-5.080002,5.080002,52,205,13,20,-7,7,0.75,-0.75,0,0,0,0,0,0,0,0,0,35,-35,35
Eric Spicely,Darren Stewart,Darren Stewart,2018-05-27,0,1,4,-4,2,1.5,2.539993,-2.539993,-20,20,-2.540009,2.540009,63,15,18,20,-2,2,0.5,-0.5,0,0,0,0,0,0,0,0,0,162,-162,162
Charles Byrd,Darren Stewart,Darren Stewart,2018-09-08,0,1,7,-7,1.428571,1.5,-5.080002,5.080002,-20,20,-2.540009,2.540009,101,62,17,20,-3,3,-7.14285373687744e-02,7.14285373687744e-02,1,1,0,0,0,0,0,0,175,104,71,-71
Edmen Shahbazyan,Darren Stewart,Edmen Shahbazyan,2018-11-30,1,0,-6,6,3,1.5,5.080002,-5.080002,-20,20,2.539993,-2.539993,597,41,16,20,-4,4,1.5,-1.5,0,2,0,0,-2,2,0,0,0,83,-83,83
Bevon Lewis,Darren Stewart,Darren Stewart,2019-06-08,0,1,0,0,2.333333,1.5,7.619995,-7.619995,-20,20,12.7,-12.7,222,101,10,20,-10,10,0.833333253860474,-0.833333253860474,0,0,0,0,0,0,0,0,0,190,-190,190
Maki Pitolo,Darren Stewart,Darren Stewart,2020-08-08,0,1,0,0,1.444444,1.5,-5.080002,5.080002,-20,20,2.539993,-2.539993,17,19,22,20,2,-2,-5.55555820465088e-02,5.55555820465088e-02,0,1,0,0,-1,1,0,0,308,427,-119,119
Kevin Holland,Darren Stewart,Kevin Holland,2020-09-19,1,0,-2,2,2.5,1.5,7.619995,-7.619995,-35,35,17.78,-17.78,215,249,35,20,15,-15,1,-1,2,2,0,0,0,0,0,0,539,42,497,-497
Eryk Anders,Darren Stewart,Eryk Anders,2021-06-12,1,0,4,-4,1.875,1.5,2.539993,-2.539993,-20,20,2.539993,-2.539993,499,135,23,20,3,-3,0.375,-0.375,0,0,1,0,0,0,1,-1,392,266,126,-126
Dustin Jacoby,Darren Stewart,Dustin Jacoby,2021-08-28,1,0,3,-3,2.714286,1.5,7.619995,-7.619995,0,0,5.079987,-5.079987,23,43,26,20,6,-6,1.21428561210632,-1.21428561210632,1,0,0,0,1,-1,0,0,301,77,224,-224
Wendell Oliveira Marques,Darren Till,Darren Till,2015-05-30,0,1,9,-9,2.9,3.6,-5.080002,5.080002,-15,15,-7.960007,7.960007,119,66,39,23,16,-16,-0.699999809265137,0.699999809265137,0,0,1,0,0,0,1,-1,259,0,259,-259
Jessin Ayari,Darren Till,Darren Till,2017-05-28,0,1,0,0,2.666667,3.6,0,0,-30,30,-2.540009,2.540009,46,176,22,23,-1,1,-0.933333158493042,0.933333158493042,1,1,0,0,0,0,0,0,267,729,-462,462
Donald Cerrone,Darren Till,Darren Till,2017-10-21,0,1,10,-10,2.117647,3.6,2.539993,-2.539993,-30,30,-2.540009,2.540009,29,4,53,23,30,-30,-1.48235273361206,1.48235273361206,0,2,3,0,-2,2,3,-3,84,146,-62,62
Stephen Thompson,Darren Till,Darren Till,2018-05-27,0,1,10,-10,2.833333,3.6,0,0,-15,15,2.539993,-2.539993,0,14,23,23,0,0,-0.766666650772095,0.766666650772095,0,3,0,0,-3,3,0,0,449,218,231,-231
Jorge Masvidal,Darren Till,Jorge Masvidal,2019-03-16,1,0,8,-8,2.058824,3.6,-2.540009,2.540009,-15,15,0,0,47,55,52,23,29,-29,-1.54117631912231,1.54117631912231,0,4,0,0,-4,4,0,0,497,293,204,-204
Kelvin Gastelum,Darren Till,Darren Till,2019-11-02,0,1,2,-2,2.25,3.6,-7.62001,7.62001,-15,15,-7.62001,7.62001,163,38,26,23,3,-3,-1.34999990463257,1.34999990463257,1,0,0,1,1,-1,-1,1,539,231,308,-308
Derek Brunson,Darren Till,Derek Brunson,2021-09-04,1,0,9,-9,2.555556,3.6,2.539993,-2.539993,0,0,7.619995,-7.619995,443,4,32,23,9,-9,-1.04444432258606,1.04444432258606,4,1,3,1,3,-3,2,-2,168,672,-504,504
Dricus Du Plessis,Darren Till,Dricus Du Plessis,2022-12-10,1,0,-1,1,10,3.6,2.539993,-2.539993,0,0,5.079987,-5.079987,333,23,22,23,-1,1,6.40000009536743,-6.40000009536743,3,0,0,1,3,-3,-1,1,161,462,-301,301
Phil Harris,Darren Uyenoyama,Darren Uyenoyama,2012-10-05,0,1,-3,3,1.833333,1.666667,-5.080002,5.080002,0,0,0,0,154,120,34,16,18,-18,0.166666746139526,-0.166666746139526,0,0,0,0,0,0,0,0,0,0,0,0
Joseph Benavidez,Darren Uyenoyama,Joseph Benavidez,2013-04-20,1,0,-5,5,3.5,1.666667,-5.080002,5.080002,0,0,0,0,111,26,36,16,20,-20,1.83333337306976,-1.83333337306976,1,1,0,0,0,0,0,0,77,197,-120,120
Alptekin Ozkilic,Darren Uyenoyama,Alptekin Ozkilic,2013-12-14,1,0,-7,7,1.8,1.666667,-2.539993,2.539993,0,0,0,0,382,72,14,16,-2,2,0.133333325386047,-0.133333325386047,0,0,0,1,0,0,-1,1,0,238,-238,238
Grant Dawson,Darrick Minner,Grant Dawson,2020-02-29,1,0,-3,3,20,1.857143,7.62001,-7.62001,10,-10,7.62001,-7.62001,315,26,21,40,-19,19,18.1428571939468,-18.1428571939468,2,0,0,0,2,-2,0,0,287,0,287,-287
TJ Laramie,Darrick Minner,Darrick Minner,2020-09-19,0,1,-8,8,2.4,1.857143,-2.539993,2.539993,0,0,-7.619995,7.619995,23,7,17,40,-23,23,0.54285728931427,-0.54285728931427,0,0,0,0,0,0,0,0,0,203,-203,203
Darren Elkins,Darrick Minner,Darren Elkins,2021-07-24,1,0,6,-6,2.454545,1.857143,7.62001,-7.62001,0,0,5.080002,-5.080002,181,281,38,40,-2,2,0.597402691841125,-0.597402691841125,1,1,2,0,0,0,2,-2,259,308,-49,49
Ryan Hall,Darrick Minner,Ryan Hall,2021-12-11,1,0,5,-5,4.5,1.857143,7.62001,-7.62001,0,0,2.540009,-2.540009,337,298,11,40,-29,29,2.64285719394684,-2.64285719394684,0,0,1,1,0,0,0,0,154,140,14,-14
James McSweeney,Darrill Schoonover,James McSweeney,2009-12-05,1,0,5,-5,1,1.75,5.079987,-5.079987,10,-10,4.580002,-4.580002,438,126,30,22,8,-8,-0.75,0.75,0,0,0,0,0,0,0,0,0,0,0,0
Carlos Barreto,Dave Beneteau,Dave Beneteau,1997-10-17,0,1,,,1.555556,1.2,5.079987,-5.079987,-20,20,-12.5,12.5,0,0,23,11,12,-12,0.355555534362793,-0.355555534362793,0,0,0,0,0,0,0,0,0,0,0,0
Gabriel Gonzaga,Dave Herman,Gabriel Gonzaga,2013-07-06,1,0,6,-6,1.545455,3.666667,-5.079987,5.079987,0,0,-2.540009,2.540009,3,0,28,28,0,0,-2.12121224403381,2.12121224403381,2,0,1,0,2,-2,1,-1,168,0,168,-168
Fabiano Iha,Dave Menne,Dave Menne,2000-03-10,0,1,4,-4,1.8,2.647059,-5.080002,5.080002,-15,15,-7,7,38,583,14,62,-48,48,-0.847058773040771,0.847058773040771,0,0,0,0,0,0,0,0,0,0,0,0
Gil Castillo,Dave Menne,Dave Menne,2001-09-28,0,1,8,-8,1.6,2.647059,-2.540009,2.540009,0,0,0,0,696,475,13,62,-49,49,-1.0470587015152,1.0470587015152,0,1,0,0,-1,1,0,0,0,567,-567,567
Murilo Bustamante,Dave Menne,Murilo Bustamante,2002-01-11,1,0,8,-8,1.875,2.647059,10.16,-10.16,13,-13,11,-11,187,0,23,62,-39,39,-0.772058725357056,0.772058725357056,0,2,0,0,-2,2,0,0,105,105,0,0
Phil Baroni,Dave Menne,Phil Baroni,2002-09-27,1,0,-2,2,0.8333333,2.647059,-2.540009,2.540009,0,0,2.880005,-2.880005,0,0,33,62,-29,29,-1.81372541189194,1.81372541189194,1,0,0,1,1,-1,-1,1,140,259,-119,119
Josh Koscheck,Dave Menne,Josh Koscheck,2006-06-28,1,0,-3,3,1.545455,2.647059,0,0,0,0,5.419998,-5.419998,678,30,28,62,-34,34,-1.10160422325134,1.10160422325134,2,0,0,2,2,-2,-2,2,326,1370,-1044,1044
Luigi Fioravanti,Dave Menne,Luigi Fioravanti,2006-12-13,1,0,-7,7,1.733333,2.647059,-5.080002,5.080002,0,0,-2.199997,2.199997,33,0,41,62,-21,21,-0.91372537612915,0.91372537612915,1,0,0,2,1,-1,-2,2,172,168,4,-4
Romie Aram,Dave Strasser,Dave Strasser,2003-04-25,0,1,-8,8,7,3.125,0,0,0,0,-5,5,294,284,8,33,-25,25,3.875,-3.875,0,0,0,0,0,0,0,0,0,0,0,0
Karo Parisyan,Dave Strasser,Karo Parisyan,2003-09-26,1,0,-13,13,2.181818,3.125,0,0,0,0,2.880005,-2.880005,163,14,35,33,2,-2,-0.943181753158569,0.943181753158569,0,1,0,0,-1,1,0,0,0,154,-154,154
Manny Bermudez,Davey Grant,Manny Bermudez,2018-07-22,1,0,-8,8,7,2.142857,5.080002,-5.080002,10,-10,5.080002,-5.080002,21,17,16,22,-6,6,4.85714292526245,-4.85714292526245,1,0,0,0,1,-1,0,0,148,0,148,-148
Martin Day,Davey Grant,Davey Grant,2020-07-11,0,1,-3,3,1.333333,2.142857,5.080002,-5.080002,10,-10,10.16,-10.16,88,128,14,22,-8,8,-0.809523701667786,0.809523701667786,0,0,0,0,0,0,0,0,595,720,-125,125
Raphael Assuncao,Davey Grant,Davey Grant,2023-03-11,0,1,3,-3,2.8,2.142857,-7.619995,7.619995,0,0,-7.619995,7.619995,257,52,38,22,16,-16,0.657142877578735,-0.657142877578735,1,1,3,0,0,0,3,-3,147,973,-826,826
Sergio Moraes,Davi Ramos,Sergio Moraes,2017-03-11,1,0,4,-4,2.333333,2.5,15.24001,-15.24001,15,-15,5.080002,-5.080002,0,0,20,14,6,-6,-0.166666746139526,0.166666746139526,1,0,0,0,1,-1,0,0,112,0,112,-112
Chris Gruetzemacher,Davi Ramos,Davi Ramos,2017-12-09,0,1,0,0,3,2.5,5.080002,-5.080002,0,0,-5.080002,5.080002,15,233,20,14,6,-6,0.5,-0.5,0,0,0,0,0,0,0,0,308,273,35,-35
Nick Hein,Davi Ramos,Davi Ramos,2018-05-12,0,1,3,-3,2.8,2.5,0,0,0,0,-10.16,10.16,7,130,19,14,5,-5,0.299999952316284,-0.299999952316284,3,1,0,0,2,-2,0,0,616,154,462,-462
John Gunther,Davi Ramos,Davi Ramos,2018-11-10,0,1,0,0,5,2.5,7.619995,-7.619995,0,0,5.080002,-5.080002,0,105,6,14,-8,8,2.5,-2.5,1,2,0,0,-1,1,0,0,127,182,-55,55
Austin Hubbard,Davi Ramos,Davi Ramos,2019-05-18,0,1,-5,5,2.285714,2.5,10.16,-10.16,0,0,2.539993,-2.539993,50,246,23,14,9,-9,-0.214285612106323,0.214285612106323,0,3,0,0,-3,3,0,0,0,189,-189,189
Islam Makhachev,Davi Ramos,Islam Makhachev,2019-09-07,1,0,-5,5,24,2.5,10.16,-10.16,0,0,0,0,279,25,25,14,11,-11,21.5,-21.5,3,4,1,0,-1,1,1,-1,140,112,28,-28
Rich Attonito,David Branch,David Branch,2010-12-04,0,1,4,-4,2,3.666667,-7.619995,7.619995,-15,15,-15.23999,15.23999,28,739,15,28,-13,13,-1.66666674613953,1.66666674613953,2,0,0,0,2,-2,0,0,80,0,80,-80
Tim Boetsch,David Heath,Tim Boetsch,2008-02-02,1,0,-4,4,1.615385,2.571429,2.540009,-2.540009,-20,20,5.080002,-5.080002,6,0,34,25,9,-9,-0.95604395866394,0.95604395866394,0,0,0,0,0,0,0,0,0,0,0,0
Scott Bessac,David Hood,Scott Bessac,1995-09-08,1,0,,,0.6666667,0.3333333,10.15999,-10.15999,45,-45,9,-9,0,0,10,4,6,-6,0.333333343267441,-0.333333343267441,0,0,0,0,0,0,0,0,0,0,0,0
Junie Browning,David Kaplan,Junie Browning,2008-12-13,1,0,-5,5,0.8333333,0.75,5.080002,-5.080002,0,0,5,-5,186,60,11,7,4,-4,8.33333134651184e-02,-8.33333134651184e-02,0,0,0,0,0,0,0,0,0,0,0,0
Tyson Griffin,David Lee,Tyson Griffin,2006-09-23,1,0,,,2,1.2,-10.16,10.16,-10,10,-7.279999,7.279999,95,0,24,22,2,-2,0.799999952316284,-0.799999952316284,0,0,0,0,0,0,0,0,0,0,0,0
Junior Assuncao,David Lee,Junior Assuncao,2007-04-21,1,0,,,2.666667,1.2,-2.540009,2.540009,-10,10,2.880005,-2.880005,308,23,22,22,0,0,1.46666669845581,-1.46666669845581,0,0,0,0,0,0,0,0,189,210,-21,21
Rich Franklin,David Loiseau,Rich Franklin,2006-03-04,1,0,5,-5,4.142857,2.090909,2.539993,-2.539993,0,0,0,0,517,15,36,34,2,-2,2.05194807052612,-2.05194807052612,5,0,0,0,5,-5,0,0,105,0,105,-105
Ed Herman,David Loiseau,Ed Herman,2009-04-18,1,0,-1,1,1.6875,2.090909,2.539993,-2.539993,20,-20,2.540009,-2.540009,715,34,43,34,9,-9,-0.403409004211426,0.403409004211426,0,0,0,0,0,0,0,0,364,1141,-777,777
Li Jingliang,David Michaud,Li Jingliang,2014-05-24,1,0,1,-1,2.375,3.666667,7.62001,-7.62001,15,-15,2.339996,-2.339996,215,211,27,14,13,-13,-1.29166674613953,1.29166674613953,0,0,0,0,0,0,0,0,0,0,0,0
Olivier Aubin-Mercier,David Michaud,Olivier Aubin-Mercier,2015-04-25,1,0,0,0,2.2,3.666667,0,0,0,0,-0.1999969,0.1999969,375,0,16,14,2,-2,-1.46666669845581,1.46666669845581,1,0,0,0,1,-1,0,0,203,336,-133,133
Yan Cabral,David Mitchell,Yan Cabral,2013-10-09,1,0,-3,3,4.333333,3.142857,-2.540009,2.540009,-15,15,-5.080002,5.080002,729,67,16,29,-13,13,1.1904764175415,-1.1904764175415,0,0,0,0,0,0,0,0,0,0,0,0
Mason Jones,David Onama,Mason Jones,2021-10-23,1,0,-1,1,5.5,5.5,-2.539993,2.539993,10,-10,0,0,541,11,13,13,0,0,0,0,0,0,0,0,0,0,0,0,0,0,0,0
Gabriel Benitez,David Onama,David Onama,2022-02-19,0,1,6,-6,2.090909,5.5,-7.619995,7.619995,10,-10,-7.62001,7.62001,0,10,34,13,21,-21,-3.40909099578857,3.40909099578857,0,0,3,0,0,0,3,-3,217,119,98,-98
Garrett Armfield,David Onama,David Onama,2022-07-09,0,1,-3,3,3,5.5,-12.7,12.7,-10,10,-10.16,10.16,112,155,12,13,-1,1,-2.5,2.5,0,1,0,0,-1,1,0,0,0,140,-140,140
Nate Landwehr,David Onama,Nate Landwehr,2022-08-13,1,0,6,-6,3.4,5.5,-5.080002,5.080002,0,0,-5.080002,5.080002,305,73,22,13,9,-9,-2.09999990463257,2.09999990463257,0,2,0,0,-2,2,0,0,0,35,-35,35
Marcelo Mello,David Roberts,Marcelo Mello,1999-05-07,1,0,,,1,0.625,-15.24001,15.24001,0,0,-10,10,0,0,1,13,-12,12,0.375,-0.375,0,0,0,0,0,0,0,0,0,0,0,0
Matt Lindland,David Terrell,David Terrell,2004-08-21,0,1,8,-8,2.444444,3,-2.539993,2.539993,0,0,-3.999329e-02,3.999329e-02,0,8,31,8,23,-23,-0.555555582046509,0.555555582046509,1,0,1,0,1,-1,1,-1,274,0,274,-274
Evan Tanner,David Terrell,Evan Tanner,2005-02-05,1,0,6,-6,4,3,-2.539993,2.539993,0,0,-3.999329e-02,3.999329e-02,189,21,40,8,32,-32,1,-1,0,1,0,0,-1,1,0,0,0,168,-168,168
Scott Smith,David Terrell,David Terrell,2006-04-15,0,1,-2,2,1.636364,3,-2.539993,2.539993,0,0,-10.2,10.2,83,75,29,8,21,-21,-1.36363637447357,1.36363637447357,0,0,0,1,0,0,-1,1,0,434,-434,434
Martin Svensson,David Teymur,David Teymur,2016-02-27,0,1,4,-4,2.5,4,10.16,-10.16,0,0,2.580002,-2.580002,19,29,21,10,11,-11,-1.5,1.5,0,0,0,0,0,0,0,0,0,0,0,0
Jason Novelli,David Teymur,David Teymur,2016-08-06,0,1,10,-10,3.666667,4,7.62001,-7.62001,0,0,0.5800018,-0.5800018,23,2,14,10,4,-4,-0.333333253860474,0.333333253860474,0,1,0,0,-1,1,0,0,0,161,-161,161
Drakkar Klose,David Teymur,David Teymur,2017-12-02,0,1,1,-1,6.5,4,0,0,0,0,-7.619995,7.619995,16,49,15,10,5,-5,2.5,-2.5,1,2,0,0,-1,1,0,0,321,483,-162,162
Nik Lentz,David Teymur,David Teymur,2018-06-01,0,1,4,-4,2.5,4,-2.539993,2.539993,-10,10,-12.7,12.7,44,6,42,10,32,-32,-1.5,1.5,0,3,0,0,-3,3,0,0,475,181,294,-294
Charles Oliveira,David Teymur,Charles Oliveira,2019-02-02,1,0,0,0,3.777778,4,2.540009,-2.540009,0,0,2.540009,-2.540009,13,35,43,10,33,-33,-0.222222328186035,0.222222328186035,0,4,1,0,-4,4,1,-1,889,246,643,-643
Jens Pulver,David Velasquez,Jens Pulver,2000-03-10,1,0,,,1.421053,1,5.079987,-5.079987,0,0,9.800003,-9.800003,313,0,46,20,26,-26,0.421052575111389,-0.421052575111389,0,0,0,0,0,0,0,0,0,0,0,0
Danny Roberts,David Zawada,Danny Roberts,2018-07-22,1,0,4,-4,2.25,2.428571,2.539993,-2.539993,0,0,-2.539993,2.539993,526,162,26,24,2,-2,-0.178571462631226,0.178571462631226,0,0,1,0,0,0,1,-1,218,0,218,-218
Li Jingliang,David Zawada,Li Jingliang,2018-11-24,1,0,2,-2,2.375,2.428571,0,0,0,0,-10.16,10.16,76,49,27,24,3,-3,-5.35714626312256e-02,5.35714626312256e-02,0,0,0,0,0,0,0,0,287,125,162,-162
Abubakar Nurmagomedov,David Zawada,David Zawada,2019-11-09,0,1,0,0,4.25,2.428571,-2.540009,2.540009,0,0,-7.619995,7.619995,110,0,21,24,-3,3,1.82142853736877,-1.82142853736877,0,0,0,1,0,0,-1,1,0,350,-350,350
Ramazan Emeev,David Zawada,Ramazan Emeev,2021-01-16,1,0,3,-3,3.333333,2.428571,-5.080002,5.080002,0,0,2.539993,-2.539993,268,126,26,24,2,-2,0.904761791229248,-0.904761791229248,1,1,0,1,0,0,-1,1,175,434,-259,259
Alex Morono,David Zawada,Alex Morono,2021-09-04,1,0,0,0,2.875,2.428571,-2.540009,2.540009,0,0,-7.619995,7.619995,66,39,31,24,7,-7,0.446428537368774,-0.446428537368774,0,0,1,1,0,0,0,0,259,231,28,-28
Jeremy Horn,Dean Lister,Dean Lister,2008-06-21,0,1,0,0,4.136364,1.857143,0,0,0,0,-2.539993,2.539993,75,40,113,20,93,-93,2.27922070026398,-2.27922070026398,0,0,1,0,0,0,1,-1,140,0,140,-140
Marco Beltran,Deiveson Figueiredo,Deiveson Figueiredo,2017-06-03,0,1,2,-2,1.333333,7,7.619995,-7.619995,0,0,2.539993,-2.539993,114,288,14,24,-10,10,-5.66666662693024,5.66666662693024,0,0,0,0,0,0,0,0,210,0,210,-210
Jarred Brooks,Deiveson Figueiredo,Deiveson Figueiredo,2017-10-28,0,1,-5,5,6.5,7,-5.080002,5.080002,0,0,-15.24001,15.24001,449,66,15,24,-9,9,-0.5,0.5,1,1,0,0,0,0,0,0,91,147,-56,56
Tim Elliott,Deiveson Figueiredo,Deiveson Figueiredo,2019-10-12,0,1,1,-1,1.666667,7,5.079987,-5.079987,0,0,-5.080002,5.080002,4,0,32,24,8,-8,-5.33333337306976,5.33333337306976,0,2,0,0,-2,2,0,0,854,714,140,-140
Joseph Benavidez,Deiveson Figueiredo,Deiveson Figueiredo,2020-02-29,0,1,3,-3,3.5,7,-2.540009,2.540009,0,0,-7.619995,7.619995,10,27,36,24,12,-12,-3.5,3.5,3,3,1,0,0,0,1,-1,245,140,105,-105
Joseph Benavidez,Deiveson Figueiredo,Deiveson Figueiredo,2020-07-18,0,1,3,-3,3.5,7,-2.540009,2.540009,0,0,-7.619995,7.619995,0,143,36,24,12,-12,-3.5,3.5,0,4,2,0,-4,4,2,-2,140,140,0,0
Dominick Cruz,Demetrious Johnson,Dominick Cruz,2011-10-01,1,0,1,-1,6,9,12.7,-12.7,10,-10,5.080002,-5.080002,761,177,28,30,-2,2,-3,3,1,0,0,0,1,-1,0,0,91,0,91,-91
Joseph Benavidez,Demetrious Johnson,Demetrious Johnson,2012-09-22,0,1,2,-2,3.5,9,2.539993,-2.539993,0,0,-2.539993,2.539993,204,140,36,30,6,-6,-5.5,5.5,3,0,0,0,3,-3,0,0,204,357,-153,153
John Dodson,Demetrious Johnson,Demetrious Johnson,2013-01-26,0,1,2,-2,1.833333,9,0,0,10,-10,0,0,154,345,34,30,4,-4,-7.16666662693024,7.16666662693024,2,1,0,0,1,-1,0,0,113,126,-13,13
Joseph Benavidez,Demetrious Johnson,Demetrious Johnson,2013-12-14,0,1,2,-2,3.5,9,2.539993,-2.539993,0,0,-2.539993,2.539993,0,2,36,30,6,-6,-5.5,5.5,3,2,0,0,1,-1,0,0,101,322,-221,221
Ali Bagautinov,Demetrious Johnson,Demetrious Johnson,2014-06-14,0,1,2,-2,2.5,9,2.539993,-2.539993,0,0,-2.539993,2.539993,491,86,21,30,-9,9,-6.5,6.5,3,3,0,0,0,0,0,0,133,182,-49,49
Chris Cariaso,Demetrious Johnson,Demetrious Johnson,2014-09-27,0,1,5,-5,2.125,9,0,0,0,0,-5.080002,5.080002,3,284,25,30,-5,5,-6.875,6.875,3,4,0,0,-1,1,0,0,140,105,35,-35
Kyoji Horiguchi,Demetrious Johnson,Demetrious Johnson,2015-04-25,0,1,-4,4,9.5,9,5.080002,-5.080002,0,0,0,0,62,823,21,30,-9,9,0.5,-0.5,2,5,0,0,-3,3,0,0,350,210,140,-140
John Dodson,Demetrious Johnson,Demetrious Johnson,2015-09-05,0,1,1,-1,1.833333,9,0,0,10,-10,0,0,175,299,34,30,4,-4,-7.16666662693024,7.16666662693024,3,6,0,0,-3,3,0,0,105,133,-28,28
Henry Cejudo,Demetrious Johnson,Demetrious Johnson,2016-04-23,0,1,0,0,5.333333,9,2.539993,-2.539993,10,-10,-5.080002,5.080002,33,16,19,30,-11,11,-3.66666650772095,3.66666650772095,2,7,0,0,-5,5,0,0,154,231,-77,77
Tim Elliott,Demetrious Johnson,Demetrious Johnson,2016-12-03,0,1,-1,1,1.666667,9,10.15999,-10.15999,0,0,0,0,218,998,32,30,2,-2,-7.33333337306976,7.33333337306976,0,8,0,0,-8,8,0,0,658,224,434,-434
Ray Borg,Demetrious Johnson,Demetrious Johnson,2017-10-07,0,1,-7,7,2.6,9,2.539993,-2.539993,10,-10,-7.619995,7.619995,128,1069,18,30,-12,12,-6.40000009536743,6.40000009536743,2,9,0,0,-7,7,0,0,210,308,-98,98
Henry Cejudo,Demetrious Johnson,Henry Cejudo,2018-08-04,1,0,0,0,5.333333,9,2.539993,-2.539993,10,-10,-5.080002,5.080002,278,36,19,30,-11,11,-3.66666650772095,3.66666650772095,2,10,1,0,-8,8,1,-1,245,301,-56,56
Ryan Jensen,Demian Maia,Demian Maia,2007-10-20,0,1,1,-1,2.625,2.545455,0,0,15,-15,10.15999,-10.15999,0,146,29,39,-10,10,7.95454978942871e-02,-7.95454978942871e-02,0,0,0,0,0,0,0,0,56,0,56,-56
Ed Herman,Demian Maia,Demian Maia,2008-04-19,0,1,-3,3,1.6875,2.545455,0,0,35,-35,12.7,-12.7,228,184,43,39,4,-4,-0.857954502105713,0.857954502105713,2,1,0,0,1,-1,0,0,308,182,126,-126
Jason MacDonald,Demian Maia,Demian Maia,2008-08-09,0,1,3,-3,1.5625,2.545455,5.080002,-5.080002,15,-15,20.31999,-20.31999,316,379,41,39,2,-2,-0.982954502105713,0.982954502105713,0,2,0,0,-2,2,0,0,294,112,182,-182
Kendall Grove,Demian Maia,Demian Maia,2010-12-04,0,1,-5,5,1.352941,2.545455,12.7,-12.7,15,-15,17.78,-17.78,0,496,40,39,1,-1,-1.19251334667206,1.19251334667206,1,3,2,0,-2,2,2,-2,154,847,-693,693
Dong Hyun Kim,Demian Maia,Demian Maia,2012-07-07,0,1,-4,4,5.5,2.545455,2.540009,-2.540009,0,0,10.15999,-10.15999,0,41,26,39,-13,13,2.95454549789429,-2.95454549789429,3,4,0,0,-1,1,0,0,190,581,-391,391
Jon Fitch,Demian Maia,Demian Maia,2013-02-02,0,1,-1,1,4.285714,2.545455,-2.539993,2.539993,0,0,5.080002,-5.080002,33,771,37,39,-2,2,1.74025964736938,-1.74025964736938,1,5,1,0,-4,4,1,-1,112,210,-98,98
Rory MacDonald,Demian Maia,Rory MacDonald,2014-02-22,1,0,-12,12,4.75,2.545455,-2.539993,2.539993,0,0,10.15999,-10.15999,7,301,23,39,-16,16,2.20454549789429,-2.20454549789429,3,6,0,0,-3,3,0,0,441,385,56,-56
Ryan LaFlare,Demian Maia,Demian Maia,2015-03-21,0,1,-6,6,4.666667,2.545455,0,0,0,0,5.080002,-5.080002,96,828,17,39,-22,22,2.12121200561523,-2.12121200561523,2,0,0,0,2,-2,0,0,462,392,70,-70
Neil Magny,Demian Maia,Demian Maia,2015-08-01,0,1,-10,10,2.333333,2.545455,5.080002,-5.080002,0,0,20.31999,-20.31999,2,447,40,39,1,-1,-0.212121248245239,0.212121248245239,2,1,0,0,1,-1,0,0,448,133,315,-315
Matt Brown,Demian Maia,Demian Maia,2016-05-14,0,1,-3,3,1.368421,2.545455,-2.539993,2.539993,0,0,7.619995,-7.619995,59,723,45,39,6,-6,-1.17703342437744,1.17703342437744,1,2,0,0,-1,1,0,0,308,287,21,-21
Carlos Condit,Demian Maia,Demian Maia,2016-08-27,0,1,-6,6,2.285714,2.545455,2.540009,-2.540009,0,0,7.619995,-7.619995,0,79,46,39,7,-7,-0.259740114212036,0.259740114212036,0,3,1,0,-3,3,1,-1,238,105,133,-133
Colby Covington,Demian Maia,Colby Covington,2017-10-28,1,0,-10,10,5.666667,2.545455,-5.080002,5.080002,0,0,0,0,104,2,20,39,-19,19,3.12121200561523,-3.12121200561523,6,4,0,0,2,-2,0,0,133,427,-294,294
Lyman Good,Demian Maia,Demian Maia,2019-02-02,0,1,-8,8,3.5,2.545455,-2.539993,2.539993,0,0,5.080002,-5.080002,0,131,27,39,-12,12,0.954545497894287,-0.954545497894287,1,0,0,0,1,-1,0,0,91,462,-371,371
Ben Askren,Demian Maia,Demian Maia,2019-10-26,0,1,-6,6,9.5,2.545455,-5.080002,5.080002,0,0,2.539993,-2.539993,114,90,21,39,-18,18,6.95454549789429,-6.95454549789429,0,1,1,0,-1,1,1,-1,112,266,-154,154
Gilbert Burns,Demian Maia,Gilbert Burns,2020-03-14,1,0,-9,9,3.666667,2.545455,-7.619995,7.619995,0,0,-2.540009,2.540009,4,83,28,39,-11,11,1.12121224403381,-1.12121224403381,3,2,1,0,1,-1,1,-1,168,140,28,-28
Alan Belcher,Denis Kang,Alan Belcher,2009-01-17,1,0,-7,7,2.25,2.1875,7.62001,-7.62001,0,0,-5.080002,5.080002,20,343,26,51,-25,25,0.0625,-0.0625,1,0,1,0,1,-1,1,-1,122,0,122,-122
Xavier Foupa-Pokam,Denis Kang,Denis Kang,2009-04-18,0,1,-5,5,1.454545,2.1875,5.080002,-5.080002,0,0,-7.580002,7.580002,6,480,54,51,3,-3,-0.732954502105713,0.732954502105713,0,0,0,0,0,0,0,0,0,91,-91,91
Michael Bisping,Denis Kang,Michael Bisping,2009-11-14,1,0,-2,2,3.333333,2.1875,5.080002,-5.080002,0,0,-5.080002,5.080002,85,224,39,51,-12,12,1.14583325386047,-1.14583325386047,0,1,1,0,-1,1,1,-1,126,210,-84,84
Aliaskhab Khizriev,Denis Tiuliulin,Aliaskhab Khizriev,2022-03-26,1,0,-2,2,14,1.25,-10.16,10.16,0,0,-7.619995,7.619995,166,2,14,18,-4,4,12.75,-12.75,0,0,0,0,0,0,0,0,0,0,0,0
Jamie Pickett,Denis Tiuliulin,Denis Tiuliulin,2022-09-10,0,1,0,0,1.3,1.25,2.540009,-2.540009,0,0,7.619995,-7.619995,35,59,23,18,5,-5,4.99999523162842e-02,-4.99999523162842e-02,1,0,1,0,1,-1,1,-1,322,168,154,-154
JunYong Park,Denis Tiuliulin,JunYong Park,2023-02-04,1,0,-3,3,3.4,1.25,-7.619995,7.619995,0,0,-10.16,10.16,178,0,22,18,4,-4,2.15000009536743,-2.15000009536743,0,1,1,0,-1,1,1,-1,469,147,322,-322
Gregory Rodrigues,Denis Tiuliulin,Gregory Rodrigues,2023-08-19,1,0,-4,4,2.8,1.25,5.080002,-5.080002,0,0,-5.080002,5.080002,47,0,19,18,1,-1,1.54999995231628,-1.54999995231628,1,0,0,0,1,-1,0,0,805,196,609,-609
Bruna Brasil,Denise Gomes,Denise Gomes,2023-04-15,0,1,6,-6,3,4,10.16,-10.16,0,0,5.080002,-5.080002,79,233,12,10,2,-2,-1,1,0,0,0,0,0,0,0,0,0,0,0,0
Brian Ebersole,Dennis Hallman,Brian Ebersole,2011-08-06,1,0,-5,5,2.833333,2.65,7.62001,-7.62001,15,-15,2.539993,-2.539993,127,136,69,73,-4,4,0.183333158493042,-0.183333158493042,1,0,0,0,1,-1,0,0,161,0,161,-161
Jess Liaudin,Dennis Siver,Jess Liaudin,2007-04-21,1,0,,,1.818182,2.090909,7.619995,-7.619995,25,-25,5.080002,-5.080002,43,0,31,34,-3,3,-0.272727131843567,0.272727131843567,0,0,0,0,0,0,0,0,0,0,0,0
Naoyuki Kotani,Dennis Siver,Dennis Siver,2007-09-08,0,1,-3,3,2.428571,2.090909,5.080002,-5.080002,10,-10,-10.16,10.16,5,229,48,34,14,-14,0.3376624584198,-0.3376624584198,0,0,0,0,0,0,0,0,156,140,16,-16
Gray Maynard,Dennis Siver,Gray Maynard,2008-01-23,1,0,-1,1,1.857143,2.090909,7.619995,-7.619995,10,-10,0,0,648,155,20,34,-14,14,-0.233766198158264,0.233766198158264,1,1,0,0,0,0,0,0,126,137,-11,11
Melvin Guillard,Dennis Siver,Melvin Guillard,2008-07-05,1,0,-4,4,1.777778,2.090909,7.619995,-7.619995,10,-10,2.539993,-2.539993,20,0,50,34,16,-16,-0.313131213188171,0.313131213188171,0,0,0,0,0,0,0,0,457,164,293,-293
Nate Mohr,Dennis Siver,Dennis Siver,2009-01-17,0,1,-5,5,1.285714,2.090909,7.619995,-7.619995,10,-10,5.080002,-5.080002,109,7,16,34,-18,18,-0.805194735527039,0.805194735527039,0,0,0,1,0,0,-1,1,653,196,457,-457
Dale Hartt,Dennis Siver,Dennis Siver,2009-06-13,0,1,0,0,2,2.090909,10.16,-10.16,10,-10,-2.540009,2.540009,29,71,9,34,-25,25,-9.09090042114258e-02,9.09090042114258e-02,1,1,0,1,0,0,-1,1,185,147,38,-38
Paul Kelly,Dennis Siver,Dennis Siver,2009-11-14,0,1,-5,5,2.8,2.090909,7.619995,-7.619995,10,-10,0,0,57,26,19,34,-15,15,0.709090948104858,-0.709090948104858,2,2,0,1,0,0,-1,1,266,154,112,-112
Ross Pearson,Dennis Siver,Ross Pearson,2010-03-31,1,0,-6,6,1.25,2.090909,5.080002,-5.080002,10,-10,-2.540009,2.540009,60,70,36,34,2,-2,-0.840909004211426,0.840909004211426,2,3,0,1,-1,1,-1,1,137,137,0,0
Spencer Fisher,Dennis Siver,Dennis Siver,2010-06-19,0,1,3,-3,2.666667,2.090909,2.539993,-2.539993,10,-10,-5.080002,5.080002,0,1,33,34,-1,1,0.575757741928101,-0.575757741928101,0,0,2,1,0,0,1,-1,238,80,158,-158
Donald Cerrone,Dennis Siver,Donald Cerrone,2011-10-29,1,0,-4,4,2.117647,2.090909,17.78,-17.78,10,-10,7.619995,-7.619995,10,38,53,34,19,-19,2.6738166809082e-02,-2.6738166809082e-02,3,1,0,1,2,-2,-1,1,76,497,-421,421
Diego Nunes,Dennis Siver,Dennis Siver,2012-04-14,0,1,-4,4,2.714286,2.090909,0,0,0,0,-7.62001,7.62001,0,33,26,34,-8,8,0.623376607894897,-0.623376607894897,0,0,0,1,0,0,-1,1,0,168,-168,168
Nam Phan,Dennis Siver,Dennis Siver,2012-12-08,0,1,-4,4,1.235294,2.090909,0,0,-10,10,0,0,0,423,38,34,4,-4,-0.855614900588989,0.855614900588989,0,1,0,1,-1,1,-1,1,0,238,-238,238
Charles Rosa,Dennis Siver,Dennis Siver,2014-10-04,0,1,-7,7,1.75,2.090909,7.619995,-7.619995,0,0,-2.540009,2.540009,55,531,22,34,-12,12,-0.340909004211426,0.340909004211426,0,2,0,1,-2,2,-1,1,0,665,-665,665
Conor McGregor,Dennis Siver,Conor McGregor,2015-01-18,1,0,-10,10,3.666667,2.090909,7.619995,-7.619995,10,-10,10.16,-10.16,26,3,28,34,-6,6,1.5757577419281,-1.5757577419281,1,3,0,1,-2,2,-1,1,113,106,7,-7
Tatsuya Kawajiri,Dennis Siver,Tatsuya Kawajiri,2015-06-20,1,0,1,-1,3.272727,2.090909,2.539993,-2.539993,0,0,-2.540009,2.540009,509,0,47,34,13,-13,1.18181824684143,-1.18181824684143,1,0,0,2,1,-1,-2,2,532,153,379,-379
BJ Penn,Dennis Siver,Dennis Siver,2017-06-25,0,1,0,0,1.142857,2.090909,7.619995,-7.619995,10,-10,0,0,121,11,30,34,-4,4,-0.948051810264587,0.948051810264587,0,0,2,2,0,0,0,0,161,736,-575,575
Dalcha Lungiambula,Dequan Townsend,Dalcha Lungiambula,2019-06-29,1,0,-2,2,1.833333,1.75,-17.78,17.78,-20,20,-7.62001,7.62001,463,2,17,33,-16,16,8.33333730697632e-02,-8.33333730697632e-02,0,0,0,0,0,0,0,0,0,0,0,0
Bevon Lewis,Dequan Townsend,Bevon Lewis,2020-01-25,1,0,-5,5,2.333333,1.75,0,0,-20,20,0,0,502,4,10,33,-23,23,0.583333253860474,-0.583333253860474,0,0,0,1,0,0,-1,1,231,210,21,-21
Devin Clark,Dequan Townsend,Devin Clark,2020-02-15,1,0,-4,4,1.75,1.75,-7.619995,7.619995,0,0,-10.16,10.16,606,0,22,33,-11,11,0,0,0,0,2,1,0,0,1,-1,126,21,105,-105
Dusko Todorovic,Dequan Townsend,Dusko Todorovic,2020-10-03,1,0,-8,8,3,1.75,-5.080002,5.080002,-20,20,-12.7,12.7,205,18,16,33,-17,17,1.25,-1.25,0,0,0,1,0,0,-1,1,0,231,-231,231
Sam Alvey,Derek Brunson,Derek Brunson,2015-08-08,0,1,-2,2,1.833333,2.555556,2.540009,-2.540009,0,0,-5.080002,5.080002,0,92,51,32,19,-19,-0.722222208976746,0.722222208976746,3,0,0,0,3,-3,0,0,91,0,91,-91
Israel Adesanya,Derek Brunson,Israel Adesanya,2018-11-03,1,0,-5,5,8,2.555556,7.619995,-7.619995,0,0,7.619995,-7.619995,10,95,27,32,-5,5,5.44444441795349,-5.44444441795349,3,1,0,0,2,-2,0,0,120,1183,-1063,1063
Nick Catone,Derek Downey,Nick Catone,2009-02-07,1,0,-1,1,2.5,2.75,-2.539993,2.539993,0,0,-5.119995,5.119995,277,62,14,15,-1,1,-0.25,0.25,0,0,0,0,0,0,0,0,0,0,0,0
Eric Spicely,Deron Winn,Deron Winn,2019-06-22,0,1,2,-2,2,2.333333,17.78,-17.78,0,0,7.619995,-7.619995,3,78,18,10,8,-8,-0.333333253860474,0.333333253860474,0,0,1,0,0,0,1,-1,391,0,391,-391
Darren Stewart,Deron Winn,Darren Stewart,2019-10-18,1,0,-2,2,1.5,2.333333,15.24001,-15.24001,20,-20,10.16,-10.16,30,482,20,10,10,-10,-0.833333253860474,0.833333253860474,0,1,0,0,-1,1,0,0,0,118,-118,118
Gerald Meerschaert,Deron Winn,Gerald Meerschaert,2020-03-07,1,0,2,-2,2.058824,2.333333,17.78,-17.78,0,0,17.78,-17.78,21,11,52,10,42,-42,-0.27450966835022,0.27450966835022,2,0,1,0,2,-2,1,-1,610,141,469,-469
Antonio Arroyo,Deron Winn,Deron Winn,2020-12-19,0,1,0,0,1.8,2.333333,22.86,-22.86,0,0,7.619995,-7.619995,28,569,14,10,4,-4,-0.533333301544189,0.533333301544189,0,0,0,0,0,0,0,0,399,287,112,-112
Phil Hawes,Deron Winn,Phil Hawes,2022-06-18,1,0,0,0,2.4,2.333333,15.24001,-15.24001,0,0,17.78,-17.78,47,0,17,10,7,-7,6.6666841506958e-02,-6.6666841506958e-02,2,1,0,0,1,-1,0,0,483,546,-63,63
Song Kenan,Derrick Krantz,Song Kenan,2019-08-31,1,0,-2,2,2.857143,1.833333,5.080002,-5.080002,0,0,-2.540009,2.540009,36,338,27,34,-7,7,1.02380955219269,-1.02380955219269,0,0,0,0,0,0,0,0,280,0,280,-280
Guto Inocente,Derrick Lewis,Derrick Lewis,2014-07-06,0,1,-1,1,1.75,2.454545,0,0,-55,55,-7.660004,7.660004,0,93,11,38,-27,27,-0.704545497894287,0.704545497894287,0,0,0,0,0,0,0,0,0,0,0,0
Shawn Jordan,Derrick Lewis,Shawn Jordan,2015-06-06,1,0,0,0,2.375,2.454545,-7.619995,7.619995,0,0,-10.16,10.16,211,55,27,38,-11,11,-7.95454978942871e-02,7.95454978942871e-02,1,1,1,0,0,0,1,-1,294,335,-41,41
Damian Grabowski,Derrick Lewis,Derrick Lewis,2016-02-06,0,1,5,-5,4,2.454545,-5.080002,5.080002,-19,19,-10.16,10.16,0,119,25,38,-13,13,1.54545450210571,-1.54545450210571,0,0,0,1,0,0,-1,1,0,245,-245,245
Gabriel Gonzaga,Derrick Lewis,Derrick Lewis,2016-04-10,0,1,5,-5,1.545455,2.454545,-2.539993,2.539993,-18,18,-7.62001,7.62001,219,4,28,38,-10,10,-0.909090995788574,0.909090995788574,0,1,2,1,-1,1,1,-1,484,64,420,-420
Shamil Abdurakhimov,Derrick Lewis,Derrick Lewis,2016-12-09,0,1,4,-4,2.5,2.454545,0,0,-25,25,-7.62001,7.62001,452,102,28,38,-10,10,4.54545021057129e-02,-4.54545021057129e-02,2,2,1,1,0,0,0,0,69,243,-174,174
Travis Browne,Derrick Lewis,Derrick Lewis,2017-02-19,0,1,2,-2,2.571429,2.454545,7.619995,-7.619995,-5,5,0,0,4,100,25,38,-13,13,0.116883039474487,-0.116883039474487,0,3,2,1,-3,3,1,-1,162,72,90,-90
Mark Hunt,Derrick Lewis,Mark Hunt,2017-06-10,1,0,11,-11,0.9285714,2.454545,-12.7,12.7,5,-5,-17.78,17.78,0,0,27,38,-11,11,-1.52597409486771,1.52597409486771,0,4,3,1,-4,4,2,-2,98,111,-13,13
Daniel Cormier,Derrick Lewis,Daniel Cormier,2018-11-03,1,0,6,-6,7.333333,2.454545,-10.16,10.16,-25,25,-17.78,17.78,310,0,25,38,-13,13,4.87878799438477,-4.87878799438477,6,0,0,2,6,-6,-2,2,119,511,-392,392
Junior Dos Santos,Derrick Lewis,Junior Dos Santos,2019-03-09,1,0,1,-1,2.333333,2.454545,2.539993,-2.539993,-22,22,-5.080002,5.080002,11,2,30,38,-8,8,-0.121212244033813,0.121212244033813,2,0,3,2,2,-2,1,-1,98,126,-28,28
Blagoy Ivanov,Derrick Lewis,Derrick Lewis,2019-11-02,0,1,-1,1,3.166667,2.454545,-10.16,10.16,-10,10,-15.24001,15.24001,200,127,25,38,-13,13,0.712121248245239,-0.712121248245239,2,0,0,3,2,-2,-3,3,147,238,-91,91
Ilir Latifi,Derrick Lewis,Derrick Lewis,2020-02-08,0,1,2,-2,1.888889,2.454545,-12.7,12.7,-30,30,-15.24001,15.24001,528,41,26,38,-12,12,-0.565656661987305,0.565656661987305,0,1,1,3,-1,1,-2,2,182,98,84,-84
Curtis Blaydes,Derrick Lewis,Derrick Lewis,2021-02-20,0,1,-6,6,4.25,2.454545,2.539993,-2.539993,5,-5,2.539993,-2.539993,15,0,21,38,-17,17,1.79545450210571,-1.79545450210571,3,2,2,3,1,-1,-1,1,245,378,-133,133
Ciryl Gane,Derrick Lewis,Ciryl Gane,2021-08-07,1,0,-5,5,6,2.454545,2.539993,-2.539993,-15,15,5.080002,-5.080002,81,8,14,38,-24,24,3.54545450210571,-3.54545450210571,4,3,0,3,1,-1,-3,3,42,168,-126,126
Chris Daukaus,Derrick Lewis,Derrick Lewis,2021-12-18,0,1,-4,4,1.714286,2.454545,0,0,-55,55,-7.62001,7.62001,0,0,19,38,-19,19,-0.740259766578674,0.740259766578674,3,0,0,4,3,-3,-4,4,301,133,168,-168
Thiago Alves,Derrick Noble,Thiago Alves,2006-04-15,1,0,-5,5,1.533333,1.8,0,0,0,0,-0.1999969,0.1999969,12,39,38,42,-4,4,-0.266666650772095,0.266666650772095,1,0,0,0,1,-1,0,0,147,0,147,-147
Josh Emmett,Desmond Green,Desmond Green,2017-04-08,0,1,5,-5,4.5,2.875,-10.16,10.16,-10,10,-7.619995,7.619995,0,33,22,31,-9,9,1.625,-1.625,2,0,0,0,2,-2,0,0,112,0,112,-112
Jan Blachowicz,Devin Clark,Jan Blachowicz,2017-10-21,1,0,7,-7,2.9,1.75,5.080002,-5.080002,0,0,7.619995,-7.619995,161,25,39,22,17,-17,1.15000009536743,-1.15000009536743,0,0,0,0,0,0,0,0,196,0,196,-196
Drakkar Klose,Devin Powell,Drakkar Klose,2017-01-15,1,0,0,0,6.5,2.25,-7.62001,7.62001,0,0,-7.619995,7.619995,486,7,15,13,2,-2,4.25,-4.25,0,0,0,0,0,0,0,0,0,0,0,0
Darrell Horcher,Devin Powell,Darrell Horcher,2017-06-25,1,0,0,0,3.25,2.25,-5.080002,5.080002,0,0,-7.619995,7.619995,432,114,17,13,4,-4,1,-1,0,0,1,0,0,0,1,-1,435,161,274,-274
Alvaro Herrera Mendoza,Devin Powell,Devin Powell,2018-07-28,0,1,-2,2,1.5,2.25,0,0,0,0,2.540009,-2.540009,10,11,15,13,2,-2,-0.75,0.75,0,0,0,0,0,0,0,0,357,398,-41,41
Jesus Pinedo,Devin Powell,Jesus Pinedo,2018-11-17,1,0,-8,8,3.2,2.25,-5.080002,5.080002,0,0,-5.419998,5.419998,267,15,21,13,8,-8,0.950000047683716,-0.950000047683716,0,1,0,0,-1,1,0,0,0,112,-112,112
Julian Erosa,Devonte Smith,Devonte Smith,2018-11-10,0,1,4,-4,2.333333,2.75,10.16,-10.16,-10,10,-5.079987,5.079987,0,3,40,15,25,-25,-0.416666746139526,0.416666746139526,0,0,1,0,0,0,1,-1,980,0,980,-980
Dong Hyun Ma,Devonte Smith,Devonte Smith,2019-02-09,0,1,5,-5,1.454545,2.75,5.080002,-5.080002,0,0,-15.23999,15.23999,0,2,27,15,12,-12,-1.29545450210571,1.29545450210571,1,1,2,0,0,0,2,-2,798,91,707,-707
Justin Jaynes,Devonte Smith,Devonte Smith,2021-02-06,0,1,4,-4,2,2.75,-5.080002,5.080002,-10,10,-20.31999,20.31999,12,188,24,15,9,-9,-0.75,0.75,0,2,0,0,-2,2,0,0,182,728,-546,546
Jamie Mullarkey,Devonte Smith,Jamie Mullarkey,2021-10-02,1,0,-1,1,2.833333,2.75,7.62001,-7.62001,0,0,-5.079987,5.079987,47,0,23,15,8,-8,8.33332538604736e-02,-8.33332538604736e-02,1,3,0,0,-2,2,0,0,189,238,-49,49
Ludovit Klein,Devonte Smith,Ludovit Klein,2022-03-05,1,0,-1,1,5,2.75,-5.080002,5.080002,0,0,-10.15999,10.15999,399,14,24,15,9,-9,2.25,-2.25,0,0,0,1,0,0,-1,1,140,154,-14,14
Eddie Gordon,Dhiego Lima,Eddie Gordon,2014-07-06,1,0,5,-5,2,1.888889,-5.080002,5.080002,15,-15,2.539993,-2.539993,18,0,12,26,-14,14,0.111111164093018,-0.111111164093018,0,0,0,0,0,0,0,0,0,0,0,0
Jorge de Oliveira,Dhiego Lima,Dhiego Lima,2014-11-08,0,1,9,-9,4.5,1.888889,-15.24001,15.24001,-15,15,-15.5,15.5,0,581,11,26,-15,15,2.61111116409302,-2.61111116409302,0,0,0,1,0,0,-1,1,0,125,-125,125
Li Jingliang,Dhiego Lima,Li Jingliang,2015-05-16,1,0,1,-1,2.375,1.888889,-5.080002,5.080002,0,0,-10.16,10.16,12,0,27,26,1,-1,0.486111164093018,-0.486111164093018,0,1,0,1,-1,1,-1,1,224,189,35,-35
Chad Laprise,Dhiego Lima,Dhiego Lima,2018-12-08,0,1,3,-3,3.25,1.888889,-10.16,10.16,0,0,-10.16,10.16,0,2,17,26,-9,9,1.36111116409302,-1.36111116409302,0,0,2,2,0,0,0,0,203,1302,-1099,1099
Luke Jumeau,Dhiego Lima,Dhiego Lima,2019-10-05,0,1,1,-1,2.6,1.888889,-7.62001,7.62001,0,0,-7.619995,7.619995,0,160,18,26,-8,8,0.711111068725586,-0.711111068725586,1,1,0,2,0,0,-2,2,847,301,546,-546
Matt Brown,Dhiego Lima,Matt Brown,2021-06-19,1,0,8,-8,1.368421,1.888889,-5.080002,5.080002,0,0,0,0,0,52,45,26,19,-19,-0.520467758178711,0.520467758178711,0,2,2,2,-2,2,0,0,154,623,-469,469
Dennis Bermudez,Diego Brandao,Diego Brandao,2011-12-03,0,1,0,0,1.888889,2,-2.539993,2.539993,10,-10,5.080002,-5.080002,61,26,26,33,-7,7,-0.111111164093018,0.111111164093018,0,0,0,0,0,0,0,0,0,0,0,0
Beneil Dariush,Diego Ferreira,Beneil Dariush,2014-10-25,1,0,-4,4,4.4,3.6,2.540009,-2.540009,0,0,-5.080002,5.080002,473,36,27,23,4,-4,0.800000190734863,-0.800000190734863,1,0,1,0,1,-1,1,-1,63,0,63,-63
Olivier Aubin-Mercier,Diego Ferreira,Diego Ferreira,2016-01-30,0,1,-5,5,2.2,3.6,0,0,0,0,-10.16,10.16,57,243,16,23,-7,7,-1.39999985694885,1.39999985694885,3,0,0,0,3,-3,0,0,160,462,-302,302
Beneil Dariush,Diego Ferreira,Beneil Dariush,2021-02-06,1,0,-5,5,4.4,3.6,2.540009,-2.540009,0,0,-5.080002,5.080002,443,58,27,23,4,-4,0.800000190734863,-0.800000190734863,4,1,2,0,3,-3,2,-2,182,1834,-1652,1652
Movsar Evloev,Diego Lopes,Movsar Evloev,2023-05-06,1,0,1,-1,17,3.666667,-10.16,10.16,0,0,0,0,510,41,17,28,-11,11,13.3333332538605,-13.3333332538605,3,0,0,0,3,-3,0,0,336,0,336,-336
Mike Brown,Diego Nunes,Diego Nunes,2011-01-01,0,1,7,-7,2.888889,2.714286,0,0,0,0,7.62001,-7.62001,295,130,35,26,9,-9,0.174603223800659,-0.174603223800659,0,0,0,0,0,0,0,0,2465,0,2465,-2465
Kenny Florian,Diego Nunes,Kenny Florian,2011-06-11,1,0,7,-7,2.333333,2.714286,10.16,-10.16,0,0,17.78001,-17.78001,292,138,20,26,-6,6,-0.38095235824585,0.38095235824585,0,1,1,0,-1,1,1,-1,287,161,126,-126
Manvel Gamburyan,Diego Nunes,Diego Nunes,2011-12-30,0,1,1,-1,1.5,2.714286,-2.539993,2.539993,-10,10,0,0,211,55,25,26,-1,1,-1.21428561210632,1.21428561210632,0,0,0,0,0,0,0,0,187,202,-15,15
Nik Lentz,Diego Nunes,Nik Lentz,2013-01-19,1,0,-2,2,2.5,2.714286,5.080002,-5.080002,0,0,2.540009,-2.540009,733,0,42,26,16,-16,-0.214285612106323,0.214285612106323,4,1,0,0,3,-3,0,0,161,386,-225,225
Noad Lahat,Diego Rivas,Diego Rivas,2016-02-06,0,1,7,-7,5.5,5,2.539993,-2.539993,0,0,0,0,240,17,13,12,1,-1,0.5,-0.5,1,0,1,0,1,-1,1,-1,560,0,560,-560
Jose Quinonez,Diego Rivas,Jose Quinonez,2017-08-05,1,0,2,-2,1.8,5,0,0,-10,10,0,0,176,16,14,12,2,-2,-3.20000004768372,3.20000004768372,0,1,0,0,-1,1,0,0,0,546,-546,546
Guido Cannetti,Diego Rivas,Guido Cannetti,2018-05-19,1,0,12,-12,1.25,5,-5.080002,5.080002,-10,10,-2.539993,2.539993,356,183,18,12,6,-6,-3.75,3.75,0,0,0,0,0,0,0,0,125,287,-162,162
Kenny Florian,Diego Sanchez,Diego Sanchez,2005-04-09,0,1,5,-5,2.333333,2.384615,0,0,-25,25,5.080002,-5.080002,0,92,20,44,-24,24,-5.12821674346924e-02,5.12821674346924e-02,0,0,0,0,0,0,0,0,0,0,0,0
Brian Gassaway,Diego Sanchez,Diego Sanchez,2005-08-20,0,1,10,-10,1.45,2.384615,7.619995,-7.619995,0,0,5.119995,-5.119995,23,317,49,44,5,-5,-0.93461537361145,0.93461537361145,0,1,0,0,-1,1,0,0,0,133,-133,133
Nick Diaz,Diego Sanchez,Diego Sanchez,2005-11-05,0,1,-1,1,2.6,2.384615,7.619995,-7.619995,0,0,10.15999,-10.15999,138,625,36,44,-8,8,0.215384483337402,-0.215384483337402,2,2,0,0,0,0,0,0,154,77,77,-77
John Alessio,Diego Sanchez,Diego Sanchez,2006-05-27,0,1,2,-2,2.058824,2.384615,0,0,-15,15,0,0,0,262,52,44,8,-8,-0.325791835784912,0.325791835784912,0,3,0,0,-3,3,0,0,2178,203,1975,-1975
Karo Parisyan,Diego Sanchez,Diego Sanchez,2006-08-17,0,1,-1,1,2.181818,2.384615,0,0,0,0,0,0,271,295,35,44,-9,9,-0.202797174453735,0.202797174453735,2,4,0,0,-2,2,0,0,124,82,42,-42
Joe Riggs,Diego Sanchez,Diego Sanchez,2006-12-13,0,1,0,0,2.588235,2.384615,5.080002,-5.080002,15,-15,-5.080002,5.080002,0,4,61,44,17,-17,0.203619956970215,-0.203619956970215,1,5,0,0,-4,4,0,0,118,118,0,0
Josh Koscheck,Diego Sanchez,Josh Koscheck,2007-04-07,1,0,4,-4,1.545455,2.384615,0,0,0,0,2.539993,-2.539993,14,6,28,44,-16,16,-0.839160919189453,0.839160919189453,3,6,0,0,-3,3,0,0,283,115,168,-168
Jon Fitch,Diego Sanchez,Jon Fitch,2007-09-22,1,0,4,-4,4.285714,2.384615,5.080002,-5.080002,0,0,5.080002,-5.080002,580,216,37,44,-7,7,1.90109872817993,-1.90109872817993,2,0,0,0,2,-2,0,0,343,168,175,-175
David Bielkheden,Diego Sanchez,Diego Sanchez,2008-03-01,0,1,2,-2,2,2.384615,0,0,-15,15,-2.540009,2.540009,0,270,36,44,-8,8,-0.384615421295166,0.384615421295166,0,0,0,0,0,0,0,0,0,161,-161,161
Luigi Fioravanti,Diego Sanchez,Diego Sanchez,2008-06-21,0,1,1,-1,1.733333,2.384615,-5.080002,5.080002,0,0,-5.080002,5.080002,45,111,41,44,-3,3,-0.651282072067261,0.651282072067261,0,1,0,0,-1,1,0,0,375,112,263,-263
Clay Guida,Diego Sanchez,Diego Sanchez,2009-06-20,0,1,0,0,1.9,2.384615,-7.62001,7.62001,-15,15,-5.080002,5.080002,476,66,58,44,14,-14,-0.484615445137024,0.484615445137024,1,2,0,0,-1,1,0,0,444,364,80,-80
BJ Penn,Diego Sanchez,BJ Penn,2009-12-12,1,0,3,-3,1.142857,2.384615,-2.540009,2.540009,-15,15,-5.080002,5.080002,90,382,30,44,-14,14,-1.24175822734833,1.24175822734833,0,3,1,0,-3,3,1,-1,315,175,140,-140
John Hathaway,Diego Sanchez,John Hathaway,2010-05-29,1,0,-6,6,8.5,2.384615,7.619995,-7.619995,0,0,7.619995,-7.619995,234,125,19,44,-25,25,6.11538457870483,-6.11538457870483,2,0,0,1,2,-2,-1,1,196,168,28,-28
Martin Kampmann,Diego Sanchez,Diego Sanchez,2011-03-03,0,1,-1,1,2.857143,2.384615,5.080002,-5.080002,0,0,0,0,22,98,27,44,-17,17,0.472527503967285,-0.472527503967285,0,0,1,1,0,0,0,0,131,278,-147,147
Jake Ellenberger,Diego Sanchez,Jake Ellenberger,2012-02-15,1,0,-4,4,2.066667,2.384615,-2.540009,2.540009,0,0,-2.540009,2.540009,102,68,46,44,2,-2,-0.317948818206787,0.317948818206787,4,1,0,1,3,-3,-1,1,151,349,-198,198
Takanori Gomi,Diego Sanchez,Diego Sanchez,2013-03-02,0,1,3,-3,2.5,2.384615,-7.62001,7.62001,-15,15,-5.080002,5.080002,3,20,49,44,5,-5,0.115384578704834,-0.115384578704834,1,0,0,1,1,-1,-1,1,371,381,-10,10
Gilbert Melendez,Diego Sanchez,Gilbert Melendez,2013-10-19,1,0,0,0,2.75,2.384615,-2.540009,2.540009,-25,25,2.539993,-2.539993,34,49,30,44,-14,14,0.365384578704834,-0.365384578704834,0,1,0,1,-1,1,-1,1,0,231,-231,231
Myles Jury,Diego Sanchez,Myles Jury,2014-03-15,1,0,-7,7,4.25,2.384615,0,0,-25,25,2.539993,-2.539993,187,49,21,44,-23,23,1.86538457870483,-1.86538457870483,3,0,0,1,3,-3,-1,1,175,147,28,-28
Ross Pearson,Diego Sanchez,Diego Sanchez,2014-06-07,0,1,-3,3,1.25,2.384615,-5.080002,5.080002,-15,15,-7.62001,7.62001,6,2,36,44,-8,8,-1.13461542129517,1.13461542129517,1,0,1,1,1,-1,0,0,540,84,456,-456
Ricardo Lamas,Diego Sanchez,Ricardo Lamas,2015-11-21,1,0,0,0,2.5,2.384615,-5.080002,5.080002,-25,25,-2.540009,2.540009,280,85,28,44,-16,16,0.115384578704834,-0.115384578704834,0,1,1,1,-1,1,0,0,231,532,-301,301
Jim Miller,Diego Sanchez,Diego Sanchez,2016-03-05,0,1,-2,2,2.117647,2.384615,-5.080002,5.080002,-15,15,-2.540009,2.540009,24,207,53,44,9,-9,-0.266968250274658,0.266968250274658,4,0,0,1,4,-4,-1,1,1813,105,1708,-1708
Joe Lauzon,Diego Sanchez,Joe Lauzon,2016-07-09,1,0,-2,2,1.75,2.384615,0,0,-15,15,-2.540009,2.540009,17,0,44,44,0,0,-0.634615421295166,0.634615421295166,0,1,1,1,-1,1,0,0,1288,126,1162,-1162
Marcin Held,Diego Sanchez,Diego Sanchez,2016-11-05,0,1,-10,10,3.285714,2.384615,-2.540009,2.540009,-15,15,-2.540009,2.540009,18,555,30,44,-14,14,0.901098966598511,-0.901098966598511,0,0,0,2,0,0,-2,2,0,119,-119,119
Al Iaquinta,Diego Sanchez,Al Iaquinta,2017-04-22,1,0,-6,6,2,2.384615,0,0,-15,15,-5.080002,5.080002,5,0,21,44,-23,23,-0.384615421295166,0.384615421295166,4,1,0,2,3,-3,-2,2,749,168,581,-581
Matt Brown,Diego Sanchez,Matt Brown,2017-11-11,1,0,1,-1,1.368421,2.384615,5.080002,-5.080002,0,0,7.619995,-7.619995,1,90,45,44,1,-1,-1.01619434356689,1.01619434356689,0,0,2,3,0,0,-1,1,336,203,133,-133
Mickey Gall,Diego Sanchez,Diego Sanchez,2019-03-02,0,1,-10,10,1.4,2.384615,10.16,-10.16,0,0,5.080002,-5.080002,19,357,12,44,-32,32,-0.984615445137024,0.984615445137024,4,0,0,4,4,-4,-4,4,189,476,-287,287
Michael Chiesa,Diego Sanchez,Michael Chiesa,2019-07-06,1,0,-6,6,2.571429,2.384615,7.619995,-7.619995,0,0,7.619995,-7.619995,709,144,25,44,-19,19,0.186813116073608,-0.186813116073608,1,1,1,4,0,0,-3,3,189,126,63,-63
Michel Pereira,Diego Sanchez,Diego Sanchez,2020-02-15,0,1,-12,12,2.545455,2.384615,7.619995,-7.619995,15,-15,2.539993,-2.539993,49,10,39,44,-5,5,0.160839080810547,-0.160839080810547,1,0,0,4,1,-1,-4,4,273,224,49,-49
Jake Matthews,Diego Sanchez,Jake Matthews,2020-09-26,1,0,-12,12,3.166667,2.384615,2.539993,-2.539993,0,0,2.539993,-2.539993,292,0,25,44,-19,19,0.78205132484436,-0.78205132484436,1,1,0,4,0,0,-4,4,217,224,-7,7
Dustin Hazelett,Diego Saraiva,Dustin Hazelett,2007-02-03,1,0,-4,4,1.714286,1.1,17.78,-17.78,15,-15,23.03999,-23.03999,254,344,19,42,-23,23,0.614285707473755,-0.614285707473755,0,0,0,0,0,0,0,0,0,0,0,0
Jorge Gurgel,Diego Saraiva,Jorge Gurgel,2007-07-07,1,0,5,-5,1.4,1.1,2.539993,-2.539993,0,0,5.259995,-5.259995,314,3,24,42,-18,18,0.299999952316284,-0.299999952316284,0,0,0,0,0,0,0,0,374,154,220,-220
Anthony Birchak,Dileno Lopes,Anthony Birchak,2016-07-07,1,0,-1,1,2,6.333333,7.619995,-7.619995,0,0,5.259995,-5.259995,140,310,24,22,2,-2,-4.33333349227905,4.33333349227905,1,0,0,0,1,-1,0,0,397,0,397,-397
BJ Penn,Din Thomas,BJ Penn,2001-06-29,1,0,-2,2,1.142857,2.888889,0,0,0,0,-0.1999969,0.1999969,8,125,30,35,-5,5,-1.74603164196014,1.74603164196014,0,0,0,0,0,0,0,0,0,0,0,0
Fabiano Iha,Din Thomas,Din Thomas,2001-09-28,0,1,6,-6,1.8,2.888889,-2.539993,2.539993,0,0,-5,5,343,369,14,35,-21,21,-1.0888888835907,1.0888888835907,0,0,1,1,0,0,0,0,91,91,0,0
Matt Serra,Din Thomas,Din Thomas,2003-02-28,0,1,2,-2,1.571429,2.888889,-7.619995,7.619995,15,-15,-5.279999,5.279999,86,105,18,35,-17,17,-1.31746029853821,1.31746029853821,0,1,0,1,-1,1,-1,1,0,518,-518,518
Rich Clementi,Din Thomas,Din Thomas,2006-11-11,0,1,0,0,1.956522,2.888889,0,0,0,0,4.880005,-4.880005,20,135,68,35,33,-33,-0.932367086410522,0.932367086410522,0,2,0,1,-2,2,-1,1,1352,1352,0,0
Clay Guida,Din Thomas,Din Thomas,2007-01-25,0,1,-5,5,1.9,2.888889,-5.080002,5.080002,0,0,-0.1999969,0.1999969,413,48,58,35,23,-23,-0.98888885974884,0.98888885974884,1,3,0,1,-2,2,-1,1,103,75,28,-28
Jeremy Stephens,Din Thomas,Din Thomas,2007-05-26,0,1,-9,9,1.473684,2.888889,0,0,-10,10,2.339996,-2.339996,66,242,47,35,12,-12,-1.41520464420319,1.41520464420319,0,4,0,1,-4,4,-1,1,0,121,-121,121
Kenny Florian,Din Thomas,Kenny Florian,2007-09-19,1,0,1,-1,2.333333,2.888889,2.540009,-2.540009,-10,10,9.960007,-9.960007,102,21,20,35,-15,15,-0.555555582046509,0.555555582046509,2,5,1,1,-3,3,0,0,74,116,-42,42
Josh Neer,Din Thomas,Josh Neer,2008-04-02,1,0,-6,6,2.25,2.888889,5.080002,-5.080002,15,-15,4.880005,-4.880005,492,93,52,35,17,-17,-0.638888835906982,0.638888835906982,1,0,0,1,1,-1,-1,1,727,196,531,-531
Steven Graham,Dmitri Stepanov,Steven Graham,1997-05-30,1,0,,,2,0,-5.080002,5.080002,73,-73,-5,5,0,0,3,1,2,-2,2,-2,0,0,0,0,0,0,0,0,0,0,0,0
Luis Henrique,Dmitrii Smoliakov,Luis Henrique,2016-07-23,1,0,-11,11,2,3,0,0,-10,10,0,0,361,0,15,12,3,-3,-1,1,0,0,1,0,0,0,1,-1,217,0,217,-217
Cyril Asker,Dmitrii Smoliakov,Cyril Asker,2017-01-15,1,0,-3,3,2.25,3,-5.080002,5.080002,-6,6,0,0,82,0,13,12,1,-1,-0.75,0.75,0,0,1,0,0,0,1,-1,280,176,104,-104
Greg Hardy,Dmitrii Smoliakov,Greg Hardy,2019-04-27,1,0,-6,6,1.4,3,7.619995,-7.619995,12,-12,15.23999,-15.23999,25,0,12,12,0,0,-1.60000002384186,1.60000002384186,0,0,0,1,0,0,-1,1,0,832,-832,832
Mark Godbeer,Dmitry Sosnovskiy,Dmitry Sosnovskiy,2018-03-17,0,1,6,-6,3.25,11,2.539993,-2.539993,0,0,0,0,209,255,17,11,6,-6,-7.75,7.75,2,0,0,0,2,-2,0,0,133,0,133,-133
Kenny Florian,Dokonjonosuke Mishima,Kenny Florian,2007-04-05,1,0,-4,4,2.333333,3,7.62001,-7.62001,-10,10,14.96001,-14.96001,437,89,20,28,-8,8,-0.666666746139526,0.666666746139526,0,0,1,0,0,0,1,-1,173,0,173,-173
Felipe Colares,Domingo Pilarte,Felipe Colares,2019-07-20,1,0,-4,4,2.5,2.666667,-10.16,10.16,10,-10,-10.16,10.16,398,370,14,11,3,-3,-0.166666746139526,0.166666746139526,0,0,0,0,0,0,0,0,168,0,168,-168
Brian Kelleher,Domingo Pilarte,Brian Kelleher,2021-08-21,1,0,4,-4,1.714286,2.666667,-15.24001,15.24001,0,0,-17.78,17.78,769,89,38,11,27,-27,-0.952381014823914,0.952381014823914,0,0,1,0,0,0,1,-1,189,763,-574,574
George Sullivan,Dominic Waters,George Sullivan,2015-07-12,1,0,8,-8,2.428571,1.8,-2.539993,2.539993,0,0,-15.24001,15.24001,363,325,24,14,10,-10,0.628571510314941,-0.628571510314941,0,0,0,0,0,0,0,0,0,0,0,0
Dong Hyun Kim,Dominic Waters,Dong Hyun Kim,2015-11-28,1,0,8,-8,5.5,1.8,2.540009,-2.540009,0,0,-7.62001,7.62001,120,53,26,14,12,-12,3.70000004768372,-3.70000004768372,0,0,2,0,0,0,2,-2,462,139,323,-323
Leon Edwards,Dominic Waters,Leon Edwards,2016-05-08,1,0,-3,3,7,1.8,2.540009,-2.540009,0,0,-12.7,12.7,191,435,24,14,10,-10,5.20000004768372,-5.20000004768372,0,0,0,1,0,0,-1,1,141,162,-21,21
Henry Cejudo,Dominick Cruz,Henry Cejudo,2020-05-09,1,0,-2,2,5.333333,6,-10.16,10.16,0,0,-10.16,10.16,14,0,19,28,-9,9,-0.666666507720947,0.666666507720947,5,0,1,0,5,-5,1,-1,336,0,336,-336
Joachim Christensen,Dominick Reyes,Dominick Reyes,2017-06-25,0,1,11,-11,2.333333,3,-2.539993,2.539993,0,0,-2.540009,2.540009,0,6,20,16,4,-4,-0.666666746139526,0.666666746139526,1,0,0,0,1,-1,0,0,161,0,161,-161
Jeremy Kimball,Dominick Reyes,Dominick Reyes,2017-12-02,0,1,-1,1,1.875,3,-10.15999,10.15999,0,0,-12.7,12.7,60,127,23,16,7,-7,-1.125,1.125,1,1,1,0,0,0,1,-1,160,160,0,0
Jared Cannonier,Dominick Reyes,Dominick Reyes,2018-05-19,0,1,6,-6,2.833333,3,-12.7,12.7,-20,20,0,0,0,0,23,16,7,-7,-0.166666746139526,0.166666746139526,1,2,1,0,-1,1,1,-1,316,168,148,-148
Volkan Oezdemir,Dominick Reyes,Dominick Reyes,2019-03-16,0,1,0,0,2.714286,3,-5.079987,5.079987,0,0,-5.080002,5.080002,93,0,26,16,10,-10,-0.285714387893677,0.285714387893677,0,3,0,0,-3,3,0,0,140,301,-161,161
Jon Jones,Dominick Reyes,Jon Jones,2020-02-08,1,0,2,-2,27,3,0,0,43,-43,17.78,-17.78,101,0,28,16,12,-12,24,-24,10,4,0,0,6,-6,0,0,217,329,-112,112
Jan Blachowicz,Dominick Reyes,Jan Blachowicz,2020-09-26,1,0,7,-7,2.9,3,-5.079987,5.079987,0,0,2.539993,-2.539993,3,0,39,16,23,-23,-9.99999046325684e-02,9.99999046325684e-02,2,0,1,0,2,-2,1,-1,315,231,84,-84
Jiri Prochazka,Dominick Reyes,Jiri Prochazka,2021-05-01,1,0,-3,3,9.666667,3,-2.539993,2.539993,0,0,7.619995,-7.619995,95,29,32,16,16,-16,6.66666698455811,-6.66666698455811,0,0,0,1,0,0,-1,1,0,217,-217,217
Zak Cummings,Dominique Steele,Zak Cummings,2015-07-25,1,0,3,-3,3.571429,1.555556,5.080002,-5.080002,35,-35,2.539993,-2.539993,1,0,32,23,9,-9,2.01587295532227,-2.01587295532227,0,0,0,0,0,0,0,0,371,0,371,-371
Dong Hyun Ma,Dominique Steele,Dominique Steele,2015-11-28,0,1,0,0,1.454545,1.555556,2.539993,-2.539993,-15,15,-10.16,10.16,76,372,27,23,4,-4,-0.101010084152222,0.101010084152222,0,0,0,1,0,0,-1,1,0,126,-126,126
Danny Roberts,Dominique Steele,Danny Roberts,2016-04-23,1,0,0,0,2.25,1.555556,7.619995,-7.619995,0,0,0,0,65,459,26,23,3,-3,0.694444417953491,-0.694444417953491,0,1,0,1,-1,1,-1,1,0,147,-147,147
Court McGee,Dominique Steele,Court McGee,2016-08-06,1,0,3,-3,1.833333,1.555556,2.539993,-2.539993,0,0,2.539993,-2.539993,426,92,34,23,11,-11,0.277777791023254,-0.277777791023254,0,0,1,1,0,0,0,0,112,105,7,-7
Luke Jumeau,Dominique Steele,Luke Jumeau,2017-06-10,1,0,0,0,2.6,1.555556,2.539993,-2.539993,0,0,-5.080002,5.080002,98,340,18,23,-5,5,1.04444432258606,-1.04444432258606,0,0,0,1,0,0,-1,1,0,308,-308,308
Sam Adkins,Don Frye,Don Frye,1996-02-16,0,1,0,0,0.35,2.222222,5.080002,-5.080002,6,-6,17,-17,0,0,27,29,-2,2,-1.8722223341465,1.8722223341465,1,0,0,0,1,-1,0,0,0,0,0,0
Amaury Bitetti,Don Frye,Don Frye,1996-05-17,0,1,,,2.5,2.222222,-10.16,10.16,-34,34,-10,10,0,0,7,29,-22,22,0.277777671813965,-0.277777671813965,0,1,0,0,-1,1,0,0,0,91,-91,91
Mark Coleman,Don Frye,Mark Coleman,1996-07-12,1,0,1,-1,1.6,2.222222,0,0,-14,14,2.5,-2.5,0,0,26,29,-3,3,-0.622222304344177,0.622222304344177,2,2,0,0,0,0,0,0,0,56,-56,56
David Abbott,Don Frye,Don Frye,1996-12-07,0,1,,,0.6666667,2.222222,-2.539993,2.539993,46,-46,-5.5,5.5,0,0,25,29,-4,4,-1.55555564165115,1.55555564165115,2,0,0,1,2,-2,-1,1,0,148,-148,148
Te Edwards,Don Madge,Don Madge,2018-10-27,0,1,1,-1,2,3,-10.16,10.16,0,0,0,0,228,32,9,12,-3,3,-1,1,0,0,0,0,0,0,0,0,0,0,0,0
Jack Jenkins,Don Shainis,Jack Jenkins,2023-02-11,1,0,-3,3,4,2.4,2.539993,-2.539993,0,0,2.540009,-2.540009,360,136,15,17,-2,2,1.59999990463257,-1.59999990463257,0,0,0,0,0,0,0,0,0,0,0,0
Ciryl Gane,"Don'Tale Mayes",Ciryl Gane,2019-10-26,1,0,2,-2,6,2,-5.080002,5.080002,-15,15,0,0,137,2,14,15,-1,1,4,-4,1,0,0,0,1,-1,0,0,77,0,77,-77
Roque Martinez,"Don'Tale Mayes","Don'Tale Mayes",2020-11-14,0,1,6,-6,1.875,2,-20.31999,20.31999,-10,10,-22.86,22.86,172,147,23,15,8,-8,-0.125,0.125,0,0,0,0,0,0,0,0,63,385,-322,322
Andrei Arlovski,"Don'Tale Mayes","Don'Tale Mayes",2023-06-03,0,1,13,-13,1.545455,2,-7.619995,7.619995,-20,20,-10.16,10.16,0,2,56,15,41,-41,-0.454545497894287,0.454545497894287,0,1,7,0,-1,1,7,-7,217,931,-714,714
Edson Barboza,Donald Cerrone,Donald Cerrone,2014-04-19,0,1,-3,3,2.090909,2.117647,-5.080002,5.080002,-10,10,5.080002,-5.080002,0,21,34,53,-19,19,-2.6738166809082e-02,2.6738166809082e-02,3,0,1,0,3,-3,1,-1,126,0,126,-126
Eddie Alvarez,Donald Cerrone,Donald Cerrone,2014-09-27,0,1,-1,1,4.833333,2.117647,-10.16,10.16,0,0,-10.16,10.16,37,117,35,53,-18,18,2.71568632125854,-2.71568632125854,0,1,0,0,-1,1,0,0,0,161,-161,161
Matt Brown,Donald Cerrone,Donald Cerrone,2016-12-10,0,1,2,-2,1.368421,2.117647,-2.539993,2.539993,15,-15,5.080002,-5.080002,4,35,45,53,-8,8,-0.749226093292236,0.749226093292236,0,2,1,0,-2,2,1,-1,133,805,-672,672
Matt Brown,Dong Hyun Kim,Dong Hyun Kim,2008-09-06,0,1,1,-1,1.368421,5.5,-5.080002,5.080002,0,0,-2.539993,2.539993,308,304,45,26,19,-19,-4.13157892227173,4.13157892227173,0,0,0,0,0,0,0,0,0,0,0,0
TJ Grant,Dong Hyun Kim,Dong Hyun Kim,2009-07-11,0,1,-2,2,4.2,5.5,-10.16,10.16,-15,15,-10.15999,10.15999,139,625,26,26,0,0,-1.30000019073486,1.30000019073486,0,1,0,0,-1,1,0,0,0,308,-308,308
Nate Diaz,Dong Hyun Kim,Dong Hyun Kim,2011-01-01,0,1,-4,4,1.692308,5.5,-5.080002,5.080002,0,0,0,0,117,498,35,26,9,-9,-3.80769228935242,3.80769228935242,1,2,0,0,-1,1,0,0,280,539,-259,259
Carlos Condit,Dong Hyun Kim,Carlos Condit,2011-07-02,1,0,-2,2,2.285714,5.5,0,0,0,0,-2.539993,2.539993,9,14,46,26,20,-20,-3.21428561210632,3.21428561210632,3,3,0,0,0,0,0,0,259,182,77,-77
Siyar Bahadurzada,Dong Hyun Kim,Dong Hyun Kim,2013-03-02,0,1,-3,3,3,5.5,-7.62001,7.62001,0,0,-7.619995,7.619995,2,674,32,26,6,-6,-2.5,2.5,1,0,0,1,1,-1,-1,1,322,609,-287,287
John Hathaway,Dong Hyun Kim,Dong Hyun Kim,2014-03-01,0,1,-6,6,8.5,5.5,-2.540009,2.540009,0,0,-2.539993,2.539993,225,132,19,26,-7,7,3,-3,3,1,0,1,2,-2,-1,1,518,364,154,-154
Joshua Burkman,Dong Hyun Kim,Dong Hyun Kim,2015-05-23,0,1,2,-2,1.75,5.5,-10.16,10.16,0,0,-10.15999,10.15999,78,464,44,26,18,-18,-3.75,3.75,0,2,0,1,-2,2,-1,1,2401,448,1953,-1953
Colby Covington,Dong Hyun Kim,Colby Covington,2017-06-17,1,0,-6,6,5.666667,5.5,-7.62001,7.62001,0,0,-10.15999,10.15999,610,68,20,26,-6,6,0.166666507720947,-0.166666507720947,5,3,0,1,2,-2,-1,1,301,756,-455,455
Takanori Gomi,Dong Hyun Ma,Dong Hyun Ma,2017-09-22,0,1,10,-10,2.5,1.454545,-10.16,10.16,0,0,0,0,0,7,49,27,22,-22,1.04545450210571,-1.04545450210571,0,0,3,0,0,0,3,-3,97,0,97,-97
Damien Brown,Dong Hyun Ma,Dong Hyun Ma,2018-02-10,0,1,4,-4,1.416667,1.454545,-2.539993,2.539993,0,0,-5.080002,5.080002,0,0,29,27,2,-2,-3.78788709640503e-02,3.78788709640503e-02,0,1,1,0,-1,1,1,-1,84,141,-57,57
Scott Holtzman,Dong Hyun Ma,Scott Holtzman,2019-08-03,1,0,5,-5,2.333333,1.454545,-5.080002,5.080002,0,0,-2.540009,2.540009,294,35,20,27,-7,7,0.878787755966187,-0.878787755966187,0,2,0,0,-2,2,0,0,167,539,-372,372
Chris Camozzi,Dongi Yang,Chris Camozzi,2010-10-23,1,0,-2,2,1.846154,4.333333,10.16,-10.16,0,0,5.080002,-5.080002,37,127,37,16,21,-21,-2.48717963695526,2.48717963695526,1,0,0,0,1,-1,0,0,126,0,126,-126
Rob Kimmons,Dongi Yang,Dongi Yang,2011-03-03,0,1,4,-4,2.777778,4.333333,0,0,0,0,0,0,20,497,34,16,18,-18,-1.55555582046509,1.55555582046509,0,0,1,0,0,0,1,-1,110,131,-21,21
Court McGee,Dongi Yang,Court McGee,2011-09-17,1,0,0,0,1.833333,4.333333,2.539993,-2.539993,-15,15,5.080002,-5.080002,57,20,34,16,18,-18,-2.50000011920929,2.50000011920929,0,1,0,0,-1,1,0,0,0,198,-198,198
Brad Tavares,Dongi Yang,Brad Tavares,2012-05-15,1,0,-3,3,2.222222,4.333333,7.619995,-7.619995,0,0,2.540009,-2.540009,138,34,29,16,13,-13,-2.11111116409302,2.11111116409302,0,0,0,0,0,0,0,0,0,241,-241,241
Jake Collier,Dongi Yang,Dongi Yang,2015-11-28,0,1,-3,3,1.3,4.333333,12.7,-12.7,45,-45,12.7,-12.7,107,117,23,16,7,-7,-3.03333353996277,3.03333353996277,0,0,1,0,0,0,1,-1,343,1292,-949,949
Jeff Hougland,Donny Walker,Jeff Hougland,2011-07-02,1,0,1,-1,1.666667,1.5,-5.080002,5.080002,0,0,-2.279999,2.279999,222,379,16,25,-9,9,0.166666626930237,-0.166666626930237,0,0,0,0,0,0,0,0,0,0,0,0
Ken Stone,Donny Walker,Ken Stone,2011-09-17,1,0,-3,3,2.75,1.5,-2.539993,2.539993,0,0,5.339996,-5.339996,130,0,15,25,-10,10,1.25,-1.25,0,0,0,0,0,0,0,0,0,77,-77,77
Roman Mitichyan,Dorian Price,Roman Mitichyan,2007-12-08,1,0,-1,1,2.666667,1.6,-12.7,12.7,0,0,-13,13,12,0,11,13,-2,2,1.06666672229767,-1.06666672229767,0,0,0,0,0,0,0,0,0,0,0,0
Mark Bocek,Doug Evans,Mark Bocek,2007-12-29,1,0,-1,1,2.4,1.3,-2.539993,2.539993,0,0,12.5,-12.5,638,52,17,23,-6,6,1.10000014305115,-1.10000014305115,0,0,1,0,0,0,1,-1,175,0,175,-175
Cody Gibson,Douglas Silva de Andrade,Douglas Silva de Andrade,2015-02-22,0,1,-2,2,2.222222,5.8,7.62001,-7.62001,0,0,7.619995,-7.619995,16,77,29,34,-5,5,-3.57777786254883,3.57777786254883,0,0,0,0,0,0,0,0,365,0,365,-365
Henry Briones,Douglas Silva de Andrade,Douglas Silva de Andrade,2016-11-05,0,1,5,-5,2,5.8,2.540009,-2.540009,0,0,2.539993,-2.539993,2,10,24,34,-10,10,-3.80000019073486,3.80000019073486,0,1,0,0,-1,1,0,0,483,622,-139,139
Rob Font,Douglas Silva de Andrade,Rob Font,2017-07-08,1,0,-2,2,2.857143,5.8,2.540009,-2.540009,0,0,7.619995,-7.619995,129,10,27,34,-7,7,-2.94285726547241,2.94285726547241,1,2,0,0,-1,1,0,0,217,245,-28,28
Renan Barao,Douglas Silva de Andrade,Douglas Silva de Andrade,2019-11-16,0,1,-2,2,3.777778,5.8,-2.539993,2.539993,10,-10,5.080002,-5.080002,200,28,43,34,9,-9,-2.0222225189209,2.0222225189209,0,0,3,0,0,0,3,-3,272,861,-589,589
Lerone Murphy,Douglas Silva de Andrade,Lerone Murphy,2021-01-20,1,0,-6,6,13,5.8,5.080002,-5.080002,10,-10,12.7,-12.7,111,81,13,34,-21,21,7.19999980926514,-7.19999980926514,1,1,0,0,0,0,0,0,189,431,-242,242
Gaetano Pirrello,Douglas Silva de Andrade,Douglas Silva de Andrade,2021-10-02,0,1,-7,7,2.142857,5.8,0,0,0,0,-7.619995,7.619995,0,19,22,34,-12,12,-3.65714311599731,3.65714311599731,0,0,0,0,0,0,0,0,255,255,0,0
Sergey Morozov,Douglas Silva de Andrade,Douglas Silva de Andrade,2022-02-12,0,1,-4,4,3.8,5.8,-2.539993,2.539993,0,0,-2.540009,2.540009,150,55,24,34,-10,10,-2.00000023841858,2.00000023841858,1,1,0,0,0,0,0,0,210,133,77,-77
Said Nurmagomedov,Douglas Silva de Andrade,Said Nurmagomedov,2022-07-09,1,0,-7,7,5.666667,5.8,2.540009,-2.540009,0,0,5.080002,-5.080002,22,252,20,34,-14,14,-0.133333683013916,0.133333683013916,4,2,0,0,2,-2,0,0,168,147,21,-21
Marc Diakiese,Drakkar Klose,Drakkar Klose,2017-07-07,0,1,-5,5,2.285714,6.5,2.540009,-2.540009,0,0,7.619995,-7.619995,190,320,23,15,8,-8,-4.21428561210632,4.21428561210632,3,0,0,0,3,-3,0,0,111,0,111,-111
Bobby Green,Drakkar Klose,Drakkar Klose,2018-12-15,0,1,2,-2,2.142857,6.5,2.540009,-2.540009,0,0,2.539993,-2.539993,221,55,44,15,29,-29,-4.35714292526245,4.35714292526245,1,1,1,0,0,0,1,-1,322,526,-204,204
Christos Giagos,Drakkar Klose,Drakkar Klose,2019-08-17,0,1,-2,2,1.818182,6.5,2.540009,-2.540009,0,0,2.539993,-2.539993,199,223,31,15,16,-16,-4.68181812763214,4.68181812763214,2,2,0,0,0,0,0,0,77,245,-168,168
Beneil Dariush,Drakkar Klose,Beneil Dariush,2020-03-07,1,0,-1,1,4.4,6.5,2.540009,-2.540009,0,0,5.080002,-5.080002,261,0,27,15,12,-12,-2.09999990463257,2.09999990463257,2,3,2,0,-1,1,2,-2,364,203,161,-161
Brandon Jenkins,Drakkar Klose,Drakkar Klose,2022-04-16,0,1,-4,4,1.666667,6.5,7.62001,-7.62001,0,0,2.539993,-2.539993,10,115,24,15,9,-9,-4.83333337306976,4.83333337306976,0,0,0,1,0,0,-1,1,0,770,-770,770
Rafa Garcia,Drakkar Klose,Drakkar Klose,2022-07-30,0,1,-7,7,5.333333,6.5,-5.080002,5.080002,0,0,0,0,174,125,19,15,4,-4,-1.16666650772095,1.16666650772095,2,1,0,1,1,-1,-1,1,105,105,0,0
Vince Morales,Drako Rodriguez,Vince Morales,2021-08-07,1,0,5,-5,1.571429,2.333333,2.539993,-2.539993,0,0,2.540009,-2.540009,40,74,18,10,8,-8,-0.761904716491699,0.761904716491699,1,0,0,0,1,-1,0,0,826,0,826,-826
Olivier Aubin-Mercier,Drew Dober,Olivier Aubin-Mercier,2016-12-10,1,0,-1,1,2.2,2.166667,2.539993,-2.539993,0,0,0,0,93,72,16,38,-22,22,3.33333015441895e-02,-3.33333015441895e-02,1,0,0,0,1,-1,0,0,175,0,175,-175
Joshua Burkman,Drew Dober,Drew Dober,2017-07-29,0,1,9,-9,1.75,2.166667,5.080002,-5.080002,15,-15,5.080002,-5.080002,0,67,44,38,6,-6,-0.416666746139526,0.416666746139526,0,0,1,0,0,0,1,-1,140,231,-91,91
Frank Camacho,Drew Dober,Drew Dober,2018-01-27,0,1,-1,1,2.2,2.166667,5.080002,-5.080002,0,0,7.619995,-7.619995,184,25,32,38,-6,6,3.33333015441895e-02,-3.33333015441895e-02,0,1,0,0,-1,1,0,0,224,182,42,-42
Beneil Dariush,Drew Dober,Beneil Dariush,2019-03-09,1,0,-1,1,4.4,2.166667,5.080002,-5.080002,0,0,5.080002,-5.080002,317,61,27,38,-11,11,2.23333334922791,-2.23333334922791,1,2,2,0,-1,1,2,-2,119,406,-287,287
Rafael Alves,Drew Dober,Drew Dober,2022-07-30,0,1,-2,2,1.666667,2.166667,0,0,0,0,-5.080002,5.080002,141,4,32,38,-6,6,-0.50000011920929,0.50000011920929,1,0,0,0,1,-1,0,0,259,1239,-980,980
Nick Diaz,Drew Fickett,Nick Diaz,2005-02-05,1,0,-4,4,2.6,2,7.619995,-7.619995,15,-15,15.23999,-15.23999,146,101,36,63,-27,27,0.599999904632568,-0.599999904632568,0,0,0,0,0,0,0,0,168,0,168,-168
Joshua Burkman,Drew Fickett,Joshua Burkman,2006-01-16,1,0,-1,1,1.75,2,0,0,15,-15,5.080002,-5.080002,27,7,44,63,-19,19,-0.25,0.25,1,0,0,1,1,-1,-1,1,72,345,-273,273
Martin Kampmann,Drew McFedries,Martin Kampmann,2007-03-03,1,0,-4,4,2.857143,1.714286,0,0,-15,15,0,0,122,11,27,19,8,-8,1.14285719394684,-1.14285719394684,2,0,0,0,2,-2,0,0,112,0,112,-112
Patrick Cote,Drew McFedries,Patrick Cote,2008-01-23,1,0,-2,2,2.090909,1.714286,-2.540009,2.540009,-15,15,7.619995,-7.619995,3,0,34,19,15,-15,0.376623272895813,-0.376623272895813,2,0,0,0,2,-2,0,0,151,326,-175,175
Marvin Eastman,Drew McFedries,Drew McFedries,2008-06-21,0,1,8,-8,1.2,1.714286,-7.62001,7.62001,0,0,2.539993,-2.539993,12,5,33,19,14,-14,-0.514285683631897,0.514285683631897,1,0,2,1,1,-1,1,-1,140,150,-10,10
Mike Massenzio,Drew McFedries,Mike Massenzio,2008-09-17,1,0,-5,5,1.444444,1.714286,5.080002,-5.080002,0,0,2.539993,-2.539993,81,0,22,19,3,-3,-0.269841313362122,0.269841313362122,0,1,0,1,-1,1,-1,1,0,88,-88,88
Thales Leites,Drew McFedries,Thales Leites,2008-10-25,1,0,-3,3,3.111111,1.714286,2.539993,-2.539993,0,0,15.23999,-15.23999,63,0,37,19,18,-18,1.3968254327774,-1.3968254327774,3,0,0,1,3,-3,-1,1,140,38,102,-102
Xavier Foupa-Pokam,Drew McFedries,Drew McFedries,2009-05-23,0,1,-4,4,1.454545,1.714286,2.539993,-2.539993,0,0,5.119995,-5.119995,0,10,54,19,35,-35,-0.259740233421326,0.259740233421326,0,0,0,1,0,0,-1,1,35,210,-175,175
Tomasz Drwal,Drew McFedries,Tomasz Drwal,2009-09-19,1,0,-4,4,4.2,1.714286,2.539993,-2.539993,20,-20,10.15999,-10.15999,155,0,26,19,7,-7,2.48571407794952,-2.48571407794952,1,1,1,1,0,0,0,0,245,119,126,-126
Derek Brunson,Dricus Du Plessis,Dricus Du Plessis,2023-03-04,0,1,10,-10,2.555556,10,0,0,0,0,2.540009,-2.540009,150,85,32,22,10,-10,-7.44444441795349,7.44444441795349,0,0,4,0,0,0,4,-4,385,0,385,-385
Jonathan Goulet,Duane Ludwig,Duane Ludwig,2006-01-16,0,1,-1,1,1.916667,1.5,5.080002,-5.080002,0,0,7.619995,-7.619995,0,1,35,35,0,0,0.416666626930237,-0.416666626930237,1,0,0,0,1,-1,0,0,105,0,105,-105
Darren Elkins,Duane Ludwig,Darren Elkins,2010-03-21,1,0,-6,6,2.454545,1.5,0,0,-25,25,2.539993,-2.539993,10,3,38,35,3,-3,0.954545497894287,-0.954545497894287,0,1,0,0,-1,1,0,0,0,1525,-1525,1525
Dan Hardy,Duane Ludwig,Dan Hardy,2012-05-26,1,0,-3,3,2.5,1.5,5.080002,-5.080002,0,0,10.16,-10.16,88,0,35,35,0,0,1,-1,0,0,0,1,0,0,-1,1,286,797,-511,511
Bea Malecki,Duda Santana,Bea Malecki,2019-06-01,1,0,4,-4,4,3,5.080002,-5.080002,-10,10,2.540009,-2.540009,69,155,5,4,1,-1,1,-1,0,0,0,0,0,0,0,0,0,0,0,0
Punahele Soriano,Dusko Todorovic,Punahele Soriano,2021-01-16,1,0,2,-2,3,3,-5.080002,5.080002,0,0,-5.080002,5.080002,38,4,12,16,-4,4,0,0,0,0,0,0,0,0,0,0,0,0,0,0
Gregory Rodrigues,Dusko Todorovic,Gregory Rodrigues,2021-06-05,1,0,2,-2,2.8,3,5.080002,-5.080002,0,0,2.539993,-2.539993,85,86,19,16,3,-3,-0.200000047683716,0.200000047683716,0,0,0,1,0,0,-1,1,0,140,-140,140
Maki Pitolo,Dusko Todorovic,Dusko Todorovic,2021-12-04,0,1,4,-4,1.444444,3,-7.619995,7.619995,0,0,2.539993,-2.539993,0,166,22,16,6,-6,-1.55555558204651,1.55555558204651,0,0,0,1,0,0,-1,1,483,182,301,-301
Chidi Njokuani,Dusko Todorovic,Chidi Njokuani,2022-05-21,1,0,5,-5,2.2,3,5.080002,-5.080002,0,0,15.23999,-15.23999,50,193,32,16,16,-16,-0.799999952316284,0.799999952316284,0,1,0,1,-1,1,-1,1,0,168,-168,168
Christian Leroy Duncan,Dusko Todorovic,Christian Leroy Duncan,2023-03-18,1,0,-1,1,8,3,2.540009,-2.540009,0,0,12.7,-12.7,38,0,9,16,-7,7,5,-5,0,0,0,2,0,0,-2,2,0,301,-301,301
Tony DeSouza,Dustin Hazelett,Tony DeSouza,2006-10-10,1,0,12,-12,2.75,1.714286,-2.539993,2.539993,0,0,-15.23999,15.23999,219,0,15,19,-4,4,1.03571426868439,-1.03571426868439,0,0,1,0,0,0,1,-1,1838,0,1838,-1838
Jonathan Goulet,Dustin Hazelett,Dustin Hazelett,2007-09-19,0,1,7,-7,1.916667,1.714286,-2.539993,2.539993,0,0,-7.619995,7.619995,48,0,35,19,16,-16,0.202380895614624,-0.202380895614624,0,0,2,0,0,0,2,-2,398,344,54,-54
Joshua Burkman,Dustin Hazelett,Dustin Hazelett,2008-06-21,0,1,6,-6,1.75,1.714286,-7.619995,7.619995,0,0,-10.15999,10.15999,224,42,44,19,25,-25,3.57142686843872e-02,-3.57142686843872e-02,0,1,0,0,-1,1,0,0,150,276,-126,126
Paul Daley,Dustin Hazelett,Paul Daley,2010-01-02,1,0,3,-3,2.6,1.714286,-10.16,10.16,0,0,0,0,3,0,54,19,35,-35,0.885714173316956,-0.885714173316956,1,2,0,0,-1,1,0,0,105,560,-455,455
Mark Bocek,Dustin Hazelett,Mark Bocek,2010-12-11,1,0,5,-5,2.4,1.714286,-12.7,12.7,-15,15,-2.539993,2.539993,108,32,17,19,-2,2,0.685714364051819,-0.685714364051819,0,0,1,1,0,0,0,0,259,343,-84,84
Chris Camozzi,Dustin Jacoby,Chris Camozzi,2012-01-28,1,0,2,-2,1.846154,2.714286,-2.539993,2.539993,-20,20,-2.539993,2.539993,6,0,37,26,11,-11,-0.868131756782532,0.868131756782532,0,0,0,0,0,0,0,0,91,0,91,-91
Maxim Grishin,Dustin Jacoby,Dustin Jacoby,2021-02-27,0,1,4,-4,3.2,2.714286,0,0,0,0,5.080002,-5.080002,76,48,42,26,16,-16,0.485714435577393,-0.485714435577393,0,0,0,0,0,0,0,0,231,3318,-3087,3087
John Allan,Dustin Jacoby,Dustin Jacoby,2021-11-06,0,1,-5,5,1.857143,2.714286,-5.080002,5.080002,0,0,-2.539993,2.539993,0,0,20,26,-6,6,-0.857142806053162,0.857142806053162,0,1,0,0,-1,1,0,0,336,252,84,-84
Chico Camus,Dustin Kimura,Dustin Kimura,2013-02-02,0,1,5,-5,2.428571,3.666667,-2.539993,2.539993,-10,10,-12.7,12.7,378,56,24,14,10,-10,-1.2380952835083,1.2380952835083,1,0,0,0,1,-1,0,0,175,0,175,-175
Mitch Gagnon,Dustin Kimura,Mitch Gagnon,2013-09-21,1,0,4,-4,2.4,3.666667,-5.079987,5.079987,0,0,-15.23999,15.23999,41,11,17,14,3,-3,-1.26666665077209,1.26666665077209,1,1,0,0,0,0,0,0,364,231,133,-133
Jon Delos Reyes,Dustin Kimura,Dustin Kimura,2014-01-04,0,1,2,-2,1.6,3.666667,-2.539993,2.539993,-10,10,-10.16,10.16,94,0,13,14,-1,1,-2.06666672229767,2.06666672229767,0,0,0,0,0,0,0,0,0,105,-105,105
Henry Cejudo,Dustin Kimura,Henry Cejudo,2014-12-13,1,0,2,-2,5.333333,3.666667,-7.619995,7.619995,0,0,-17.78,17.78,20,0,19,14,5,-5,1.66666674613953,-1.66666674613953,0,1,0,0,-1,1,0,0,0,343,-343,343
Bryan Caraway,Dustin Neace,Bryan Caraway,2011-12-03,1,0,2,-2,2.333333,1.190476,-2.539993,2.539993,-10,10,-5.279999,5.279999,185,55,30,46,-16,16,1.14285707473755,-1.14285707473755,0,0,0,0,0,0,0,0,0,0,0,0
Jose Maria,Dustin Ortiz,Dustin Ortiz,2013-11-09,0,1,7,-7,5.285714,2.375,0,0,0,0,4.899994,-4.899994,96,338,44,27,17,-17,2.9107141494751,-2.9107141494751,0,0,0,0,0,0,0,0,0,0,0,0
John Moraga,Dustin Ortiz,John Moraga,2014-01-15,1,0,4,-4,2.714286,2.375,2.539993,-2.539993,0,0,2.539993,-2.539993,108,430,26,27,-1,1,0.339285612106323,-0.339285612106323,0,1,0,0,-1,1,0,0,0,67,-67,67
Ray Borg,Dustin Ortiz,Dustin Ortiz,2014-04-19,0,1,-5,5,2.6,2.375,-2.540009,2.540009,10,-10,-5.080002,5.080002,360,323,18,27,-9,9,0.224999904632568,-0.224999904632568,0,0,0,0,0,0,0,0,0,94,-94,94
Joseph Benavidez,Dustin Ortiz,Joseph Benavidez,2014-11-22,1,0,5,-5,3.5,2.375,-2.540009,2.540009,0,0,0,0,147,44,36,27,9,-9,1.125,-1.125,1,1,1,0,0,0,1,-1,210,217,-7,7
Willie Gates,Dustin Ortiz,Dustin Ortiz,2015-08-08,0,1,2,-2,1.714286,2.375,7.619995,-7.619995,0,0,17.78,-17.78,0,647,19,27,-8,8,-0.660714268684387,0.660714268684387,1,0,0,0,1,-1,0,0,27,259,-232,232
Jussier Formiga,Dustin Ortiz,Jussier Formiga,2016-09-24,1,0,4,-4,2.875,2.375,0,0,0,0,5.079987,-5.079987,549,177,31,27,4,-4,0.5,-0.5,3,1,0,0,2,-2,0,0,483,413,70,-70
Zach Makovsky,Dustin Ortiz,Dustin Ortiz,2016-12-10,0,1,6,-6,2.5,2.375,-2.540009,2.540009,0,0,-2.540009,2.540009,127,490,28,27,1,-1,0.125,-0.125,1,0,0,0,1,-1,0,0,1022,77,945,-945
Brandon Moreno,Dustin Ortiz,Brandon Moreno,2017-04-22,1,0,-5,5,3,2.375,5.079987,-5.079987,0,0,12.7,-12.7,102,287,28,27,1,-1,0.625,-0.625,1,1,0,0,0,0,0,0,203,133,70,-70
Matheus Nicolau,Dustin Ortiz,Dustin Ortiz,2018-07-28,0,1,-4,4,4.75,2.375,2.539993,-2.539993,0,0,2.539993,-2.539993,0,4,23,27,-4,4,2.375,-2.375,1,0,0,0,1,-1,0,0,210,462,-252,252
Joseph Benavidez,Dustin Ortiz,Joseph Benavidez,2019-01-19,1,0,4,-4,3.5,2.375,-2.540009,2.540009,0,0,0,0,410,183,36,27,9,-9,1.125,-1.125,1,1,1,0,0,0,1,-1,50,175,-125,125
John Albert,Dustin Pague,John Albert,2011-12-03,1,0,1,-1,1.2,1.090909,-2.539993,2.539993,0,0,-15.24001,15.24001,47,0,11,23,-12,12,0.109090924263,-0.109090924263,0,0,0,0,0,0,0,0,0,0,0,0
Chico Camus,Dustin Pague,Chico Camus,2012-08-11,1,0,2,-2,2.428571,1.090909,-7.619995,7.619995,-10,10,-20.32001,20.32001,652,136,24,23,1,-1,1.33766233921051,-1.33766233921051,0,0,0,1,0,0,-1,1,0,252,-252,252
Yves Jabouin,Dustin Pague,Yves Jabouin,2013-06-15,1,0,9,-9,1.818182,1.090909,-5.080002,5.080002,0,0,-15.24001,15.24001,486,286,31,23,8,-8,0.727272748947144,-0.727272748947144,0,0,1,1,0,0,0,0,259,308,-49,49
Kyoji Horiguchi,Dustin Pague,Kyoji Horiguchi,2013-10-19,1,0,-3,3,9.5,1.090909,-10.15999,10.15999,-10,10,-20.32001,20.32001,233,209,21,23,-2,2,8.40909087657928,-8.40909087657928,0,0,0,1,0,0,-1,1,0,126,-126,126
Josh Grispi,Dustin Poirier,Dustin Poirier,2011-01-01,0,1,1,-1,2.8,3.625,5.080002,-5.080002,-10,10,5.080002,-5.080002,162,469,19,37,-18,18,-0.825000047683716,0.825000047683716,0,0,0,0,0,0,0,0,0,0,0,0
Pablo Garza,Dustin Poirier,Dustin Poirier,2011-11-12,0,1,6,-6,3,3.625,10.16,-10.16,-10,10,2.539993,-2.539993,0,175,16,37,-21,21,-0.625,0.625,2,1,0,0,1,-1,0,0,196,315,-119,119
Max Holloway,Dustin Poirier,Dustin Poirier,2012-02-04,0,1,-3,3,3.571429,3.625,5.080002,-5.080002,-10,10,-7.62001,7.62001,7,89,32,37,-5,5,-5.35714626312256e-02,5.35714626312256e-02,0,2,0,0,-2,2,0,0,0,84,-84,84
Jonathan Brookins,Dustin Poirier,Dustin Poirier,2012-12-15,0,1,4,-4,1.6,3.625,7.62001,-7.62001,-10,10,5.080002,-5.080002,27,69,26,37,-11,11,-2.02499997615814,2.02499997615814,0,3,0,0,-3,3,0,0,197,315,-118,118
Erik Koch,Dustin Poirier,Dustin Poirier,2013-08-31,0,1,0,0,2.666667,3.625,2.540009,-2.540009,15,-15,-2.540009,2.540009,209,451,22,37,-15,15,-0.958333253860474,0.958333253860474,0,4,1,0,-4,4,1,-1,217,259,-42,42
Diego Brandao,Dustin Poirier,Dustin Poirier,2013-12-28,0,1,2,-2,2,3.625,-5.080002,5.080002,-10,10,-20.32001,20.32001,12,33,33,37,-4,4,-1.625,1.625,3,5,0,0,-2,2,0,0,133,119,14,-14
Akira Corassani,Dustin Poirier,Dustin Poirier,2014-04-16,0,1,6,-6,2,3.625,-2.539993,2.539993,-10,10,-10.16,10.16,12,44,18,37,-19,19,-1.625,1.625,2,6,0,0,-4,4,0,0,375,109,266,-266
Conor McGregor,Dustin Poirier,Conor McGregor,2014-09-27,1,0,1,-1,3.666667,3.625,0,0,0,0,5.080002,-5.080002,3,0,28,37,-9,9,4.16667461395264e-02,-4.16667461395264e-02,0,7,0,0,-7,7,0,0,0,164,-164,164
Diego Ferreira,Dustin Poirier,Dustin Poirier,2015-04-04,0,1,4,-4,3.6,3.625,0,0,0,0,5.080002,-5.080002,58,46,23,37,-14,14,-2.50000953674316e-02,2.50000953674316e-02,2,0,0,1,2,-2,-1,1,217,189,28,-28
Yancy Medeiros,Dustin Poirier,Dustin Poirier,2015-06-06,0,1,1,-1,1.875,3.625,2.540009,-2.540009,0,0,7.619995,-7.619995,87,0,23,37,-14,14,-1.75,1.75,1,1,0,1,0,0,-1,1,176,63,113,-113
Joe Duffy,Dustin Poirier,Dustin Poirier,2016-01-02,0,1,1,-1,3.2,3.625,2.540009,-2.540009,0,0,2.539993,-2.539993,8,563,21,37,-16,16,-0.424999952316284,0.424999952316284,2,2,0,1,0,0,-1,1,168,210,-42,42
Bobby Green,Dustin Poirier,Dustin Poirier,2016-06-04,0,1,2,-2,2.142857,3.625,2.540009,-2.540009,0,0,-2.540009,2.540009,0,16,44,37,7,-7,-1.48214292526245,1.48214292526245,4,3,0,1,1,-1,-1,1,679,154,525,-525
Michael Johnson,Dustin Poirier,Michael Johnson,2016-09-17,1,0,3,-3,1.157895,3.625,2.540009,-2.540009,0,0,2.539993,-2.539993,3,0,41,37,4,-4,-2.46710526943207,2.46710526943207,2,4,0,1,-2,2,-1,1,994,105,889,-889
Jim Miller,Dustin Poirier,Dustin Poirier,2017-02-11,0,1,5,-5,2.117647,3.625,-2.539993,2.539993,0,0,-2.540009,2.540009,82,237,53,37,16,-16,-1.50735282897949,1.50735282897949,0,0,0,2,0,0,-2,2,343,147,196,-196
Anthony Pettis,Dustin Poirier,Dustin Poirier,2017-11-11,0,1,2,-2,2.4,3.625,2.540009,-2.540009,0,0,0,0,96,411,34,37,-3,3,-1.22499990463257,1.22499990463257,1,1,0,2,0,0,-2,2,2226,273,1953,-1953
Justin Gaethje,Dustin Poirier,Dustin Poirier,2018-04-14,0,1,0,0,6.25,3.625,5.080002,-5.080002,0,0,-5.080002,5.080002,64,6,29,37,-8,8,2.625,-2.625,1,2,0,2,-1,1,-2,2,281,154,127,-127
Eddie Alvarez,Dustin Poirier,Dustin Poirier,2018-07-28,0,1,5,-5,4.833333,3.625,0,0,0,0,-7.62001,7.62001,148,5,35,37,-2,2,1.20833349227905,-1.20833349227905,1,3,1,2,-2,2,-1,1,238,105,133,-133
Max Holloway,Dustin Poirier,Dustin Poirier,2019-04-13,0,1,-3,3,3.571429,3.625,5.080002,-5.080002,-10,10,-7.62001,7.62001,6,215,32,37,-5,5,-5.35714626312256e-02,5.35714626312256e-02,7,4,0,2,3,-3,-2,2,126,259,-133,133
Khabib Nurmagomedov,Dustin Poirier,Khabib Nurmagomedov,2019-09-07,1,0,0,0,29,3.625,2.540009,-2.540009,0,0,-5.080002,5.080002,532,0,29,37,-8,8,25.375,-25.375,4,5,0,2,-1,1,-2,2,2296,147,2149,-2149
Dan Hooker,Dustin Poirier,Dustin Poirier,2020-06-27,0,1,-1,1,1.916667,3.625,7.62001,-7.62001,0,0,7.619995,-7.619995,362,169,35,37,-2,2,-1.70833337306976,1.70833337306976,4,0,0,2,4,-4,-2,2,266,294,-28,28
Conor McGregor,Dustin Poirier,Dustin Poirier,2021-01-23,0,1,0,0,3.666667,3.625,0,0,0,0,5.080002,-5.080002,67,102,28,37,-9,9,4.16667461395264e-02,-4.16667461395264e-02,0,1,0,2,-1,1,-2,2,840,210,630,-630
Conor McGregor,Dustin Poirier,Dustin Poirier,2021-07-10,0,1,0,0,3.666667,3.625,0,0,0,0,5.080002,-5.080002,0,198,28,37,-9,9,4.16667461395264e-02,-4.16667461395264e-02,0,2,1,2,-2,2,-1,1,168,168,0,0
Charles Oliveira,Dustin Poirier,Charles Oliveira,2021-12-11,1,0,0,0,3.777778,3.625,2.540009,-2.540009,0,0,5.080002,-5.080002,341,35,43,37,6,-6,0.152777671813965,-0.152777671813965,1,3,1,2,-2,2,-1,1,1043,154,889,-889
Michael Chandler,Dustin Poirier,Dustin Poirier,2022-11-12,0,1,3,-3,2.875,3.625,-2.539993,2.539993,0,0,-2.540009,2.540009,339,47,31,37,-6,6,-0.75,0.75,1,0,1,2,1,-1,-1,1,189,336,-147,147
Justin Gaethje,Dustin Poirier,Justin Gaethje,2023-07-29,1,0,0,0,6.25,3.625,5.080002,-5.080002,0,0,-5.080002,5.080002,0,0,29,37,-8,8,2.625,-2.625,0,1,1,2,-1,1,-1,1,448,259,189,-189
Kyle Daukaus,Dustin Stoltzfus,Kyle Daukaus,2020-11-21,1,0,-2,2,2.75,2.8,7.619995,-7.619995,0,0,2.539993,-2.539993,520,121,15,19,-4,4,-4.99999523162842e-02,4.99999523162842e-02,0,0,0,0,0,0,0,0,0,0,0,0
Gerald Meerschaert,Dustin Stoltzfus,Gerald Meerschaert,2021-12-18,1,0,4,-4,2.058824,2.8,2.539993,-2.539993,0,0,5.080002,-5.080002,194,447,52,19,33,-33,-0.74117636680603,0.74117636680603,4,0,1,0,4,-4,1,-1,112,392,-280,280
Dwight Grant,Dustin Stoltzfus,Dustin Stoltzfus,2022-07-16,0,1,7,-7,1.833333,2.8,2.539993,-2.539993,0,0,2.539993,-2.539993,0,257,17,19,-2,2,-0.966666579246521,0.966666579246521,0,0,2,0,0,0,2,-2,84,210,-126,126
Abus Magomedov,Dustin Stoltzfus,Abus Magomedov,2022-09-03,1,0,2,-2,5,2.8,5.080002,-5.080002,0,0,7.619995,-7.619995,2,0,30,19,11,-11,2.20000004768372,-2.20000004768372,0,1,0,0,-1,1,0,0,0,49,-49,49
Papy Abedi,Dylan Andrews,Dylan Andrews,2013-08-28,0,1,2,-2,2.5,2.571429,-5.080002,5.080002,0,0,1.23999,-1.23999,312,69,14,25,-11,11,-7.14285373687744e-02,7.14285373687744e-02,1,0,0,0,1,-1,0,0,144,0,144,-144
Sam Alvey,Dylan Andrews,Sam Alvey,2014-11-07,1,0,-6,6,1.833333,2.571429,2.540009,-2.540009,0,0,2.539993,-2.539993,2,81,51,25,26,-26,-0.738095164299011,0.738095164299011,0,1,0,0,-1,1,0,0,83,436,-353,353
Kendall Grove,Ed Herman,Kendall Grove,2006-06-24,1,0,-2,2,1.352941,1.6875,12.7,-12.7,-20,20,5.080002,-5.080002,205,585,40,43,-3,3,-0.334558844566345,0.334558844566345,0,0,0,0,0,0,0,0,0,0,0,0
Joe Doerksen,Ed Herman,Ed Herman,2007-11-17,0,1,3,-3,3.1875,1.6875,-2.539993,2.539993,-20,20,-5.080002,5.080002,114,394,67,43,24,-24,1.5,-1.5,0,0,1,0,0,0,1,-1,623,511,112,-112
Alan Belcher,Ed Herman,Alan Belcher,2008-09-17,1,0,-3,3,2.25,1.6875,2.540009,-2.540009,-20,20,-5.080002,5.080002,144,289,26,43,-17,17,0.5625,-0.5625,0,1,1,0,-1,1,1,-1,151,305,-154,154
Tim Credeur,Ed Herman,Ed Herman,2011-06-04,0,1,3,-3,3,1.6875,5.080002,-5.080002,-20,20,-5.080002,5.080002,0,3,16,43,-27,27,1.3125,-1.3125,0,0,0,0,0,0,0,0,626,990,-364,364
Derek Brunson,Ed Herman,Derek Brunson,2015-01-31,1,0,-3,3,2.555556,1.6875,0,0,-20,20,0,0,5,0,32,43,-11,11,0.868055582046509,-0.868055582046509,1,1,1,0,0,0,1,-1,154,1337,-1183,1183
Tim Boetsch,Ed Herman,Ed Herman,2016-01-17,0,1,-1,1,1.615385,1.6875,-2.539993,2.539993,-20,20,-7.619995,7.619995,8,15,34,43,-9,9,-7.2115421295166e-02,7.2115421295166e-02,0,0,3,1,0,0,2,-2,225,351,-126,126
CB Dollaway,Ed Herman,CB Dollaway,2017-07-07,1,0,-3,3,1.888889,1.6875,2.540009,-2.540009,-20,20,-2.540009,2.540009,570,164,26,43,-17,17,0.201388835906982,-0.201388835906982,0,1,4,1,-1,1,3,-3,566,537,29,-29
Patrick Cummins,Ed Herman,Ed Herman,2019-05-18,0,1,0,0,1.428571,1.6875,2.540009,-2.540009,0,0,-2.540009,2.540009,10,4,17,43,-26,26,-0.258928537368774,0.258928537368774,1,0,3,1,1,-1,2,-2,665,680,-15,15
Zak Cummings,Ed Herman,Zak Cummings,2023-04-15,1,0,-4,4,3.571429,1.6875,-2.539993,2.539993,0,0,-5.080002,5.080002,198,0,32,43,-11,11,1.88392853736877,-1.88392853736877,3,1,0,1,2,-2,-1,1,959,1428,-469,469
Chris Dempsey,Eddie Gordon,Chris Dempsey,2015-04-18,1,0,-4,4,2.2,2,-5.080002,5.080002,0,0,-10.15999,10.15999,197,249,16,12,4,-4,0.200000047683716,-0.200000047683716,0,0,1,0,0,0,1,-1,273,0,273,-273
Antonio Carlos Junior,Eddie Gordon,Antonio Carlos Junior,2015-06-27,1,0,-6,6,2.2,2,5.080002,-5.080002,0,0,7.62001,-7.62001,441,149,16,12,4,-4,0.200000047683716,-0.200000047683716,0,0,0,0,0,0,0,0,189,70,119,-119
Yves Edwards,Eddie Ruiz,Yves Edwards,2003-06-06,1,0,-9,9,1.909091,1,5.080002,-5.080002,0,0,12.42,-12.42,419,285,64,2,62,-62,0.909090876579285,-0.909090876579285,1,0,0,0,1,-1,0,0,349,0,349,-349
Mario Neto,Eddie Sanchez,Eddie Sanchez,2006-09-23,0,1,,,2.6,1.875,-5.080002,5.080002,-1,1,5.039993,-5.039993,119,61,18,23,-5,5,0.724999904632568,-0.724999904632568,0,0,0,0,0,0,0,0,0,0,0,0
Mirko Filipovic,Eddie Sanchez,Mirko Filipovic,2007-02-03,1,0,8,-8,3.181818,1.875,0,0,0,0,-2.540009,2.540009,57,0,46,23,23,-23,1.30681824684143,-1.30681824684143,0,1,0,0,-1,1,0,0,0,133,-133,133
Colin Robinson,Eddie Sanchez,Eddie Sanchez,2007-06-16,0,1,14,-14,0.8333333,1.875,5.079987,-5.079987,13,-13,5.039993,-5.039993,135,143,22,23,-1,1,-1.04166668653488,1.04166668653488,0,0,0,1,0,0,-1,1,0,133,-133,133
Soa Palelei,Eddie Sanchez,Eddie Sanchez,2007-12-29,0,1,5,-5,4.4,1.875,5.079987,-5.079987,35,-35,17.78,-17.78,349,201,27,23,4,-4,2.52500009536743,-2.52500009536743,0,1,0,1,-1,1,-1,1,0,196,-196,196
Antoni Hardonk,Eddie Sanchez,Antoni Hardonk,2008-06-07,1,0,7,-7,1.333333,1.875,5.079987,-5.079987,15,-15,10.15999,-10.15999,43,291,14,23,-9,9,-0.541666626930237,0.541666626930237,1,2,0,1,-1,1,-1,1,140,161,-21,21
Justin McCully,Eddie Sanchez,Justin McCully,2008-12-10,1,0,6,-6,2.2,1.875,-2.540009,2.540009,-5,5,-2.540009,2.540009,394,136,16,23,-7,7,0.325000047683716,-0.325000047683716,0,0,0,2,0,0,-2,2,0,186,-186,186
Urijah Faber,Eddie Wineland,Urijah Faber,2011-03-19,1,0,5,-5,3.181818,1.5,-2.539993,2.539993,0,0,-5.080002,5.080002,306,103,46,40,6,-6,1.68181824684143,-1.68181824684143,0,0,0,0,0,0,0,0,0,0,0,0
Joseph Benavidez,Eddie Wineland,Joseph Benavidez,2011-08-14,1,0,0,0,3.5,1.5,-7.619995,7.619995,-10,10,-10.15999,10.15999,9,20,36,40,-4,4,2,-2,1,0,0,0,1,-1,0,0,148,148,0,0
Scott Jorgensen,Eddie Wineland,Eddie Wineland,2012-06-08,0,1,2,-2,1.25,1.5,-5.079987,5.079987,0,0,-7.619995,7.619995,0,24,27,40,-13,13,-0.25,0.25,1,0,0,0,1,-1,0,0,370,299,71,-71
Brad Pickett,Eddie Wineland,Eddie Wineland,2012-12-29,0,1,6,-6,1.785714,1.5,-2.539993,2.539993,0,0,-2.539993,2.539993,2,0,39,40,-1,1,0.285714268684387,-0.285714268684387,0,1,0,0,-1,1,0,0,0,204,-204,204
Renan Barao,Eddie Wineland,Renan Barao,2013-09-21,1,0,-3,3,3.777778,1.5,-2.539993,2.539993,10,-10,2.540009,-2.540009,5,19,43,40,3,-3,2.27777767181396,-2.27777767181396,5,2,0,0,3,-3,0,0,217,266,-49,49
Yves Jabouin,Eddie Wineland,Eddie Wineland,2014-01-25,0,1,5,-5,1.818182,1.5,0,0,0,0,-2.539993,2.539993,0,75,31,40,-9,9,0.318181872367859,-0.318181872367859,1,0,1,1,1,-1,0,0,224,126,98,-98
Johnny Eduardo,Eddie Wineland,Johnny Eduardo,2014-05-10,1,0,6,-6,2.153846,1.5,0,0,0,0,5.080002,-5.080002,2,0,41,40,1,-1,0.653846263885498,-0.653846263885498,0,1,0,1,-1,1,-1,1,0,105,-105,105
Bryan Caraway,Eddie Wineland,Bryan Caraway,2015-07-25,1,0,-1,1,2.333333,1.5,2.540009,-2.540009,0,0,-2.539993,2.539993,73,3,30,40,-10,10,0.833333253860474,-0.833333253860474,1,0,0,2,1,-1,-2,2,413,441,-28,28
Frankie Saenz,Eddie Wineland,Eddie Wineland,2016-07-23,0,1,3,-3,1.857143,1.5,-2.539993,2.539993,0,0,-7.619995,7.619995,82,5,20,40,-20,20,0.357142806053162,-0.357142806053162,1,0,0,2,1,-1,-2,2,707,364,343,-343
Takeya Mizugaki,Eddie Wineland,Eddie Wineland,2016-12-17,0,1,1,-1,1.909091,1.5,0,0,0,0,0,0,0,6,32,40,-8,8,0.409090876579285,-0.409090876579285,1,1,0,2,0,0,-2,2,448,147,301,-301
John Dodson,Eddie Wineland,John Dodson,2017-04-22,1,0,0,0,1.833333,1.5,-10.15999,10.15999,0,0,-7.619995,7.619995,0,0,34,40,-6,6,0.333333373069763,-0.333333373069763,0,2,0,2,-2,2,-2,2,203,126,77,-77
Alejandro Perez,Eddie Wineland,Alejandro Perez,2018-07-14,1,0,-6,6,2.555556,1.5,-2.539993,2.539993,0,0,-5.080002,5.080002,3,7,32,40,-8,8,1.05555558204651,-1.05555558204651,1,0,0,2,1,-1,-2,2,343,448,-105,105
Grigory Popov,Eddie Wineland,Eddie Wineland,2019-06-08,0,1,1,-1,4.333333,1.5,0,0,0,0,-2.539993,2.539993,0,16,16,40,-24,24,2.83333349227905,-2.83333349227905,0,0,0,2,0,0,-2,2,0,329,-329,329
"Sean O'Malley",Eddie Wineland,"Sean O'Malley",2020-06-06,1,0,-10,10,17,1.5,10.16,-10.16,0,0,7.62001,-7.62001,0,0,18,40,-22,22,15.5,-15.5,3,1,0,2,2,-2,-2,2,91,364,-273,273
John Castaneda,Eddie Wineland,John Castaneda,2021-02-20,1,0,-7,7,3.333333,1.5,-2.539993,2.539993,0,0,5.080002,-5.080002,4,12,26,40,-14,14,1.83333325386047,-1.83333325386047,0,0,0,3,0,0,-3,3,210,259,-49,49
Cody Stamann,Eddie Wineland,Cody Stamann,2022-06-18,1,0,-5,5,3.5,1.5,-2.539993,2.539993,0,0,-12.7,12.7,7,0,27,40,-13,13,2,-2,0,0,0,4,0,0,-4,4,1379,483,896,-896
Junior Assuncao,Eddie Yagin,Junior Assuncao,2011-09-24,1,0,-2,2,2.666667,2.285714,5.080002,-5.080002,0,0,9.880005,-9.880005,426,15,22,23,-1,1,0.38095235824585,-0.38095235824585,0,0,0,0,0,0,0,0,1466,0,1466,-1466
Mark Hominick,Eddie Yagin,Eddie Yagin,2012-04-21,0,1,-4,4,1.666667,2.285714,2.540009,-2.540009,0,0,-0.2799988,0.2799988,0,88,32,23,9,-9,-0.61904776096344,0.61904776096344,0,0,1,0,0,0,1,-1,133,210,-77,77
Brad Blackburn,Edgar Garcia,Brad Blackburn,2009-06-20,1,0,7,-7,1.384615,2.8,0,0,0,0,5.080002,-5.080002,6,7,31,19,12,-12,-1.41538453102112,1.41538453102112,2,0,0,0,2,-2,0,0,175,0,175,-175
Luke Cummo,Edilberto de Oliveira,Luke Cummo,2007-09-19,1,0,3,-3,1,1.933333,0,0,0,0,1.960007,-1.960007,2,0,12,44,-32,32,-0.933333277702332,0.933333277702332,1,0,0,0,1,-1,0,0,165,0,165,-165
Felipe Arantes,Edimilson Souza,Edimilson Souza,2013-09-04,0,1,-3,3,1.8,3,-10.16,10.16,-10,10,-2.540009,2.540009,309,0,28,20,8,-8,-1.20000004768372,1.20000004768372,2,0,0,0,2,-2,0,0,88,0,88,-88
Mark Eddiva,Edimilson Souza,Edimilson Souza,2014-05-31,0,1,-1,1,2,3,-10.16,10.16,0,0,-15.24001,15.24001,108,0,9,20,-11,11,-1,1,1,1,0,0,0,0,0,0,91,269,-178,178
Katsunori Kikuno,Edimilson Souza,Edimilson Souza,2015-03-21,0,1,3,-3,3,3,-10.16,10.16,0,0,-20.32001,20.32001,0,2,32,20,12,-12,0,0,2,2,0,0,0,0,0,0,182,294,-112,112
Chas Skelly,Edimilson Souza,Chas Skelly,2015-11-07,1,0,-1,1,6.333333,3,-2.540009,2.540009,0,0,-5.080002,5.080002,167,128,22,20,2,-2,3.33333349227905,-3.33333349227905,1,3,0,0,-2,2,0,0,428,231,197,-197
Charles Byrd,Edmen Shahbazyan,Edmen Shahbazyan,2019-03-02,0,1,14,-14,1.428571,3,-10.16,10.16,0,0,-5.080002,5.080002,3,2,17,16,1,-1,-1.57142853736877,1.57142853736877,0,0,1,0,0,0,1,-1,175,0,175,-175
Jack Marshman,Edmen Shahbazyan,Edmen Shahbazyan,2019-07-06,0,1,8,-8,2.3,3,-5.080002,5.080002,0,0,-5.080002,5.080002,0,33,33,16,17,-17,-0.700000047683716,0.700000047683716,1,1,1,0,0,0,1,-1,112,126,-14,14
Derek Brunson,Edmen Shahbazyan,Derek Brunson,2020-08-01,1,0,14,-14,2.555556,3,-2.540009,2.540009,0,0,5.080002,-5.080002,186,3,32,16,16,-16,-0.444444417953491,0.444444417953491,2,2,3,0,0,0,3,-3,350,392,-42,42
Jack Hermansson,Edmen Shahbazyan,Jack Hermansson,2021-05-22,1,0,9,-9,2.875,3,-2.540009,2.540009,0,0,5.080002,-5.080002,431,111,31,16,15,-15,-0.125,0.125,0,0,1,1,0,0,0,0,168,294,-126,126
Nassourdine Imavov,Edmen Shahbazyan,Nassourdine Imavov,2021-11-06,1,0,3,-3,3,3,2.539993,-2.539993,0,0,0,0,236,154,16,16,0,0,0,0,1,0,0,1,1,-1,-1,1,399,168,231,-231
Dalcha Lungiambula,Edmen Shahbazyan,Edmen Shahbazyan,2022-12-10,0,1,10,-10,1.833333,3,-15.24001,15.24001,0,0,2.539993,-2.539993,15,68,17,16,1,-1,-1.16666662693024,1.16666662693024,0,0,1,2,0,0,-1,1,147,399,-252,252
Anthony Hernandez,Edmen Shahbazyan,Anthony Hernandez,2023-05-20,1,0,4,-4,5.5,3,-5.080002,5.080002,0,0,0,0,431,41,13,16,-3,3,2.5,-2.5,1,1,1,2,0,0,-1,1,826,161,665,-665
Gabriel Gonzaga,Ednaldo Oliveira,Gabriel Gonzaga,2012-01-14,1,0,5,-5,1.545455,5.666667,-7.619995,7.619995,37,-37,-4.960007,4.960007,81,0,28,20,8,-8,-4.12121200561523,4.12121200561523,0,0,1,0,0,0,1,-1,448,0,448,-448
Francimar Barroso,Ednaldo Oliveira,Francimar Barroso,2013-08-03,1,0,4,-4,2.714286,5.666667,-10.16,10.16,0,0,-7.5,7.5,220,194,26,20,6,-6,-2.95238089561462,2.95238089561462,0,0,0,0,0,0,0,0,0,567,-567,567
Makwan Amirkhani,Edson Barboza,Edson Barboza,2020-10-10,0,1,-3,3,1.888889,2.090909,-2.539993,2.539993,0,0,-7.619995,7.619995,193,98,26,34,-8,8,-0.202020168304443,0.202020168304443,1,0,1,0,1,-1,1,-1,91,0,91,-91
Humberto Bandenay,Eduardo Garagorri,Eduardo Garagorri,2019-08-10,0,1,-6,6,2,6.5,5.080002,-5.080002,0,0,2.539993,-2.539993,213,129,21,15,6,-6,-4.5,4.5,0,0,1,0,0,0,1,-1,448,0,448,-448
Darren Elkins,Eduardo Garagorri,Darren Elkins,2020-11-07,1,0,5,-5,2.454545,6.5,2.540009,-2.540009,0,0,2.539993,-2.539993,454,10,38,15,23,-23,-4.04545450210571,4.04545450210571,0,1,2,0,-1,1,2,-2,175,455,-280,280
Terry Etim,Edward Faaloloto,Terry Etim,2011-11-05,1,0,-2,2,3.2,0.4,,,0,0,7.619995,-7.619995,0,8,21,7,14,-14,2.80000004172325,-2.80000004172325,2,0,0,0,2,-2,0,0,721,0,721,-721
Alex Caceres,Edwin Figueroa,Edwin Figueroa,2012-02-04,0,1,-4,4,1.5,1.8,7.62001,-7.62001,10,-10,10.16,-10.16,364,140,35,14,21,-21,-0.299999952316284,0.299999952316284,1,0,0,0,1,-1,0,0,84,0,84,-84
Roland Delorme,Edwin Figueroa,Roland Delorme,2013-06-15,1,0,1,-1,1.8,1.8,5.080002,-5.080002,0,0,5.080002,-5.080002,564,214,14,14,0,0,0,0,2,1,0,0,1,-1,0,0,406,497,-91,91
Evan Dunham,Efrain Escudero,Evan Dunham,2010-01-11,1,0,5,-5,2,2.333333,2.540009,-2.540009,0,0,-2.539993,2.539993,210,172,27,40,-13,13,-0.333333253860474,0.333333253860474,1,0,0,0,1,-1,0,0,324,0,324,-324
Mac Danzig,Efrain Escudero,Mac Danzig,2012-04-21,1,0,6,-6,1.75,2.333333,-2.539993,2.539993,0,0,-2.539993,2.539993,334,60,33,40,-7,7,-0.583333253860474,0.583333253860474,0,0,0,0,0,0,0,0,203,831,-628,628
Rodrigo de Lima,Efrain Escudero,Efrain Escudero,2015-02-14,0,1,-6,6,2.666667,2.333333,-5.080002,5.080002,0,0,-7.339996,7.339996,227,371,11,40,-29,29,0.333333492279053,-0.333333492279053,0,0,1,0,0,0,1,-1,231,1029,-798,798
Drew Dober,Efrain Escudero,Efrain Escudero,2015-06-13,0,1,-3,3,2.166667,2.333333,-2.539993,2.539993,0,0,-2.539993,2.539993,0,22,38,40,-2,2,-0.166666507720947,0.166666507720947,1,1,0,0,0,0,0,0,182,119,63,-63
Takanori Gomi,Eiji Mitsuoka,Takanori Gomi,2012-02-25,1,0,-3,3,2.5,2,0,0,10,-10,4.800003,-4.800003,26,88,49,27,22,-22,0.5,-0.5,0,0,0,0,0,0,0,0,420,0,420,-420
Nik Lentz,Eiji Mitsuoka,Nik Lentz,2012-08-11,1,0,-9,9,2.5,2,2.540009,-2.540009,0,0,-0.2799988,0.2799988,174,8,42,27,15,-15,0.5,-0.5,3,0,0,1,3,-3,-1,1,504,168,336,-336
Marcus Bossett,Eldo Xavier Dias,Marcus Bossett,1994-12-16,1,0,,,0.3333333,0,5.080002,-5.080002,35,-35,5,-5,0,0,4,1,3,-3,0.333333343267441,-0.333333343267441,0,0,0,0,0,0,0,0,0,0,0,0
Mark De La Rosa,Elias Garcia,Mark De La Rosa,2018-07-14,1,0,-2,2,2.2,3,2.539993,-2.539993,10,-10,-5.079987,5.079987,133,0,16,8,8,-8,-0.799999952316284,0.799999952316284,0,0,0,0,0,0,0,0,196,0,196,-196
Ernest Chavez,Elias Silverio,Elias Silverio,2014-05-31,0,1,3,-3,5,4.333333,-7.619995,7.619995,-10,10,-7.619995,7.619995,156,38,12,16,-4,4,0.666666507720947,-0.666666507720947,0,0,0,0,0,0,0,0,0,0,0,0
Rashid Magomedov,Elias Silverio,Rashid Magomedov,2014-12-20,1,0,2,-2,10,4.333333,-5.080002,5.080002,0,0,-7.619995,7.619995,61,0,22,16,6,-6,5.66666650772095,-5.66666650772095,1,1,0,0,0,0,0,0,322,203,119,-119
Shane Campbell,Elias Silverio,Shane Campbell,2015-08-23,1,0,0,0,2.333333,4.333333,2.540009,-2.540009,0,0,-5.080002,5.080002,271,417,20,16,4,-4,-2.00000023841858,2.00000023841858,0,0,1,1,0,0,0,0,120,246,-126,126
Bruno Santos,Elias Theodorou,Elias Theodorou,2014-10-04,0,1,1,-1,7.5,5.333333,-10.16,10.16,0,0,-12.5,12.5,150,393,17,19,-2,2,2.16666650772095,-2.16666650772095,0,0,0,0,0,0,0,0,0,0,0,0
Roger Narvaez,Elias Theodorou,Elias Theodorou,2015-03-14,0,1,5,-5,2.666667,5.333333,5.080002,-5.080002,0,0,5.5,-5.5,0,134,11,19,-8,8,-2.66666674613953,2.66666674613953,0,1,0,0,-1,1,0,0,0,161,-161,161
Thiago Santos,Elias Theodorou,Thiago Santos,2015-12-10,1,0,4,-4,2,5.333333,2.540009,-2.540009,20,-20,2.539993,-2.539993,53,409,33,19,14,-14,-3.33333349227905,3.33333349227905,0,2,0,0,-2,2,0,0,0,271,-271,271
Sam Alvey,Elias Theodorou,Elias Theodorou,2016-06-18,0,1,2,-2,1.833333,5.333333,2.540009,-2.540009,0,0,0,0,94,98,51,19,32,-32,-3.50000011920929,3.50000011920929,0,0,1,0,0,0,1,-1,315,191,124,-124
Cezar Ferreira,Elias Theodorou,Elias Theodorou,2017-02-19,0,1,4,-4,1.625,5.333333,0,0,0,0,7.619995,-7.619995,105,162,21,19,2,-2,-3.70833349227905,3.70833349227905,2,1,1,0,1,-1,1,-1,92,246,-154,154
Brad Tavares,Elias Theodorou,Brad Tavares,2017-07-07,1,0,0,0,2.222222,5.333333,0,0,0,0,-2.539993,2.539993,127,253,29,19,10,-10,-3.11111116409302,3.11111116409302,0,2,1,0,-2,2,1,-1,790,138,652,-652
Daniel Kelly,Elias Theodorou,Elias Theodorou,2017-11-18,0,1,11,-11,3.25,5.333333,-2.539993,2.539993,0,0,-12.7,12.7,58,54,17,19,-2,2,-2.08333349227905,2.08333349227905,3,0,0,0,3,-3,0,0,735,134,601,-601
Trevor Smith,Elias Theodorou,Elias Theodorou,2018-05-27,0,1,8,-8,1.5,5.333333,5.080002,-5.080002,0,0,0,0,262,241,25,19,6,-6,-3.83333349227905,3.83333349227905,1,1,0,0,0,0,0,0,1408,190,1218,-1218
Eryk Anders,Elias Theodorou,Elias Theodorou,2018-12-08,0,1,1,-1,1.875,5.333333,0,0,0,0,0,0,23,36,23,19,4,-4,-3.45833349227905,3.45833349227905,0,2,1,0,-2,2,1,-1,77,195,-118,118
Derek Brunson,Elias Theodorou,Derek Brunson,2019-05-04,1,0,5,-5,2.555556,5.333333,0,0,0,0,5.080002,-5.080002,197,10,32,19,13,-13,-2.77777791023254,2.77777791023254,0,3,3,0,-3,3,3,-3,462,147,315,-315
Jules Bruchez,Eliot Marshall,Eliot Marshall,2008-12-13,0,1,3,-3,0.5,2.5,-5.080002,5.080002,0,0,-9.580002,9.580002,0,65,3,14,-11,11,-2,2,0,0,0,0,0,0,0,0,0,0,0,0
Vinny Magalhaes,Eliot Marshall,Eliot Marshall,2009-04-18,0,1,-4,4,1.555556,2.5,2.539993,-2.539993,0,0,-5.080002,5.080002,66,0,23,14,9,-9,-0.944444417953491,0.944444417953491,0,1,0,0,-1,1,0,0,0,126,-126,126
Jason Brilz,Eliot Marshall,Eliot Marshall,2009-09-19,0,1,5,-5,3.666667,2.5,-7.62001,7.62001,0,0,-15.24001,15.24001,220,24,28,14,14,-14,1.16666674613953,-1.16666674613953,1,2,0,0,-1,1,0,0,367,154,213,-213
Luiz Cane,Eliot Marshall,Luiz Cane,2011-03-19,1,0,-1,1,2.428571,2.5,0,0,-20,20,0,0,59,0,24,14,10,-10,-7.14285373687744e-02,7.14285373687744e-02,0,3,2,0,-3,3,2,-2,294,546,-252,252
Sijara Eubanks,Elise Reed,Sijara Eubanks,2021-07-24,1,0,8,-8,1.142857,1.75,2.539993,-2.539993,10,-10,10.15999,-10.15999,221,0,15,11,4,-4,-0.607142806053162,0.607142806053162,0,0,0,0,0,0,0,0,217,0,217,-217
Cory McKenna,Elise Reed,Elise Reed,2022-03-19,0,1,-7,7,4,1.75,0,0,0,0,-12.7,12.7,226,22,10,11,-1,1,2.25,-2.25,0,0,0,1,0,0,-1,1,0,238,-238,238
Sam Hughes,Elise Reed,Sam Hughes,2022-05-21,1,0,0,0,1.6,1.75,5.080002,-5.080002,0,0,2.539993,-2.539993,719,0,13,11,2,-2,-0.149999976158142,0.149999976158142,1,1,1,1,0,0,0,0,35,63,-28,28
Melissa Martinez,Elise Reed,Elise Reed,2022-09-10,0,1,-4,4,7,1.75,-2.540009,2.540009,0,0,7.619995,-7.619995,162,214,8,11,-3,3,5.25,-5.25,0,0,0,2,0,0,-2,2,0,112,-112,112
Loma Lookboonmee,Elise Reed,Loma Lookboonmee,2023-02-11,1,0,-3,3,2.666667,1.75,-5.080002,5.080002,0,0,-5.080002,5.080002,36,119,11,11,0,0,0.916666746139526,-0.916666746139526,1,1,0,2,0,0,-2,2,861,154,707,-707
Loopy Godinez,Elise Reed,Loopy Godinez,2023-09-16,1,0,0,0,3.666667,1.75,-2.540009,2.540009,0,0,-5.080002,5.080002,389,22,14,11,3,-3,1.91666674613953,-1.91666674613953,0,0,0,2,0,0,-2,2,399,217,182,-182
Valerie Letourneau,Elizabeth Phillips,Valerie Letourneau,2014-06-14,1,0,4,-4,1.333333,1,2.539993,-2.539993,-20,20,7.619995,-7.619995,1,125,14,12,2,-2,0.333333373069763,-0.333333373069763,0,0,0,0,0,0,0,0,0,0,0,0
Milana Dudieva,Elizabeth Phillips,Milana Dudieva,2014-08-23,1,0,-3,3,1.833333,1,-7.619995,7.619995,0,0,-2.100006,2.100006,155,453,17,12,5,-5,0.833333373069763,-0.833333373069763,0,0,0,0,0,0,0,0,0,70,-70,70
Jessamyn Duke,Elizabeth Phillips,Elizabeth Phillips,2015-07-25,0,1,1,-1,0.6,1,12.7,-12.7,0,0,20.31999,-20.31999,199,401,8,12,-4,4,-0.399999976158142,0.399999976158142,0,0,1,0,0,0,1,-1,374,336,38,-38
Raquel Pennington,Elizabeth Phillips,Raquel Pennington,2016-08-20,1,0,-3,3,1.666667,1,2.539993,-2.539993,0,0,5.079987,-5.079987,305,399,24,12,12,-12,0.666666626930237,-0.666666626930237,0,1,0,0,-1,1,0,0,0,392,-392,392
Nicolas Dalby,Elizeu Zaleski dos Santos,Nicolas Dalby,2015-05-30,1,0,2,-2,5.5,3.428571,0,0,0,0,2.540009,-2.540009,254,36,26,31,-5,5,2.07142853736877,-2.07142853736877,0,0,0,0,0,0,0,0,0,0,0,0
Omari Akhmedov,Elizeu Zaleski dos Santos,Elizeu Zaleski dos Santos,2016-04-16,0,1,-1,1,3.5,3.428571,2.540009,-2.540009,15,-15,0,0,79,171,27,31,-4,4,7.14285373687744e-02,-7.14285373687744e-02,0,0,1,0,0,0,1,-1,128,322,-194,194
Keita Nakamura,Elizeu Zaleski dos Santos,Elizeu Zaleski dos Santos,2016-10-01,0,1,3,-3,3.4,3.428571,0,0,0,0,0,0,461,76,44,31,13,-13,-2.85713672637939e-02,2.85713672637939e-02,1,1,0,0,0,0,0,0,80,168,-88,88
Lyman Good,Elizeu Zaleski dos Santos,Elizeu Zaleski dos Santos,2017-07-22,0,1,2,-2,3.5,3.428571,2.540009,-2.540009,0,0,2.540009,-2.540009,37,72,27,31,-4,4,7.14285373687744e-02,-7.14285373687744e-02,0,2,0,0,-2,2,0,0,0,294,-294,294
Max Griffin,Elizeu Zaleski dos Santos,Elizeu Zaleski dos Santos,2017-10-28,0,1,1,-1,1.9,3.428571,0,0,0,0,7.619995,-7.619995,68,152,29,31,-2,2,-1.52857148647308,1.52857148647308,1,3,0,0,-2,2,0,0,357,98,259,-259
Sean Strickland,Elizeu Zaleski dos Santos,Elizeu Zaleski dos Santos,2018-05-12,0,1,-4,4,5.6,3.428571,5.080002,-5.080002,15,-15,7.619995,-7.619995,0,6,33,31,2,-2,2.17142844200134,-2.17142844200134,0,4,0,0,-4,4,0,0,399,196,203,-203
Luigi Vendramini,Elizeu Zaleski dos Santos,Elizeu Zaleski dos Santos,2018-09-22,0,1,-9,9,3,3.428571,-7.619995,7.619995,-15,15,0,0,161,8,12,31,-19,19,-0.428571462631226,0.428571462631226,0,5,0,0,-5,5,0,0,0,133,-133,133
Curtis Millender,Elizeu Zaleski dos Santos,Elizeu Zaleski dos Santos,2019-03-09,0,1,-1,1,3.4,3.428571,7.62001,-7.62001,0,0,7.619995,-7.619995,0,128,22,31,-9,9,-2.85713672637939e-02,2.85713672637939e-02,0,6,0,0,-6,6,0,0,0,168,-168,168
Li Jingliang,Elizeu Zaleski dos Santos,Li Jingliang,2019-08-31,1,0,-1,1,2.375,3.428571,2.540009,-2.540009,0,0,-5.080002,5.080002,22,24,27,31,-4,4,-1.05357146263123,1.05357146263123,1,7,0,0,-6,6,0,0,280,175,105,-105
Aleksei Kunchenko,Elizeu Zaleski dos Santos,Elizeu Zaleski dos Santos,2020-03-14,0,1,2,-2,10,3.428571,-7.619995,7.619995,0,0,-7.619995,7.619995,24,150,22,31,-9,9,6.57142853736877,-6.57142853736877,1,0,0,1,1,-1,-1,1,469,196,273,-273
Muslim Salikhov,Elizeu Zaleski dos Santos,Muslim Salikhov,2020-07-11,1,0,3,-3,4.75,3.428571,0,0,0,0,-7.619995,7.619995,2,53,23,31,-8,8,1.32142853736877,-1.32142853736877,2,1,0,1,1,-1,-1,1,259,119,140,-140
Benoit Saint Denis,Elizeu Zaleski dos Santos,Elizeu Zaleski dos Santos,2021-10-30,0,1,-9,9,12,3.428571,0,0,-15,15,0,0,115,120,13,31,-18,18,8.57142853736877,-8.57142853736877,0,0,0,1,0,0,-1,1,0,476,-476,476
Abubakar Nurmagomedov,Elizeu Zaleski dos Santos,Elizeu Zaleski dos Santos,2023-06-03,0,1,-3,3,4.25,3.428571,0,0,0,0,-2.539993,2.539993,376,15,21,31,-10,10,0.821428537368774,-0.821428537368774,1,1,0,1,0,0,-1,1,224,581,-357,357
Francimar Barroso,Elvis Mutapcic,Francimar Barroso,2016-01-17,1,0,6,-6,2.714286,2.5,2.539993,-2.539993,20,-20,7.619995,-7.619995,194,0,26,21,5,-5,0.214285612106323,-0.214285612106323,1,0,0,0,1,-1,0,0,232,0,232,-232
Jeremy Horn,Elvis Sinosic,Elvis Sinosic,2001-02-23,0,1,-5,5,4.136364,0.6363636,-5.080002,5.080002,-20,20,-7.619995,7.619995,150,0,113,18,95,-95,3.49999988079071,-3.49999988079071,3,0,0,0,3,-3,0,0,154,0,154,-154
Tito Ortiz,Elvis Sinosic,Tito Ortiz,2001-06-29,1,0,-4,4,1.583333,0.6363636,0,0,0,0,-7.619995,7.619995,172,0,31,18,13,-13,0.946969747543335,-0.946969747543335,2,1,1,0,1,-1,1,-1,126,126,0,0
Forrest Griffin,Elvis Sinosic,Forrest Griffin,2005-10-07,1,0,-8,8,2.714286,0.6363636,0,0,0,0,0,0,6,0,26,18,8,-8,2.0779219865799,-2.0779219865799,1,0,0,1,1,-1,-1,1,125,1561,-1436,1436
Alessio Sakara,Elvis Sinosic,Alessio Sakara,2006-02-04,1,0,-10,10,1.727273,0.6363636,-7.619995,7.619995,-20,20,-12.7,12.7,741,12,30,18,12,-12,1.09090912342072,-1.09090912342072,0,0,0,2,0,0,-2,2,0,120,-120,120
Michael Bisping,Elvis Sinosic,Michael Bisping,2007-04-21,1,0,-8,8,3.333333,0.6363636,-5.080002,5.080002,-20,20,-5.080002,5.080002,286,59,39,18,21,-21,2.69696962833405,-2.69696962833405,2,0,0,2,2,-2,-2,2,112,441,-329,329
Bartosz Fabinski,Emil Meek,Bartosz Fabinski,2018-07-22,1,0,3,-3,3,1.8,2.540009,-2.540009,0,0,2.539993,-2.539993,784,13,20,14,6,-6,1.20000004768372,-1.20000004768372,2,0,0,0,2,-2,0,0,974,0,974,-974
Jake Matthews,Emil Meek,Jake Matthews,2020-02-22,1,0,-6,6,3.166667,1.8,0,0,0,0,-2.540009,2.540009,507,4,25,14,11,-11,1.36666679382324,-1.36666679382324,0,0,0,0,0,0,0,0,448,580,-132,132
Angela Hill,Emily Kagan,Angela Hill,2014-12-12,1,0,-4,4,1.153846,1,0,0,0,0,-2.440002,2.440002,261,336,28,6,22,-22,0.153846144676208,-0.153846144676208,0,0,0,0,0,0,0,0,0,0,0,0
Kailin Curran,Emily Kagan,Kailin Curran,2015-12-10,1,0,-10,10,0.8,1,2.539993,-2.539993,0,0,0.1000061,-0.1000061,74,277,9,6,3,-3,-0.199999988079071,0.199999988079071,0,0,1,0,0,0,1,-1,383,363,20,-20
Gillian Robertson,Emily Whitmire,Gillian Robertson,2017-12-01,1,0,-4,4,1.5,0.8,0,0,-10,10,0,0,49,33,20,9,11,-11,0.699999988079071,-0.699999988079071,0,0,0,0,0,0,0,0,0,0,0,0
Jamie Moyle,Emily Whitmire,Emily Whitmire,2018-07-07,0,1,2,-2,1.333333,0.8,-10.16,10.16,-10,10,5.080002,-5.080002,38,295,7,9,-2,2,0.533333361148834,-0.533333361148834,0,0,0,0,0,0,0,0,399,218,181,-181
Aleksandra Albu,Emily Whitmire,Emily Whitmire,2019-02-17,0,1,1,-1,1.5,0.8,-7.62001,7.62001,-10,10,0,0,0,51,5,9,-4,4,0.699999988079071,-0.699999988079071,2,1,0,0,1,-1,0,0,568,225,343,-343
Amanda Ribas,Emily Whitmire,Amanda Ribas,2019-06-29,1,0,-3,3,2.75,0.8,-5.080002,5.080002,0,0,7.619995,-7.619995,272,94,15,9,6,-6,1.94999998807907,-1.94999998807907,0,2,0,0,-2,2,0,0,0,132,-132,132
Polyana Viana,Emily Whitmire,Polyana Viana,2020-08-29,1,0,-1,1,2.166667,0.8,0,0,-10,10,10.15999,-10.15999,0,62,19,9,10,-10,1.3666667342186,-1.3666667342186,0,0,0,0,0,0,0,0,0,427,-427,427
Hannah Goldy,Emily Whitmire,Hannah Goldy,2021-09-18,1,0,-1,1,1.5,0.8,-2.540009,2.540009,-10,10,-5.080002,5.080002,24,184,10,9,1,-1,0.699999988079071,-0.699999988079071,0,0,0,0,0,0,0,0,777,385,392,-392
Keith Hackney,Emmanuel Yarborough,Keith Hackney,1994-09-09,1,0,,,1,0.5,-22.86,22.86,-570,570,-21,21,0,0,4,3,1,-1,0.5,-0.5,0,0,0,0,0,0,0,0,0,0,0,0
Chris Avila,Enrique Barzola,Enrique Barzola,2016-11-05,0,1,-4,4,1.25,3.4,7.62001,-7.62001,0,0,3.559998,-3.559998,0,426,9,22,-13,13,-2.15000009536743,2.15000009536743,0,0,0,0,0,0,0,0,77,0,77,-77
Kevin Aguilar,Enrique Barzola,Kevin Aguilar,2019-03-30,1,0,1,-1,3.4,3.4,0,0,10,-10,7.619995,-7.619995,0,30,22,22,0,0,0,0,1,1,0,0,0,0,0,0,120,875,-755,755
Royce Alger,Enson Inoue,Enson Inoue,1997-05-30,0,1,,,1.5,1.5,0,0,-11,11,1.360001,-1.360001,0,0,5,20,-15,15,0,0,0,0,0,0,0,0,0,0,0,0,0,0
Rob MacDonald,Eric Schafer,Eric Schafer,2006-08-26,0,1,-1,1,1.25,1.75,0,0,20,-20,5.080002,-5.080002,0,89,9,22,-13,13,-0.5,0.5,1,0,0,0,1,-1,0,0,59,0,59,-59
Michael Bisping,Eric Schafer,Michael Bisping,2006-12-30,1,0,-2,2,3.333333,1.75,-5.080002,5.080002,0,0,-2.539993,2.539993,39,155,39,22,17,-17,1.58333325386047,-1.58333325386047,1,1,0,0,0,0,0,0,189,126,63,-63
Stephan Bonnar,Eric Schafer,Stephan Bonnar,2007-10-20,1,0,0,0,1.666667,1.75,2.539993,-2.539993,20,-20,7.62001,-7.62001,230,129,24,22,2,-2,-8.33333730697632e-02,8.33333730697632e-02,1,0,0,1,1,-1,-1,1,105,294,-189,189
Houston Alexander,Eric Schafer,Eric Schafer,2008-09-17,0,1,6,-6,1.133333,1.75,-7.619995,7.619995,20,-20,-10.15999,10.15999,32,196,32,22,10,-10,-0.616666674613953,0.616666674613953,0,0,2,2,0,0,0,0,168,333,-165,165
Antonio Mendes,Eric Schafer,Eric Schafer,2009-01-17,0,1,-4,4,1.384615,1.75,0,0,20,-20,2.540009,-2.540009,9,186,31,22,9,-9,-0.365384578704834,0.365384578704834,0,1,1,2,-1,1,-1,1,238,122,116,-116
Ryan Bader,Eric Schafer,Ryan Bader,2009-10-24,1,0,-6,6,4.6,1.75,-2.539993,2.539993,20,-20,-5.079987,5.079987,265,1,28,22,6,-6,2.84999990463257,-2.84999990463257,2,2,0,2,0,0,-2,2,206,280,-74,74
Jason Brilz,Eric Schafer,Jason Brilz,2010-03-21,1,0,2,-2,3.666667,1.75,-10.16,10.16,20,-20,-12.7,12.7,432,105,28,22,6,-6,1.91666674613953,-1.91666674613953,0,0,0,2,0,0,-2,2,183,148,35,-35
Jorge Rivera,Eric Schafer,Jorge Rivera,2012-01-20,1,0,5,-5,2.222222,1.75,-5.080002,5.080002,0,0,-7.619995,7.619995,58,278,29,22,7,-7,0.472222328186035,-0.472222328186035,0,0,0,2,0,0,-2,2,0,670,-670,670
Alexandre Pantoja,Eric Shelton,Alexandre Pantoja,2017-01-28,1,0,1,-1,5.2,2,-2.539993,2.539993,0,0,-2.540009,2.540009,230,171,31,18,13,-13,3.19999980926514,-3.19999980926514,0,0,0,0,0,0,0,0,0,0,0,0
Jarred Brooks,Eric Shelton,Jarred Brooks,2017-07-29,1,0,-2,2,6.5,2,-7.619995,7.619995,0,0,-15.24001,15.24001,218,37,15,18,-3,3,4.5,-4.5,0,0,0,0,0,0,0,0,0,182,-182,182
Jenel Lausa,Eric Shelton,Eric Shelton,2017-11-18,0,1,3,-3,1.4,2,-2.539993,2.539993,0,0,0,0,71,535,12,18,-6,6,-0.600000023841858,0.600000023841858,0,0,0,0,0,0,0,0,224,112,112,-112
Alex Perez,Eric Shelton,Alex Perez,2018-02-24,1,0,-2,2,3.428571,2,0,0,0,0,-7.619995,7.619995,418,2,31,18,13,-13,1.42857146263123,-1.42857146263123,0,1,0,0,-1,1,0,0,0,98,-98,98
Joseph Morales,Eric Shelton,Eric Shelton,2018-11-10,0,1,-3,3,4.5,2,0,0,0,0,2.539993,-2.539993,52,406,11,18,-7,7,2.5,-2.5,1,0,0,0,1,-1,0,0,462,259,203,-203
Jordan Espinosa,Eric Shelton,Jordan Espinosa,2019-03-23,1,0,1,-1,1.666667,2,0,0,0,0,2.539993,-2.539993,18,0,24,18,6,-6,-0.333333373069763,0.333333373069763,0,1,0,0,-1,1,0,0,0,133,-133,133
Sam Alvey,Eric Spicely,Sam Alvey,2016-07-13,1,0,1,-1,1.833333,2,2.540009,-2.540009,0,0,5.080002,-5.080002,20,74,51,18,33,-33,-0.166666626930237,0.166666626930237,0,0,1,0,0,0,1,-1,25,0,25,-25
Thiago Santos,Eric Spicely,Eric Spicely,2016-09-24,0,1,3,-3,2,2,2.540009,-2.540009,20,-20,7.619995,-7.619995,65,82,33,18,15,-15,0,0,1,0,0,0,1,-1,0,0,289,73,216,-216
Alessio Di Chirico,Eric Spicely,Eric Spicely,2017-01-28,0,1,-3,3,1.857143,2,-2.539993,2.539993,0,0,2.540009,-2.540009,46,51,20,18,2,-2,-0.142857193946838,0.142857193946838,1,1,0,0,0,0,0,0,154,126,28,-28
Antonio Carlos Junior,Eric Spicely,Antonio Carlos Junior,2017-06-03,1,0,-3,3,2.2,2,2.540009,-2.540009,0,0,15.24001,-15.24001,288,35,16,18,-2,2,0.200000047683716,-0.200000047683716,2,2,1,0,0,0,1,-1,155,126,29,-29
Gerald Meerschaert,Eric Spicely,Gerald Meerschaert,2017-12-01,1,0,-2,2,2.058824,2,0,0,0,0,10.16,-10.16,22,220,52,18,34,-34,5.88235855102539e-02,-5.88235855102539e-02,0,0,1,0,0,0,1,-1,146,181,-35,35
Charles Oliveira,Eric Wisely,Charles Oliveira,2012-01-28,1,0,-5,5,3.777778,2.888889,5.080002,-5.080002,10,-10,12.96001,-12.96001,35,6,43,35,8,-8,0.888888835906982,-0.888888835906982,0,0,0,0,0,0,0,0,0,0,0,0
Enrique Marin,Erick Montano,Erick Montano,2015-11-21,0,1,-1,1,2.5,1.4,-5.080002,5.080002,0,0,-5.419998,5.419998,208,162,14,12,2,-2,1.10000002384186,-1.10000002384186,0,0,0,0,0,0,0,0,0,0,0,0
Randy Brown,Erick Montano,Randy Brown,2016-09-17,1,0,-4,4,3.4,1.4,7.619995,-7.619995,0,0,12.7,-12.7,142,314,22,12,10,-10,2.00000011920929,-2.00000011920929,0,1,0,0,-1,1,0,0,154,301,-147,147
Max Griffin,Erick Montano,Max Griffin,2016-11-05,1,0,0,0,1.9,1.4,-2.540009,2.540009,0,0,7.619995,-7.619995,13,0,29,12,17,-17,0.5,-0.5,0,0,0,0,0,0,0,0,0,49,-49,49
Luis Ramos,Erick Silva,Erick Silva,2011-08-27,0,1,3,-3,2,2.111111,-10.16,10.16,0,0,-12.96001,12.96001,0,5,30,28,2,-2,-0.111111164093018,0.111111164093018,0,0,0,0,0,0,0,0,0,0,0,0
Carlo Prater,Erick Silva,Carlo Prater,2012-01-14,1,0,3,-3,1.722222,2.111111,-2.540009,2.540009,-15,15,-5.080002,5.080002,0,4,49,28,21,-21,-0.388888955116272,0.388888955116272,0,1,0,0,-1,1,0,0,0,140,-140,140
Charlie Brenneman,Erick Silva,Erick Silva,2012-06-08,0,1,4,-4,2.375,2.111111,-5.080002,5.080002,-15,15,-10.16,10.16,120,33,27,28,-1,1,0.263888835906982,-0.263888835906982,1,0,2,0,1,-1,2,-2,140,146,-6,6
Jon Fitch,Erick Silva,Jon Fitch,2012-10-13,1,0,6,-6,4.285714,2.111111,0,0,0,0,0,0,528,177,37,28,9,-9,2.17460298538208,-2.17460298538208,0,1,1,0,-1,1,1,-1,288,127,161,-161
Jason High,Erick Silva,Erick Silva,2013-06-08,0,1,3,-3,3.5,2.111111,-10.16,10.16,-15,15,-2.540009,2.540009,13,18,27,28,-1,1,1.38888883590698,-1.38888883590698,0,0,0,0,0,0,0,0,0,238,-238,238
Dong Hyun Kim,Erick Silva,Dong Hyun Kim,2013-10-09,1,0,2,-2,5.5,2.111111,5.080002,-5.080002,0,0,5.079987,-5.079987,240,22,26,28,-2,2,3.38888883590698,-3.38888883590698,1,1,1,0,0,0,1,-1,333,123,210,-210
Takenori Sato,Erick Silva,Erick Silva,2014-02-15,0,1,-1,1,1.727273,2.111111,-5.080002,5.080002,0,0,-7.960007,7.960007,0,1,30,28,2,-2,-0.383838415145874,0.383838415145874,0,0,0,1,0,0,-1,1,0,129,-129,129
Matt Brown,Erick Silva,Matt Brown,2014-05-10,1,0,4,-4,1.368421,2.111111,0,0,0,0,2.539993,-2.539993,227,228,45,28,17,-17,-0.742690086364746,0.742690086364746,7,1,0,1,6,-6,-1,1,266,84,182,-182
Mike Rhodes,Erick Silva,Erick Silva,2014-12-20,0,1,-5,5,2,2.111111,2.539993,-2.539993,0,0,0,0,0,65,15,28,-13,13,-0.111111164093018,0.111111164093018,0,0,0,2,0,0,-2,2,175,224,-49,49
Josh Koscheck,Erick Silva,Erick Silva,2015-03-21,0,1,7,-7,1.545455,2.111111,-5.080002,5.080002,0,0,-2.540009,2.540009,64,49,28,28,0,0,-0.565656661987305,0.565656661987305,0,1,3,2,-1,1,1,-1,490,91,399,-399
Neil Magny,Erick Silva,Neil Magny,2015-08-23,1,0,-3,3,2.333333,2.111111,7.619995,-7.619995,0,0,15.23999,-15.23999,245,166,40,28,12,-12,0.222222089767456,-0.222222089767456,0,2,0,2,-2,2,-2,2,22,155,-133,133
Luan Chagas,Erick Silva,Erick Silva,2016-09-24,0,1,-9,9,5,2.111111,0,0,0,0,2.539993,-2.539993,152,190,18,28,-10,10,2.88888883590698,-2.88888883590698,0,0,0,2,0,0,-2,2,0,398,-398,398
Yancy Medeiros,Erick Silva,Yancy Medeiros,2017-06-03,1,0,-3,3,1.875,2.111111,-5.080002,5.080002,-15,15,2.539993,-2.539993,11,0,23,28,-5,5,-0.236111164093018,0.236111164093018,1,1,1,2,0,0,-1,1,266,252,14,-14
Jordan Mein,Erick Silva,Jordan Mein,2017-12-16,1,0,-5,5,2.583333,2.111111,0,0,0,0,-2.540009,2.540009,472,40,43,28,15,-15,0.472222089767456,-0.472222089767456,0,0,0,3,0,0,-3,3,161,196,-35,35
Raphael Assuncao,Erik Koch,Erik Koch,2011-03-19,0,1,6,-6,2.8,2.666667,-12.7,12.7,-35,35,-12.7,12.7,0,2,38,22,16,-16,0.133333206176758,-0.133333206176758,0,0,0,0,0,0,0,0,0,0,0,0
Jonathan Brookins,Erik Koch,Erik Koch,2011-09-17,0,1,4,-4,1.6,2.666667,5.080002,-5.080002,-25,25,7.62001,-7.62001,519,34,26,22,4,-4,-1.06666672229767,1.06666672229767,1,1,0,0,0,0,0,0,287,182,105,-105
Daron Cruickshank,Erik Koch,Daron Cruickshank,2014-05-10,1,0,3,-3,1.8,2.666667,-5.080002,5.080002,-15,15,2.540009,-2.540009,13,0,28,22,6,-6,-0.866666793823242,0.866666793823242,1,2,0,0,-1,1,0,0,105,966,-861,861
Shane Campbell,Erik Koch,Erik Koch,2016-05-29,0,1,2,-2,2.333333,2.666667,5.080002,-5.080002,-15,15,0,0,65,256,20,22,-2,2,-0.333333492279053,0.333333492279053,0,0,1,1,0,0,0,0,98,750,-652,652
Clay Guida,Erik Koch,Clay Guida,2017-06-25,1,0,7,-7,1.9,2.666667,-7.62001,7.62001,-15,15,-2.539993,2.539993,593,35,58,22,36,-36,-0.766666769981384,0.766666769981384,0,1,2,1,-1,1,1,-1,386,392,-6,6
Bobby Green,Erik Koch,Bobby Green,2018-01-27,1,0,2,-2,2.142857,2.666667,0,0,-15,15,0,0,197,116,44,22,22,-22,-0.523809671401978,0.523809671401978,0,0,1,1,0,0,0,0,287,216,71,-71
John Albert,Erik Perez,Erik Perez,2012-06-01,0,1,3,-3,1.2,2.833333,0,0,0,0,0,0,52,154,11,23,-12,12,-1.63333320617676,1.63333320617676,0,0,0,0,0,0,0,0,107,0,107,-107
Byron Bloodworth,Erik Perez,Erik Perez,2012-12-29,0,1,6,-6,2,2.833333,0,0,0,0,2.279999,-2.279999,9,199,9,23,-14,14,-0.833333253860474,0.833333253860474,0,1,1,0,-1,1,1,-1,455,211,244,-244
Takeya Mizugaki,Erik Perez,Takeya Mizugaki,2013-08-28,1,0,6,-6,1.909091,2.833333,-2.540009,2.540009,0,0,2.539993,-2.539993,160,278,32,23,9,-9,-0.924242377281189,0.924242377281189,0,2,0,0,-2,2,0,0,0,242,-242,242
Edwin Figueroa,Erik Perez,Erik Perez,2013-11-16,0,1,6,-6,1.8,2.833333,-2.540009,2.540009,0,0,2.539993,-2.539993,0,514,14,23,-9,9,-1.03333330154419,1.03333330154419,0,0,1,0,0,0,1,-1,287,80,207,-207
Bryan Caraway,Erik Perez,Bryan Caraway,2014-06-07,1,0,5,-5,2.333333,2.833333,0,0,0,0,0,0,159,93,30,23,7,-7,-0.5,0.5,0,1,0,0,-1,1,0,0,462,203,259,-259
Taylor Lapilus,Erik Perez,Erik Perez,2015-11-21,0,1,-3,3,6.333333,2.833333,-5.080002,5.080002,0,0,12.7,-12.7,431,0,22,23,-1,1,3.50000023841858,-3.50000023841858,2,0,0,0,2,-2,0,0,154,532,-378,378
Felipe Arantes,Erik Perez,Erik Perez,2016-11-05,0,1,2,-2,1.8,2.833333,0,0,0,0,12.7,-12.7,116,426,28,23,5,-5,-1.03333330154419,1.03333330154419,2,1,0,0,1,-1,0,0,121,350,-229,229
TJ Brown,Erik Silva,TJ Brown,2022-12-10,1,0,-3,3,1.7,4.5,0,0,0,0,2.540009,-2.540009,583,155,27,11,16,-16,-2.79999995231628,2.79999995231628,0,0,0,0,0,0,0,0,168,0,168,-168
Sarah Alpar,Erin Blanchfield,Erin Blanchfield,2021-09-18,0,1,8,-8,1.5,12,0,0,10,-10,-1.830002,1.830002,0,583,15,13,2,-2,-10.5,10.5,0,0,1,0,0,0,1,-1,364,0,364,-364
JJ Aldrich,Erin Blanchfield,Erin Blanchfield,2022-06-04,0,1,6,-6,2,12,2.540009,-2.540009,0,0,2.539993,-2.539993,42,56,18,13,5,-5,-10,10,3,1,1,0,2,-2,1,-1,84,259,-175,175
Jessica Andrade,Erin Blanchfield,Erin Blanchfield,2023-02-18,0,1,8,-8,2,12,-7.619995,7.619995,-10,10,-10.16,10.16,0,63,36,13,23,-23,-10,10,3,2,3,0,1,-1,3,-3,28,259,-231,231
Yosdenis Cedeno,Ernest Chavez,Ernest Chavez,2014-02-22,0,1,-1,1,1.666667,5,0,0,10,-10,-2.540009,2.540009,46,271,16,12,4,-4,-3.33333337306976,3.33333337306976,0,0,0,0,0,0,0,0,0,0,0,0
Oleg Taktarov,Ernie Verdicia,Oleg Taktarov,1995-04-07,1,0,,,3.4,0,2.540009,-2.540009,11,-11,2,-2,0,0,22,1,21,-21,3.40000009536743,-3.40000009536743,0,0,0,0,0,0,0,0,0,0,0,0
Loik Radzhabov,Esteban Ribovics,Loik Radzhabov,2023-03-04,1,0,6,-6,3.4,12,2.539993,-2.539993,0,0,0,0,459,31,22,13,9,-9,-8.59999990463257,8.59999990463257,0,0,0,0,0,0,0,0,0,0,0,0
Kamuela Kirk,Esteban Ribovics,Esteban Ribovics,2023-07-08,0,1,2,-2,2,12,0,0,0,0,15.24001,-15.24001,380,75,18,13,5,-5,-10,10,0,0,0,0,0,0,0,0,0,126,-126,126
Royce Alger,Eugene Jackson,Eugene Jackson,1999-07-16,0,1,,,1.5,1.666667,5.080002,-5.080002,14,-14,3.360001,-3.360001,154,20,5,24,-19,19,-0.166666626930237,0.166666626930237,0,0,0,0,0,0,0,0,777,0,777,-777
Jeremy Horn,Eugene Jackson,Jeremy Horn,2000-09-22,1,0,-8,8,4.136364,1.666667,12.7,-12.7,0,0,9.960007,-9.960007,215,0,113,24,89,-89,2.4696968793869,-2.4696968793869,2,1,0,0,1,-1,0,0,434,434,0,0
Ricardo Almeida,Eugene Jackson,Ricardo Almeida,2001-09-28,1,0,-11,11,2.6,1.666667,10.16,-10.16,-15,15,9.960007,-9.960007,187,38,18,24,-6,6,0.933333277702332,-0.933333277702332,0,0,0,0,0,0,0,0,147,371,-224,224
Mikey Burnett,Eugenio Tadeu,Mikey Burnett,1998-03-13,1,0,,,2.5,0.6666667,-5.080002,5.080002,10,-10,-5,5,0,0,7,5,2,-2,1.83333331346512,-1.83333331346512,0,0,0,0,0,0,0,0,0,0,0,0
Marcus Aurelio,Evan Dunham,Evan Dunham,2009-08-29,0,1,9,-9,2.2,2,0,0,0,0,10.16,-10.16,253,61,32,27,5,-5,0.200000047683716,-0.200000047683716,0,0,0,0,0,0,0,0,308,0,308,-308
Shamar Bailey,Evan Dunham,Evan Dunham,2011-09-17,0,1,-1,1,1.454545,2,-2.540009,2.540009,0,0,12.7,-12.7,12,12,27,27,0,0,-0.545454502105713,0.545454502105713,1,1,0,0,0,0,0,0,105,749,-644,644
Rafael Dos Anjos,Evan Dunham,Rafael Dos Anjos,2013-05-18,1,0,-3,3,2.133333,2,-5.080002,5.080002,15,-15,0,0,42,160,47,27,20,-20,0.133333444595337,-0.133333444595337,2,2,1,0,0,0,1,-1,311,609,-298,298
Donald Cerrone,Evan Dunham,Donald Cerrone,2013-11-16,1,0,-1,1,2.117647,2,7.619995,-7.619995,0,0,7.619995,-7.619995,141,89,53,27,26,-26,0.117647171020508,-0.117647171020508,0,0,1,0,0,0,1,-1,80,182,-102,102
Edson Barboza,Evan Dunham,Edson Barboza,2014-07-16,1,0,-4,4,2.090909,2,2.539993,-2.539993,-10,10,12.7,-12.7,3,2,34,27,7,-7,9.09090042114258e-02,-9.09090042114258e-02,0,0,1,0,0,0,1,-1,88,242,-154,154
Rodrigo Damm,Evan Dunham,Evan Dunham,2015-01-03,0,1,1,-1,1.444444,2,-7.62001,7.62001,0,0,2.539993,-2.539993,0,34,22,27,-5,5,-0.555555582046509,0.555555582046509,0,0,1,1,0,0,0,0,120,171,-51,51
Olivier Aubin-Mercier,Evan Dunham,Olivier Aubin-Mercier,2018-04-07,1,0,-7,7,2.2,2,-2.540009,2.540009,0,0,0,0,7,0,16,27,-11,11,0.200000047683716,-0.200000047683716,3,1,0,1,2,-2,-1,1,203,1190,-987,987
Herbert Burns,Evan Dunham,Herbert Burns,2020-06-06,1,0,-6,6,2.75,2,-2.540009,2.540009,-10,10,7.619995,-7.619995,38,5,15,27,-12,12,0.75,-0.75,1,0,0,2,1,-1,-2,2,133,791,-658,658
Darrel Gholar,Evan Tanner,Evan Tanner,1999-01-08,0,1,,,0.8333333,4,-10.16,10.16,9,-9,-12.96001,12.96001,0,0,11,40,-29,29,-3.16666668653488,3.16666668653488,0,0,0,0,0,0,0,0,0,0,0,0
Valeri Ignatov,Evan Tanner,Evan Tanner,1999-03-05,0,1,,,0.5,4,-7.62001,7.62001,-15,15,-13.96001,13.96001,0,0,3,40,-37,37,-3.5,3.5,0,1,0,0,-1,1,0,0,0,56,-56,56
Lance Gibson,Evan Tanner,Evan Tanner,2000-12-16,0,1,1,-1,0.8,4,-7.62001,7.62001,0,0,-9.960007,9.960007,0,251,9,40,-31,31,-3.19999998807907,3.19999998807907,0,2,0,0,-2,2,0,0,0,652,-652,652
Tito Ortiz,Evan Tanner,Tito Ortiz,2001-02-23,1,0,-4,4,1.583333,4,7.619995,-7.619995,20,-20,0,0,1,1,31,40,-9,9,-2.41666662693024,2.41666662693024,1,3,1,0,-2,2,1,-1,315,69,246,-246
Homer Moore,Evan Tanner,Evan Tanner,2001-11-02,0,1,-1,1,2.888889,4,-5.080002,5.080002,20,-20,-7.960007,7.960007,273,0,35,40,-5,5,-1.11111116409302,1.11111116409302,0,0,0,1,0,0,-1,1,0,252,-252,252
Elvis Sinosic,Evan Tanner,Evan Tanner,2002-03-22,0,1,0,0,0.6363636,4,7.619995,-7.619995,20,-20,7.619995,-7.619995,0,103,18,40,-22,22,-3.36363637447357,3.36363637447357,0,1,0,1,-1,1,-1,1,0,140,-140,140
Chris Haseman,Evan Tanner,Evan Tanner,2002-07-13,0,1,2,-2,1.176471,4,-2.540009,2.540009,20,-20,-3.960007,3.960007,14,829,37,40,-3,3,-2.82352936267853,2.82352936267853,0,2,0,1,-2,2,-1,1,0,113,-113,113
Rich Franklin,Evan Tanner,Rich Franklin,2003-04-25,1,0,-4,4,4.142857,4,2.539993,-2.539993,0,0,5.079987,-5.079987,2,0,36,40,-4,4,0.142857074737549,-0.142857074737549,0,3,0,1,-3,3,-1,1,0,286,-286,286
Phil Baroni,Evan Tanner,Evan Tanner,2003-11-21,0,1,-5,5,0.8333333,4,-7.62001,7.62001,-15,15,-5.080002,5.080002,14,147,33,40,-7,7,-3.16666668653488,3.16666668653488,0,0,0,2,0,0,-2,2,266,210,56,-56
Phil Baroni,Evan Tanner,Evan Tanner,2004-06-19,0,1,-5,5,0.8333333,4,-7.62001,7.62001,-15,15,-5.080002,5.080002,3,365,33,40,-7,7,-3.16666668653488,3.16666668653488,0,1,1,2,-1,1,-1,1,211,211,0,0
Robbie Lawler,Evan Tanner,Evan Tanner,2004-10-22,0,1,-11,11,1.875,4,-2.540009,2.540009,-15,15,0,0,33,0,46,40,6,-6,-2.125,2.125,1,2,0,2,-1,1,-2,2,336,125,211,-211
Rich Franklin,Evan Tanner,Rich Franklin,2005-06-04,1,0,-4,4,4.142857,4,2.539993,-2.539993,0,0,5.079987,-5.079987,75,48,36,40,-4,4,0.142857074737549,-0.142857074737549,3,3,0,2,0,0,-2,2,56,225,-169,169
David Loiseau,Evan Tanner,David Loiseau,2005-10-03,1,0,-9,9,2.090909,4,0,0,0,0,5.079987,-5.079987,48,360,34,40,-6,6,-1.90909099578857,1.90909099578857,2,0,0,3,2,-2,-3,3,121,121,0,0
Justin Levens,Evan Tanner,Evan Tanner,2006-04-15,0,1,-10,10,1.428571,4,-2.540009,2.540009,0,0,-4.960007,4.960007,19,132,17,40,-23,23,-2.57142853736877,2.57142853736877,0,0,0,4,0,0,-4,4,0,194,-194,194
Yushin Okami,Evan Tanner,Yushin Okami,2008-03-01,1,0,-11,11,2.833333,4,5.080002,-5.080002,-15,15,2.539993,-2.539993,37,117,46,40,6,-6,-1.16666674613953,1.16666674613953,3,1,0,4,2,-2,-4,4,329,686,-357,357
Kendall Grove,Evan Tanner,Kendall Grove,2008-06-21,1,0,-12,12,1.352941,4,15.23999,-15.23999,0,0,12.7,-12.7,82,539,40,40,0,0,-2.64705884456635,2.64705884456635,0,0,1,5,0,0,-4,4,154,112,42,-42
Laverne Clark,Fabiano Iha,Laverne Clark,1999-05-07,1,0,-3,3,1.285714,1.8,7.619995,-7.619995,15,-15,8,-8,0,0,48,14,34,-34,-0.514285683631897,0.514285683631897,1,0,0,0,1,-1,0,0,420,0,420,-420
Laverne Clark,Fabiano Iha,Fabiano Iha,2000-09-22,0,1,-4,4,1.285714,1.8,7.619995,-7.619995,15,-15,8,-8,24,7,48,14,34,-34,-0.514285683631897,0.514285683631897,3,0,0,1,3,-3,-1,1,161,504,-343,343
Gabriel Gonzaga,Fabiano Scherner,Gabriel Gonzaga,2006-05-27,1,0,-6,6,1.545455,1.1,-2.539993,2.539993,-15,15,3.999329e-02,-3.999329e-02,143,38,28,21,7,-7,0.445454478263855,-0.445454478263855,1,0,0,0,1,-1,0,0,189,0,189,-189
Jerry Bohlander,Fabio Gurgel,Jerry Bohlander,1996-09-20,1,0,,,2.75,1.5,-2.540009,2.540009,-6,6,-3,3,0,0,15,5,10,-10,1.25,-1.25,0,0,1,0,0,0,1,-1,217,0,217,-217
Kyle Kingsbury,Fabio Maldonado,Kyle Kingsbury,2011-06-04,1,0,-2,2,1.833333,2.090909,7.619995,-7.619995,0,0,10.16,-10.16,157,94,17,34,-17,17,-0.257575631141663,0.257575631141663,1,0,0,0,1,-1,0,0,119,0,119,-119
Roger Hollett,Fabio Maldonado,Fabio Maldonado,2013-05-18,0,1,1,-1,2.6,2.090909,-5.080002,5.080002,0,0,-6.5,6.5,267,198,18,34,-16,16,0.509090900421143,-0.509090900421143,0,0,0,0,0,0,0,0,0,714,-714,714
Joey Beltran,Fabio Maldonado,Fabio Maldonado,2013-10-09,0,1,-2,2,1.214286,2.090909,0,0,-20,20,0,0,366,37,31,34,-3,3,-0.876623272895813,0.876623272895813,0,1,1,0,-1,1,1,-1,455,144,311,-311
Quinton Jackson,Fabio Maldonado,Quinton Jackson,2015-04-25,1,0,1,-1,3.083333,2.090909,0,0,0,0,-5.080002,5.080002,71,172,49,34,15,-15,0.992424249649048,-0.992424249649048,0,2,0,0,-2,2,0,0,819,563,256,-256
Corey Anderson,Fabio Maldonado,Corey Anderson,2015-11-07,1,0,-9,9,2.8,2.090909,5.080002,-5.080002,0,0,10.16,-10.16,512,0,19,34,-15,15,0.709090948104858,-0.709090948104858,1,0,1,0,1,-1,1,-1,63,196,-133,133
Andrei Arlovski,Fabricio Werdum,Andrei Arlovski,2007-04-21,1,0,-1,1,1.545455,2.666667,-2.539993,2.539993,9,-9,0,0,37,50,56,33,23,-23,-1.12121224403381,1.12121224403381,1,0,3,0,1,-1,3,-3,112,0,112,-112
Gabriel Gonzaga,Fabricio Werdum,Fabricio Werdum,2008-01-19,0,1,-2,2,1.545455,2.666667,-5.079987,5.079987,11,-11,-2.540009,2.540009,121,169,28,33,-5,5,-1.12121224403381,1.12121224403381,3,0,0,0,3,-3,0,0,385,273,112,-112
Brandon Vera,Fabricio Werdum,Fabricio Werdum,2008-06-07,0,1,0,0,2.142857,2.666667,-2.539993,2.539993,-1,1,2.539993,-2.539993,37,133,22,33,-11,11,-0.523809671401978,0.523809671401978,0,1,0,0,-1,1,0,0,0,140,-140,140
Junior Dos Santos,Fabricio Werdum,Junior Dos Santos,2008-10-25,1,0,-7,7,2.333333,2.666667,0,0,7,-7,0,0,3,0,30,33,-3,3,-0.333333492279053,0.333333492279053,0,2,0,0,-2,2,0,0,0,140,-140,140
Roy Nelson,Fabricio Werdum,Fabricio Werdum,2012-02-04,0,1,1,-1,1.571429,2.666667,-10.15999,10.15999,32,-32,-10.16,10.16,164,64,36,33,3,-3,-1.09523820877075,1.09523820877075,2,0,0,1,2,-2,-1,1,675,1197,-522,522
Mike Russow,Fabricio Werdum,Fabricio Werdum,2012-06-23,0,1,1,-1,5,2.666667,-7.619995,7.619995,24,-24,-10.16,10.16,10,11,18,33,-15,15,2.33333325386047,-2.33333325386047,0,1,0,1,-1,1,-1,1,0,140,-140,140
Antonio Rodrigo Nogueira,Fabricio Werdum,Fabricio Werdum,2013-06-08,0,1,2,-2,3.4,2.666667,-2.539993,2.539993,9,-9,0,0,123,170,44,33,11,-11,0.733333349227905,-0.733333349227905,1,2,1,1,-1,1,0,0,651,350,301,-301
Travis Browne,Fabricio Werdum,Fabricio Werdum,2014-04-19,0,1,-5,5,2.571429,2.666667,5.080002,-5.080002,24,-24,5.080002,-5.080002,48,304,25,33,-8,8,-9.5238208770752e-02,9.5238208770752e-02,2,3,1,1,-1,1,0,0,245,315,-70,70
Mark Hunt,Fabricio Werdum,Fabricio Werdum,2014-11-15,0,1,3,-3,0.9285714,2.666667,-15.23999,15.23999,34,-34,-12.7,12.7,113,7,27,33,-6,6,-1.73809534311295,1.73809534311295,5,4,0,1,1,-1,-1,1,56,210,-154,154
Cain Velasquez,Fabricio Werdum,Fabricio Werdum,2015-06-13,0,1,-5,5,4.666667,2.666667,-7.619995,7.619995,9,-9,0,0,178,30,17,33,-16,16,1.99999976158142,-1.99999976158142,0,5,0,1,-5,5,-1,1,0,210,-210,210
Stipe Miocic,Fabricio Werdum,Stipe Miocic,2016-05-14,1,0,-5,5,5,2.666667,0,0,9,-9,7.619995,-7.619995,2,0,24,33,-9,9,2.33333325386047,-2.33333325386047,1,6,1,1,-5,5,0,0,1064,336,728,-728
Travis Browne,Fabricio Werdum,Fabricio Werdum,2016-09-10,0,1,-5,5,2.571429,2.666667,5.080002,-5.080002,24,-24,5.080002,-5.080002,13,90,25,33,-8,8,-9.5238208770752e-02,9.5238208770752e-02,0,0,2,2,0,0,0,0,63,119,-56,56
Alistair Overeem,Fabricio Werdum,Alistair Overeem,2017-07-08,1,0,-2,2,2.473684,2.666667,0,0,34,-34,7.619995,-7.619995,80,158,66,33,33,-33,-0.19298243522644,0.19298243522644,1,1,2,2,0,0,0,0,938,301,637,-637
Walt Harris,Fabricio Werdum,Fabricio Werdum,2017-10-07,0,1,-6,6,1.3,2.666667,2.540009,-2.540009,19,-19,0,0,0,31,23,33,-10,10,-1.36666679382324,1.36666679382324,1,0,2,2,1,-1,0,0,265,91,174,-174
Marcin Tybura,Fabricio Werdum,Fabricio Werdum,2017-11-18,0,1,-8,8,3,2.666667,-2.539993,2.539993,18,-18,2.539993,-2.539993,24,241,32,33,-1,1,0.333333253860474,-0.333333253860474,0,1,0,2,-1,1,-2,2,0,42,-42,42
Alexander Volkov,Fabricio Werdum,Alexander Volkov,2018-03-17,1,0,-11,11,3.7,2.666667,7.62001,-7.62001,19,-19,7.619995,-7.619995,106,399,47,33,14,-14,1.03333330154419,-1.03333330154419,0,2,0,2,-2,2,-2,2,0,119,-119,119
Aleksei Oleinik,Fabricio Werdum,Aleksei Oleinik,2020-05-09,1,0,0,0,3.529412,2.666667,-5.079987,5.079987,9,-9,7.619995,-7.619995,233,235,77,33,44,-44,0.862745046615601,-0.862745046615601,0,0,1,3,0,0,-2,2,385,784,-399,399
Alexander Gustafsson,Fabricio Werdum,Fabricio Werdum,2020-07-25,0,1,-9,9,2.25,2.666667,2.540009,-2.540009,-26,26,5.080002,-5.080002,12,66,26,33,-7,7,-0.416666746139526,0.416666746139526,0,0,2,3,0,0,-1,1,420,77,343,-343
Matt Lindland,Falaniko Vitale,Falaniko Vitale,2003-06-06,0,1,5,-5,2.444444,2.727273,5.080002,-5.080002,0,0,9.960007,-9.960007,55,27,31,41,-10,10,-0.282828330993652,0.282828330993652,2,0,0,0,2,-2,0,0,252,0,252,-252
Matt Lindland,Falaniko Vitale,Matt Lindland,2003-11-21,1,0,4,-4,2.444444,2.727273,5.080002,-5.080002,0,0,9.960007,-9.960007,497,199,31,41,-10,10,-0.282828330993652,0.282828330993652,0,1,1,0,-1,1,1,-1,168,168,0,0
Don Madge,Fares Ziam,Don Madge,2019-09-07,1,0,6,-6,3,3.5,-2.539993,2.539993,0,0,-7.619995,7.619995,577,146,12,18,-6,6,-0.5,0.5,0,0,0,0,0,0,0,0,0,0,0,0
Jamie Mullarkey,Fares Ziam,Fares Ziam,2020-10-17,0,1,3,-3,2.833333,3.5,-2.539993,2.539993,0,0,-2.539993,2.539993,416,72,23,18,5,-5,-0.666666746139526,0.666666746139526,0,0,0,0,0,0,0,0,378,406,-28,28
Luigi Vendramini,Fares Ziam,Fares Ziam,2021-06-12,0,1,1,-1,3,3.5,-12.7,12.7,0,0,-5.080002,5.080002,189,0,12,18,-6,6,-0.5,0.5,0,1,1,0,-1,1,1,-1,994,238,756,-756
Terrance McKinney,Fares Ziam,Terrance McKinney,2022-02-26,1,0,3,-3,2.8,3.5,-7.619995,7.619995,0,0,-5.080002,5.080002,123,4,19,18,1,-1,-0.700000047683716,0.700000047683716,0,2,0,0,-2,2,0,0,0,259,-259,259
Michal Figlak,Fares Ziam,Fares Ziam,2022-09-03,0,1,1,-1,8,3.5,-7.619995,7.619995,0,0,-12.7,12.7,95,408,9,18,-9,9,4.5,-4.5,0,0,0,0,0,0,0,0,0,189,-189,189
Jai Herbert,Fares Ziam,Fares Ziam,2023-07-22,0,1,9,-9,2.4,3.5,0,0,0,0,5.080002,-5.080002,252,90,17,18,-1,1,-1.09999990463257,1.09999990463257,1,1,2,0,0,0,2,-2,364,322,42,-42
Lisa Ellis,Felice Herrig,Felice Herrig,2014-12-12,0,1,2,-2,1.363636,1.4,0,0,0,0,-0.1000061,0.1000061,164,297,26,24,2,-2,-3.63636016845703e-02,3.63636016845703e-02,0,0,0,0,0,0,0,0,0,0,0,0
Kailin Curran,Felice Herrig,Felice Herrig,2016-07-23,0,1,-6,6,0.8,1.4,0,0,0,0,0,0,0,60,9,24,-15,15,-0.599999964237213,0.599999964237213,1,1,1,0,0,0,1,-1,226,589,-363,363
Alexa Grasso,Felice Herrig,Felice Herrig,2017-02-04,0,1,-9,9,5.333333,1.4,2.540009,-2.540009,10,-10,2.539993,-2.539993,14,37,19,24,-5,5,3.93333351612091,-3.93333351612091,0,2,0,0,-2,2,0,0,0,196,-196,196
Cortney Casey,Felice Herrig,Felice Herrig,2017-12-02,0,1,-3,3,1,1.4,7.619995,-7.619995,10,-10,5.079987,-5.079987,7,95,20,24,-4,4,-0.399999976158142,0.399999976158142,0,3,0,0,-3,3,0,0,378,301,77,-77
Megan Anderson,Felicia Spencer,Felicia Spencer,2019-05-18,0,1,1,-1,2.2,3,15.24001,-15.24001,0,0,10.16,-10.16,2,167,16,12,4,-4,-0.799999952316284,0.799999952316284,1,0,0,0,1,-1,0,0,140,0,140,-140
Cristiane Justino,Felicia Spencer,Cristiane Justino,2019-07-27,1,0,6,-6,10.5,3,5.080002,-5.080002,0,0,0,0,112,214,23,12,11,-11,7.5,-7.5,0,1,1,0,-1,1,1,-1,210,70,140,-140
Zarah Fairn,Felicia Spencer,Felicia Spencer,2020-02-29,0,1,7,-7,1,3,5.080002,-5.080002,-10,10,10.16,-10.16,0,141,12,12,0,0,-2,2,0,0,0,0,0,0,0,0,0,217,-217,217
Amanda Nunes,Felicia Spencer,Amanda Nunes,2020-06-06,1,0,3,-3,4.6,3,5.080002,-5.080002,-10,10,2.539993,-2.539993,481,9,28,12,16,-16,1.59999990463257,-1.59999990463257,5,1,1,0,4,-4,1,-1,756,98,658,-658
Norma Dumont,Felicia Spencer,Norma Dumont,2021-05-22,1,0,0,0,5,3,2.539993,-2.539993,0,0,-2.540009,2.540009,81,178,12,12,0,0,2,-2,1,0,0,0,1,-1,0,0,175,350,-175,175
Leah Letson,Felicia Spencer,Felicia Spencer,2021-11-13,0,1,-1,1,1.666667,3,2.539993,-2.539993,0,0,7.619995,-7.619995,61,718,8,12,-4,4,-1.33333337306976,1.33333337306976,1,0,0,0,1,-1,0,0,1079,175,904,-904
Iuri Alcantara,Felipe Arantes,Iuri Alcantara,2011-08-27,1,0,8,-8,3.5,1.8,2.539993,-2.539993,0,0,-5.080002,5.080002,434,135,45,28,17,-17,1.70000004768372,-1.70000004768372,0,0,0,0,0,0,0,0,0,0,0,0
Shane Campbell,Felipe Silva,Felipe Silva,2016-08-27,0,1,-3,3,2.333333,4,0,0,0,0,-15.24001,15.24001,0,4,20,10,10,-10,-1.66666674613953,1.66666674613953,0,0,1,0,0,0,1,-1,90,0,90,-90
Claudio Puelles,Felipe Silva,Claudio Puelles,2018-05-19,1,0,-12,12,4.333333,4,-5.080002,5.080002,0,0,-12.7,12.7,88,172,16,10,6,-6,0.333333492279053,-0.333333492279053,0,1,0,0,-1,1,0,0,0,630,-630,630
Sam Adkins,Felix Lee Mitchell,Sam Adkins,1996-07-12,1,0,,,0.35,0.2857143,,,,,32,-32,0,0,27,9,18,-18,6.42856955528259e-02,-6.42856955528259e-02,0,0,1,0,0,0,1,-1,147,0,147,-147
Mark Hall,Felix Lee Mitchell,Mark Hall,1996-12-07,1,0,,,0.8333333,0.2857143,,,,,15,-15,0,0,11,9,2,-2,0.547619014978409,-0.547619014978409,3,0,0,0,3,-3,0,0,204,148,56,-56
Julian Erosa,Fernando Padilla,Fernando Padilla,2023-04-29,0,1,7,-7,2.333333,3,0,0,0,0,-5.079987,5.079987,0,2,40,20,20,-20,-0.666666746139526,0.666666746139526,4,0,2,0,4,-4,2,-2,448,0,448,-448
Kyle Nelson,Fernando Padilla,Kyle Nelson,2023-09-16,1,0,6,-6,3,3,-5.080002,5.080002,0,0,-12.7,12.7,0,7,20,20,0,0,0,0,0,1,1,0,-1,1,1,-1,1099,140,959,-959
Paul Jones,Flavio Luiz Moura,Paul Jones,1999-07-16,1,0,,,11,2.714286,-5.080002,5.080002,16,-16,-5,5,237,14,12,26,-14,14,8.28571438789368,-8.28571438789368,0,0,0,0,0,0,0,0,0,0,0,0
Thales Leites,Floyd Sword,Thales Leites,2007-06-23,1,0,-5,5,3.111111,4,2.539993,-2.539993,0,0,13.12,-13.12,149,38,37,15,22,-22,-0.888888835906982,0.888888835906982,1,0,0,0,1,-1,0,0,77,0,77,-77
Stephan Bonnar,Forrest Griffin,Forrest Griffin,2005-04-09,0,1,2,-2,1.666667,2.714286,2.539993,-2.539993,0,0,5.080002,-5.080002,19,154,24,26,-2,2,-1.04761898517609,1.04761898517609,0,0,0,0,0,0,0,0,0,0,0,0
Stephan Bonnar,Forrest Griffin,Forrest Griffin,2006-08-26,0,1,2,-2,1.666667,2.714286,2.539993,-2.539993,0,0,5.080002,-5.080002,0,17,24,26,-2,2,-1.04761898517609,1.04761898517609,0,1,0,0,-1,1,0,0,59,504,-445,445
Rashad Evans,Forrest Griffin,Rashad Evans,2008-12-27,1,0,0,0,2.375,2.714286,-7.619995,7.619995,0,0,-5.080002,5.080002,131,3,27,26,1,-1,-0.339285612106323,0.339285612106323,5,2,0,0,3,-3,0,0,112,854,-742,742
Rich Franklin,Forrest Griffin,Forrest Griffin,2011-02-05,0,1,5,-5,4.142857,2.714286,-5.080002,5.080002,-20,20,-2.540009,2.540009,21,353,36,26,10,-10,1.42857146263123,-1.42857146263123,2,0,2,1,2,-2,1,-1,238,770,-532,532
Sammy Morgan,Forrest Petz,Forrest Petz,2006-08-17,0,1,-6,6,1.5,2.6,2.540009,-2.540009,0,0,-0.3399963,0.3399963,0,445,30,36,-6,6,-1.09999990463257,1.09999990463257,0,0,0,0,0,0,0,0,0,0,0,0
Marcus Davis,Forrest Petz,Marcus Davis,2006-10-10,1,0,2,-2,2,2.6,2.540009,-2.540009,0,0,-2.539993,2.539993,50,21,33,36,-3,3,-0.599999904632568,0.599999904632568,0,1,1,0,-1,1,1,-1,339,54,285,-285
Kuniyoshi Hironaka,Forrest Petz,Kuniyoshi Hironaka,2007-04-05,1,0,-1,1,2.555556,2.6,2.540009,-2.540009,-2,2,-2.539993,2.539993,603,48,32,36,-4,4,-4.44443225860596e-02,4.44443225860596e-02,0,0,0,0,0,0,0,0,0,177,-177,177
Luigi Fioravanti,Forrest Petz,Forrest Petz,2007-06-12,0,1,-5,5,1.733333,2.6,-2.539993,2.539993,0,0,-2.539993,2.539993,1,0,41,36,5,-5,-0.866666555404663,0.866666555404663,0,0,0,0,0,0,0,0,101,68,33,-33
Joshua Burkman,Forrest Petz,Joshua Burkman,2007-10-20,1,0,-5,5,1.75,2.6,2.540009,-2.540009,0,0,2.540009,-2.540009,150,216,44,36,8,-8,-0.849999904632568,0.849999904632568,0,1,0,0,-1,1,0,0,147,130,17,-17
Brian Foster,Forrest Petz,Brian Foster,2010-09-15,1,0,-8,8,2.7,2.6,0,0,0,0,0,0,10,0,37,36,1,-1,0.100000143051147,-0.100000143051147,0,0,0,0,0,0,0,0,207,1061,-854,854
Chris Camozzi,Francis Carmont,Francis Carmont,2011-10-29,0,1,-6,6,1.846154,2.083333,-2.539993,2.539993,-20,20,-7.619995,7.619995,360,284,37,37,0,0,-0.237179398536682,0.237179398536682,0,0,0,0,0,0,0,0,245,0,245,-245
William Gomis,Francis Marshall,William Gomis,2023-04-22,1,0,1,-1,6.5,3.5,7.62001,-7.62001,0,0,2.539993,-2.539993,17,260,15,9,6,-6,3,-3,0,0,0,0,0,0,0,0,0,0,0,0
Isaac Dulgarian,Francis Marshall,Isaac Dulgarian,2023-08-12,1,0,3,-3,6,3.5,-5.080002,5.080002,0,0,-2.540009,2.540009,258,0,6,9,-3,3,2.5,-2.5,0,0,0,0,0,0,0,0,0,112,-112,112
Luis Henrique,Francis Ngannou,Francis Ngannou,2015-12-19,0,1,-7,7,2,5.666667,-5.079987,5.079987,-7,7,-22.86,22.86,289,1,15,20,-5,5,-3.66666650772095,3.66666650772095,0,0,0,0,0,0,0,0,0,0,0,0
Curtis Blaydes,Francis Ngannou,Francis Ngannou,2016-04-10,0,1,-4,4,4.25,5.666667,0,0,15,-15,-7.62001,7.62001,65,77,21,20,1,-1,-1.41666650772095,1.41666650772095,0,1,0,0,-1,1,0,0,0,113,-113,113
Bojan Mihajlovic,Francis Ngannou,Francis Ngannou,2016-07-23,0,1,7,-7,1.666667,5.666667,-12.7,12.7,-45,45,-25.40001,25.40001,0,6,16,20,-4,4,-3.99999988079071,3.99999988079071,0,2,0,0,-2,2,0,0,0,104,-104,104
Anthony Hamilton,Francis Ngannou,Francis Ngannou,2016-12-09,0,1,6,-6,1.666667,5.666667,2.540009,-2.540009,10,-10,-17.78001,17.78001,44,6,24,20,4,-4,-3.99999988079071,3.99999988079071,2,3,0,0,-1,1,0,0,608,139,469,-469
Andrei Arlovski,Francis Ngannou,Francis Ngannou,2017-01-28,0,1,7,-7,1.545455,5.666667,-2.539993,2.539993,-10,10,-15.24001,15.24001,0,3,56,20,36,-36,-4.12121200561523,4.12121200561523,0,4,5,0,-4,4,5,-5,147,50,97,-97
Stipe Miocic,Francis Ngannou,Stipe Miocic,2018-01-20,1,0,4,-4,5,5.666667,0,0,-10,10,-7.62001,7.62001,905,2,24,20,4,-4,-0.666666507720947,0.666666507720947,3,5,1,0,-2,2,1,-1,497,357,140,-140
Derrick Lewis,Francis Ngannou,Derrick Lewis,2018-07-07,1,0,2,-2,2.454545,5.666667,-2.539993,2.539993,10,-10,-10.16,10.16,1,0,38,20,18,-18,-3.21212100982666,3.21212100982666,4,0,1,0,4,-4,1,-1,139,168,-29,29
Curtis Blaydes,Francis Ngannou,Francis Ngannou,2018-11-24,0,1,-5,5,4.25,5.666667,0,0,15,-15,-7.62001,7.62001,0,8,21,20,1,-1,-1.41666650772095,1.41666650772095,5,0,1,0,5,-5,1,-1,168,140,28,-28
Junior Dos Santos,Francis Ngannou,Francis Ngannou,2019-06-29,0,1,3,-3,2.333333,5.666667,0,0,-12,12,-15.24001,15.24001,0,4,30,20,10,-10,-3.33333325386047,3.33333325386047,3,1,3,0,2,-2,3,-3,112,217,-105,105
Stipe Miocic,Francis Ngannou,Francis Ngannou,2021-03-27,0,1,4,-4,5,5.666667,0,0,-10,10,-7.62001,7.62001,4,22,24,20,4,-4,-0.666666507720947,0.666666507720947,4,2,1,0,2,-2,1,-1,1162,637,525,-525
Ciryl Gane,Francis Ngannou,Francis Ngannou,2022-01-22,0,1,-4,4,6,5.666667,0,0,-5,5,-5.080002,5.080002,171,509,14,20,-6,6,0.333333492279053,-0.333333492279053,5,3,0,0,2,-2,0,0,168,301,-133,133
Amir Albazi,Francisco Figueiredo,Amir Albazi,2022-08-20,1,0,-4,4,17,2.6,-2.539993,2.539993,0,0,0,0,156,0,18,18,0,0,14.4000000953674,-14.4000000953674,2,0,0,0,2,-2,0,0,574,0,574,-574
Jamie Mullarkey,Francisco Prado,Jamie Mullarkey,2023-02-11,1,0,8,-8,2.833333,12,5.080002,-5.080002,0,0,12.70001,-12.70001,287,10,23,13,10,-10,-9.16666674613953,9.16666674613953,0,0,1,0,0,0,1,-1,343,0,343,-343
Ottman Azaitar,Francisco Prado,Francisco Prado,2023-07-15,0,1,12,-12,6.5,12,-5.080002,5.080002,0,0,5.080002,-5.080002,0,49,15,13,2,-2,-5.5,5.5,0,0,1,0,0,0,1,-1,245,154,91,-91
Reuben Duran,Francisco Rivera,Reuben Duran,2011-06-04,1,0,-2,2,1.571429,1.571429,-2.540009,2.540009,0,0,2.539993,-2.539993,415,58,18,18,0,0,0,0,0,0,0,0,0,0,0,0,93,0,93,-93
Edwin Figueroa,Francisco Rivera,Francisco Rivera,2013-02-02,0,1,-3,3,1.8,1.571429,-2.540009,2.540009,0,0,-2.540009,2.540009,128,67,14,18,-4,4,0.22857141494751,-0.22857141494751,1,0,0,0,1,-1,0,0,538,609,-71,71
Takeya Mizugaki,Francisco Rivera,Takeya Mizugaki,2014-05-24,1,0,-2,2,1.909091,1.571429,-2.540009,2.540009,0,0,-2.540009,2.540009,492,43,32,18,14,-14,0.33766233921051,-0.33766233921051,2,1,0,0,1,-1,0,0,169,476,-307,307
Urijah Faber,Francisco Rivera,Urijah Faber,2014-12-06,1,0,2,-2,3.181818,1.571429,-5.080002,5.080002,0,0,-7.62001,7.62001,14,0,46,18,28,-28,1.61038970947266,-1.61038970947266,4,0,0,0,4,-4,0,0,357,196,161,-161
Alex Caceres,Francisco Rivera,Francisco Rivera,2015-06-06,0,1,-7,7,1.5,1.571429,5.080002,-5.080002,10,-10,7.619995,-7.619995,3,0,35,18,17,-17,-7.14285373687744e-02,7.14285373687744e-02,0,0,0,0,0,0,0,0,259,182,77,-77
John Lineker,Francisco Rivera,John Lineker,2015-09-05,1,0,-8,8,3.444444,1.571429,-12.7,12.7,0,0,-7.62001,7.62001,19,13,40,18,22,-22,1.87301588058472,-1.87301588058472,4,1,0,0,3,-3,0,0,217,91,126,-126
Brad Pickett,Francisco Rivera,Brad Pickett,2016-02-27,1,0,3,-3,1.785714,1.571429,-5.080002,5.080002,0,0,-5.080002,5.080002,199,21,39,18,21,-21,0.214285731315613,-0.214285731315613,1,0,0,0,1,-1,0,0,721,175,546,-546
Erik Perez,Francisco Rivera,Erik Perez,2016-07-30,1,0,-8,8,2.833333,1.571429,0,0,0,0,-5.080002,5.080002,300,1,23,18,5,-5,1.2619047164917,-1.2619047164917,1,0,0,0,1,-1,0,0,1449,154,1295,-1295
Renee Forte,Francisco Trevino,Francisco Trevino,2014-03-15,0,1,-6,6,2,4.333333,-5.080002,5.080002,0,0,2.539993,-2.539993,273,163,12,16,-4,4,-2.33333349227905,2.33333349227905,0,0,1,0,0,0,1,-1,175,0,175,-175
Johnny Case,Francisco Trevino,Johnny Case,2015-06-13,1,0,-8,8,3.666667,4.333333,2.540009,-2.540009,0,0,5.080002,-5.080002,331,77,28,16,12,-12,-0.666666746139526,0.666666746139526,2,1,0,0,1,-1,0,0,146,455,-309,309
Sage Northcutt,Francisco Trevino,Sage Northcutt,2015-10-03,1,0,-14,14,5.5,4.333333,7.62001,-7.62001,15,-15,2.539993,-2.539993,0,9,13,16,-3,3,1.16666650772095,-1.16666650772095,0,0,0,0,0,0,0,0,0,112,-112,112
Delson Heleno,Francisco Trinaldo,Francisco Trinaldo,2012-06-23,0,1,1,-1,2.9,3.111111,5.080002,-5.080002,15,-15,5.199997,-5.199997,67,69,39,37,2,-2,-0.211111068725586,0.211111068725586,0,0,0,0,0,0,0,0,0,0,0,0
Gleison Tibau,Francisco Trinaldo,Gleison Tibau,2012-10-13,1,0,-5,5,2.357143,3.111111,2.540009,-2.540009,-15,15,2.539993,-2.539993,397,248,47,37,10,-10,-0.753968238830566,0.753968238830566,1,1,0,0,0,0,0,0,927,112,815,-815
CJ Keith,Francisco Trinaldo,Francisco Trinaldo,2013-01-19,0,1,-8,8,2,3.111111,7.62001,-7.62001,-15,15,0.1999969,-0.1999969,67,239,12,37,-25,25,-1.11111116409302,1.11111116409302,0,0,1,0,0,0,1,-1,211,98,113,-113
Mike Rio,Francisco Trinaldo,Francisco Trinaldo,2013-05-18,0,1,-3,3,2,3.111111,2.540009,-2.540009,-15,15,0,0,60,57,15,37,-22,22,-1.11111116409302,1.11111116409302,0,1,0,0,-1,1,0,0,0,119,-119,119
Piotr Hallmann,Francisco Trinaldo,Piotr Hallmann,2013-09-04,1,0,-9,9,3,3.111111,0,0,-15,15,2.539993,-2.539993,147,102,24,37,-13,13,-0.111111164093018,0.111111164093018,0,2,0,0,-2,2,0,0,0,109,-109,109
Jesse Ronson,Francisco Trinaldo,Francisco Trinaldo,2014-02-15,0,1,-7,7,1.75,3.111111,2.540009,-2.540009,-15,15,0,0,36,118,33,37,-4,4,-1.36111116409302,1.36111116409302,0,0,0,0,0,0,0,0,0,164,-164,164
Michael Chiesa,Francisco Trinaldo,Michael Chiesa,2014-05-24,1,0,-9,9,2.571429,3.111111,10.16,-10.16,0,0,12.7,-12.7,529,0,25,37,-12,12,-0.539682626724243,0.539682626724243,1,1,0,0,0,0,0,0,199,98,101,-101
Leandro Silva,Francisco Trinaldo,Francisco Trinaldo,2014-09-13,0,1,-8,8,3.333333,3.111111,0,0,-15,15,5.080002,-5.080002,409,238,26,37,-11,11,0.222222089767456,-0.222222089767456,0,0,0,0,0,0,0,0,0,112,-112,112
Akbarh Arreola,Francisco Trinaldo,Francisco Trinaldo,2015-03-21,0,1,-4,4,2.090909,3.111111,2.540009,-2.540009,-15,15,2.539993,-2.539993,0,557,34,37,-3,3,-1.02020215988159,1.02020215988159,1,1,0,0,0,0,0,0,119,189,-70,70
Norman Parke,Francisco Trinaldo,Francisco Trinaldo,2015-05-30,0,1,-8,8,3.833333,3.111111,5.080002,-5.080002,-15,15,0,0,376,46,29,37,-8,8,0.722222089767456,-0.722222089767456,0,2,0,0,-2,2,0,0,132,70,62,-62
Chad Laprise,Francisco Trinaldo,Francisco Trinaldo,2015-08-23,0,1,-7,7,3.25,3.111111,2.540009,-2.540009,0,0,2.539993,-2.539993,0,38,17,37,-20,20,0.138888835906982,-0.138888835906982,0,3,0,0,-3,3,0,0,0,85,-85,85
Ross Pearson,Francisco Trinaldo,Francisco Trinaldo,2016-01-17,0,1,-6,6,1.25,3.111111,-2.539993,2.539993,-15,15,-2.540009,2.540009,62,65,36,37,-1,1,-1.86111116409302,1.86111116409302,1,4,1,0,-3,3,1,-1,309,147,162,-162
Yancy Medeiros,Francisco Trinaldo,Francisco Trinaldo,2016-05-14,0,1,-9,9,1.875,3.111111,2.540009,-2.540009,-15,15,12.7,-12.7,95,211,23,37,-14,14,-1.23611116409302,1.23611116409302,0,5,1,0,-5,5,1,-1,343,118,225,-225
Paul Felder,Francisco Trinaldo,Francisco Trinaldo,2016-09-24,0,1,-6,6,2.833333,3.111111,5.080002,-5.080002,-15,15,0,0,27,262,23,37,-14,14,-0.277777910232544,0.277777910232544,0,6,0,0,-6,6,0,0,385,133,252,-252
Kevin Lee,Francisco Trinaldo,Kevin Lee,2017-03-11,1,0,-14,14,2.25,3.111111,0,0,0,0,17.78,-17.78,157,45,26,37,-11,11,-0.861111164093018,0.861111164093018,2,7,1,0,-5,5,1,-1,112,168,-56,56
Jim Miller,Francisco Trinaldo,Francisco Trinaldo,2017-10-28,0,1,-5,5,2.117647,3.111111,-2.539993,2.539993,-15,15,2.539993,-2.539993,146,280,53,37,16,-16,-0.99346399307251,0.99346399307251,0,0,0,0,0,0,0,0,112,231,-119,119
Evan Dunham,Francisco Trinaldo,Francisco Trinaldo,2018-09-22,0,1,-4,4,2,3.111111,2.540009,-2.540009,-15,15,0,0,32,58,27,37,-10,10,-1.11111116409302,1.11111116409302,4,1,1,0,3,-3,1,-1,735,329,406,-406
Alexander Hernandez,Francisco Trinaldo,Alexander Hernandez,2019-07-20,1,0,-14,14,2.333333,3.111111,0,0,-25,25,5.080002,-5.080002,20,0,20,37,-17,17,-0.777777910232544,0.777777910232544,0,2,0,0,-2,2,0,0,0,301,-301,301
Bobby Green,Francisco Trinaldo,Francisco Trinaldo,2019-11-16,0,1,-8,8,2.142857,3.111111,2.540009,-2.540009,-15,15,2.539993,-2.539993,223,64,44,37,7,-7,-0.968254089355469,0.968254089355469,0,0,1,0,0,0,1,-1,336,119,217,-217
John Makdessi,Francisco Trinaldo,Francisco Trinaldo,2020-03-14,0,1,-7,7,2,3.111111,-2.539993,2.539993,-15,15,-5.080002,5.080002,0,0,27,37,-10,10,-1.11111116409302,1.11111116409302,3,1,1,0,2,-2,1,-1,357,119,238,-238
Jai Herbert,Francisco Trinaldo,Francisco Trinaldo,2020-07-25,0,1,-9,9,2.4,3.111111,10.16,-10.16,-15,15,17.78,-17.78,200,198,17,37,-20,20,-0.711111068725586,0.711111068725586,0,2,0,0,-2,2,0,0,0,133,-133,133
Muslim Salikhov,Francisco Trinaldo,Muslim Salikhov,2021-06-05,1,0,-6,6,4.75,3.111111,5.080002,-5.080002,0,0,0,0,127,40,23,37,-14,14,1.63888883590698,-1.63888883590698,3,3,0,0,0,0,0,0,329,315,14,-14
Dwight Grant,Francisco Trinaldo,Francisco Trinaldo,2021-10-23,0,1,-6,6,1.833333,3.111111,10.16,-10.16,15,-15,15.23999,-15.23999,11,285,17,37,-20,20,-1.27777779102325,1.27777779102325,1,0,1,0,1,-1,1,-1,182,140,42,-42
Danny Roberts,Francisco Trinaldo,Francisco Trinaldo,2022-05-07,0,1,-9,9,2.25,3.111111,10.16,-10.16,0,0,10.16,-10.16,39,261,26,37,-11,11,-0.861111164093018,0.861111164093018,0,1,1,0,-1,1,1,-1,1148,196,952,-952
Randy Brown,Francisco Trinaldo,Randy Brown,2022-10-01,1,0,-12,12,3.4,3.111111,15.24001,-15.24001,0,0,20.31999,-20.31999,38,321,22,37,-15,15,0.288888931274414,-0.288888931274414,3,2,2,0,1,-1,2,-2,147,147,0,0
Damien Brown,Frank Camacho,Frank Camacho,2017-11-18,0,1,4,-4,1.416667,2.2,0,0,0,0,-12.7,12.7,132,138,29,32,-3,3,-0.783333420753479,0.783333420753479,0,0,1,0,0,0,1,-1,161,0,161,-161
Ian Freeman,Frank Mir,Ian Freeman,2002-07-13,1,0,12,-12,2.857143,1.636364,-10.16,10.16,-39,39,-17.66,17.66,177,15,27,29,-2,2,1.22077929973602,-1.22077929973602,2,0,0,0,2,-2,0,0,659,0,659,-659
David Abbott,Frank Mir,Frank Mir,2003-02-28,0,1,,,0.6666667,1.636364,-7.619995,7.619995,1,-1,-18.16,18.16,38,0,25,29,-4,4,-0.969696938991547,0.969696938991547,0,0,2,1,0,0,1,-1,1596,230,1366,-1366
Marcio Cruz,Frank Mir,Marcio Cruz,2006-02-04,1,0,1,-1,2.666667,1.636364,2.539993,-2.539993,-32,32,-4.660004,4.660004,217,15,11,29,-18,18,1.0303031206131,-1.0303031206131,1,1,0,1,0,0,-1,1,120,1072,-952,952
Dan Christison,Frank Mir,Frank Mir,2006-07-08,0,1,7,-7,2.857143,1.636364,12.7,-12.7,1,-1,-14.66,14.66,192,472,27,29,-2,2,1.22077929973602,-1.22077929973602,1,0,0,2,1,-1,-2,2,93,154,-61,61
Antoni Hardonk,Frank Mir,Frank Mir,2007-08-25,0,1,3,-3,1.333333,1.636364,2.539993,-2.539993,-19,19,-2.540009,2.540009,2,63,14,29,-15,15,-0.303030252456665,0.303030252456665,0,1,0,2,-1,1,-2,2,142,413,-271,271
Brock Lesnar,Frank Mir,Frank Mir,2008-02-02,0,1,2,-2,1.666667,1.636364,0,0,1,-1,5.080002,-5.080002,68,0,8,29,-21,21,3.03030014038086e-02,-3.03030014038086e-02,0,2,0,2,-2,2,-2,2,0,161,-161,161
Brock Lesnar,Frank Mir,Brock Lesnar,2009-07-11,1,0,1,-1,1.666667,1.636364,0,0,1,-1,5.080002,-5.080002,346,0,8,29,-21,21,3.03030014038086e-02,-3.03030014038086e-02,0,3,0,2,-3,3,-2,2,525,525,0,0
Cheick Kongo,Frank Mir,Frank Mir,2009-12-12,0,1,4,-4,2.7,1.636364,2.539993,-2.539993,-24,24,7.619995,-7.619995,23,6,37,29,8,-8,1.06363642215729,-1.06363642215729,0,0,0,3,0,0,-3,3,182,154,28,-28
Shane Carwin,Frank Mir,Shane Carwin,2010-03-27,1,0,5,-5,6,1.636364,-2.539993,2.539993,1,-1,2.539993,-2.539993,153,3,14,29,-15,15,4.36363637447357,-4.36363637447357,3,1,0,3,2,-2,-3,3,385,105,280,-280
Mirko Filipovic,Frank Mir,Frank Mir,2010-09-25,0,1,5,-5,3.181818,1.636364,-2.539993,2.539993,-34,34,-15.24001,15.24001,0,269,46,29,17,-17,1.545454621315,-1.545454621315,1,0,1,4,1,-1,-3,3,217,182,35,-35
Junior Dos Santos,Frank Mir,Junior Dos Santos,2012-05-26,1,0,-5,5,2.333333,1.636364,2.539993,-2.539993,-26,26,-5.080002,5.080002,18,9,30,29,1,-1,0.696969628334045,-0.696969628334045,7,1,0,4,6,-6,-4,4,196,609,-413,413
Daniel Cormier,Frank Mir,Daniel Cormier,2013-04-20,1,0,1,-1,7.333333,1.636364,-10.16,10.16,-29,29,-17.78,17.78,454,18,25,29,-4,4,5.69696986675262,-5.69696986675262,0,0,0,5,0,0,-5,5,0,329,-329,329
Josh Barnett,Frank Mir,Josh Barnett,2013-08-31,1,0,1,-1,4.375,1.636364,0,0,-14,14,-2.540009,2.540009,71,0,43,29,14,-14,2.73863637447357,-2.73863637447357,3,0,1,5,3,-3,-4,4,4180,133,4047,-4047
Todd Duffee,Frank Mir,Frank Mir,2015-07-15,0,1,-7,7,3,1.636364,0,0,-4,4,-2.540009,2.540009,5,1,12,29,-17,17,1.36363637447357,-1.36363637447357,1,0,1,6,1,-1,-5,5,221,683,-462,462
Andrei Arlovski,Frank Mir,Andrei Arlovski,2015-09-05,1,0,0,0,1.545455,1.636364,0,0,-24,24,-5.080002,5.080002,212,239,56,29,27,-27,-9.09091234207153e-02,9.09091234207153e-02,6,1,3,6,5,-5,-3,3,105,52,53,-53
Mark Hunt,Frank Mir,Mark Hunt,2016-03-19,1,0,5,-5,0.9285714,1.636364,-12.7,12.7,1,-1,-17.78,17.78,2,0,27,29,-2,2,-0.707792222499847,0.707792222499847,1,0,2,6,1,-1,-4,4,126,196,-70,70
Kevin Jackson,Frank Shamrock,Frank Shamrock,1997-12-21,0,1,,,2,2.3,0,0,14,-14,0,0,0,0,6,33,-27,27,-0.299999952316284,0.299999952316284,0,0,0,0,0,0,0,0,0,0,0,0
Jeremy Horn,Frank Shamrock,Frank Shamrock,1998-05-15,0,1,-3,3,4.136364,2.3,7.619995,-7.619995,0,0,7.960007,-7.960007,0,0,113,33,80,-80,1.83636355400085,-1.83636355400085,0,1,0,0,-1,1,0,0,0,145,-145,145
John Lober,Frank Shamrock,Frank Shamrock,1998-10-16,0,1,5,-5,0.5555556,2.3,2.539993,-2.539993,14,-14,3,-3,0,0,14,33,-19,19,-1.74444437026978,1.74444437026978,0,2,0,0,-2,2,0,0,0,154,-154,154
Tito Ortiz,Frank Shamrock,Frank Shamrock,1999-09-24,0,1,-2,2,1.583333,2.3,12.7,-12.7,20,-20,7.960007,-7.960007,951,13,31,33,-2,2,-0.716666579246521,0.716666579246521,0,3,0,0,-3,3,0,0,0,343,-343,343
Matt Hughes,Frank Trigg,Matt Hughes,2003-11-21,1,0,-1,1,5,2.333333,0,0,0,0,5.080002,-5.080002,103,119,54,30,24,-24,2.66666674613953,-2.66666674613953,5,0,0,0,5,-5,0,0,210,0,210,-210
Dennis Hallman,Frank Trigg,Frank Trigg,2004-06-19,0,1,-4,4,2.65,2.333333,0,0,-15,15,2.540009,-2.540009,0,200,73,30,43,-43,0.316666841506958,-0.316666841506958,0,0,0,0,0,0,0,0,995,211,784,-784
Matt Hughes,Frank Trigg,Matt Hughes,2005-04-16,1,0,-1,1,5,2.333333,0,0,0,0,5.080002,-5.080002,92,109,54,30,24,-24,2.66666674613953,-2.66666674613953,2,1,0,0,1,-1,0,0,176,301,-125,125
Georges St-Pierre,Frank Trigg,Georges St-Pierre,2005-08-20,1,0,-9,9,13,2.333333,5.080002,-5.080002,15,-15,12.7,-12.7,217,0,28,30,-2,2,10.6666667461395,-10.6666667461395,0,0,0,0,0,0,0,0,0,126,-126,126
Josh Koscheck,Frank Trigg,Josh Koscheck,2009-09-19,1,0,-6,6,1.545455,2.333333,2.540009,-2.540009,0,0,5.080002,-5.080002,6,0,28,30,-2,2,-0.787878751754761,0.787878751754761,0,0,1,0,0,0,1,-1,210,1491,-1281,1281
Matt Serra,Frank Trigg,Matt Serra,2010-02-06,1,0,-2,2,1.571429,2.333333,-7.619995,7.619995,0,0,-7.619995,7.619995,3,0,18,30,-12,12,-0.761904716491699,0.761904716491699,0,0,1,1,0,0,0,0,658,140,518,-518
Mark Bocek,Frankie Edgar,Frankie Edgar,2007-07-07,0,1,0,0,2.4,2.090909,5.080002,-5.080002,20,-20,17.78,-17.78,0,139,17,34,-17,17,0.309091091156006,-0.309091091156006,0,0,0,0,0,0,0,0,0,0,0,0
Jose Aldo,Frankie Edgar,Jose Aldo,2013-02-02,1,0,-5,5,3.875,2.090909,2.539993,-2.539993,0,0,5.080002,-5.080002,5,57,39,34,5,-5,1.78409099578857,-1.78409099578857,3,1,0,0,2,-2,0,0,385,2037,-1652,1652
Jose Aldo,Frankie Edgar,Jose Aldo,2016-07-09,1,0,-5,5,3.875,2.090909,2.539993,-2.539993,0,0,5.080002,-5.080002,71,0,39,34,5,-5,1.78409099578857,-1.78409099578857,0,0,1,0,0,0,1,-1,210,1253,-1043,1043
Johnny Case,Frankie Perez,Johnny Case,2015-01-18,1,0,0,0,3.666667,2.5,-2.539993,2.539993,0,0,-2.539993,2.539993,425,35,28,14,14,-14,1.16666674613953,-1.16666674613953,1,0,0,0,1,-1,0,0,120,0,120,-120
Marc Diakiese,Frankie Perez,Marc Diakiese,2016-12-09,1,0,-4,4,2.285714,2.5,-2.539993,2.539993,0,0,0,0,429,204,23,14,9,-9,-0.214285612106323,0.214285612106323,1,0,0,1,1,-1,-1,1,62,691,-629,629
Iuri Alcantara,Frankie Saenz,Frankie Saenz,2015-02-22,0,1,0,0,3.5,1.857143,7.619995,-7.619995,0,0,12.7,-12.7,62,420,45,20,25,-25,1.64285719394684,-1.64285719394684,3,0,0,0,3,-3,0,0,162,0,162,-162
Sirwan Kakai,Frankie Saenz,Frankie Saenz,2015-08-08,0,1,-9,9,2.4,1.857143,-2.539993,2.539993,0,0,2.360001,-2.360001,115,161,17,20,-3,3,0.54285728931427,-0.54285728931427,1,1,0,0,0,0,0,0,42,167,-125,125
Urijah Faber,Frankie Saenz,Urijah Faber,2015-12-12,1,0,1,-1,3.181818,1.857143,0,0,0,0,2.539993,-2.539993,114,121,46,20,26,-26,1.32467544078827,-1.32467544078827,5,2,0,0,3,-3,0,0,371,126,245,-245
Augusto Mendes,Frankie Saenz,Augusto Mendes,2017-01-15,1,0,-3,3,3,1.857143,0,0,0,0,-2.539993,2.539993,132,154,8,20,-12,12,1.14285719394684,-1.14285719394684,0,0,0,0,0,0,0,0,0,400,-400,400
Merab Dvalishvili,Frankie Saenz,Frankie Saenz,2017-12-09,0,1,-11,11,4,1.857143,0,0,0,0,5.080002,-5.080002,466,19,20,20,0,0,2.14285719394684,-2.14285719394684,0,0,0,0,0,0,0,0,0,328,-328,328
Henry Briones,Frankie Saenz,Frankie Saenz,2018-05-19,0,1,0,0,2,1.857143,5.080002,-5.080002,0,0,7.619995,-7.619995,8,250,24,20,4,-4,0.142857193946838,-0.142857193946838,0,1,1,0,-1,1,1,-1,287,161,126,-126
Jonathan Martinez,Frankie Saenz,Jonathan Martinez,2020-08-01,1,0,-13,13,4.5,1.857143,5.080002,-5.080002,0,0,10.16,-10.16,45,70,22,20,2,-2,2.64285719394684,-2.64285719394684,0,2,0,0,-2,2,0,0,644,805,-161,161
Pablo Garza,Fredson Paixao,Pablo Garza,2010-12-04,1,0,-4,4,3,2,17.78,-17.78,0,0,17.78,-17.78,1,0,16,15,1,-1,1,-1,0,0,0,0,0,0,0,0,0,0,0,0
Ryan Benoit,Fredy Serrano,Ryan Benoit,2016-07-30,1,0,-10,10,1.25,1.5,5.080002,-5.080002,0,0,7.619995,-7.619995,85,299,18,5,13,-13,-0.25,0.25,0,0,0,0,0,0,0,0,259,0,259,-259
Hector Sandoval,Fredy Serrano,Hector Sandoval,2016-12-17,1,0,-7,7,3.5,1.5,-2.540009,2.540009,0,0,-2.540009,2.540009,160,8,18,5,13,-13,2,-2,0,0,0,0,0,0,0,0,0,140,-140,140
Ian Garry,Gabe Green,Ian Garry,2022-07-02,1,0,-5,5,13,2.2,12.7,-12.7,0,0,2.540009,-2.540009,46,137,13,16,-3,3,10.7999999523163,-10.7999999523163,2,0,0,0,2,-2,0,0,84,0,84,-84
Bryan Battle,Gabe Green,Bryan Battle,2023-05-13,1,0,-2,2,5.5,2.2,7.619995,-7.619995,0,0,10.16,-10.16,3,0,13,16,-3,3,3.29999995231628,-3.29999995231628,0,0,0,0,0,0,0,0,147,315,-168,168
Melvin Guillard,Gabe Ruediger,Melvin Guillard,2006-09-23,1,0,-6,6,1.777778,2.25,-2.540009,2.540009,0,0,0.3399963,-0.3399963,72,128,50,26,24,-24,-0.472222208976746,0.472222208976746,0,0,0,0,0,0,0,0,250,0,250,-250
Joe Lauzon,Gabe Ruediger,Joe Lauzon,2010-08-28,1,0,-6,6,1.75,2.25,0,0,0,0,0.3399963,-0.3399963,93,0,44,26,18,-18,-0.5,0.5,0,0,0,1,0,0,-1,1,238,1435,-1197,1197
Enrique Barzola,Gabriel Benitez,Enrique Barzola,2017-05-13,1,0,0,0,3.4,2.090909,-2.540009,2.540009,-10,10,-2.539993,2.539993,350,0,22,34,-12,12,1.30909109115601,-1.30909109115601,0,0,0,0,0,0,0,0,259,0,259,-259
Humberto Bandenay,Gabriel Benitez,Gabriel Benitez,2018-05-19,0,1,-6,6,2,2.090909,7.619995,-7.619995,-10,10,0,0,0,24,21,34,-13,13,-9.09090042114258e-02,9.09090042114258e-02,1,0,0,0,1,-1,0,0,287,371,-84,84
Mirko Filipovic,Gabriel Gonzaga,Gabriel Gonzaga,2007-04-21,0,1,5,-5,3.181818,1.545455,0,0,-12,12,-7.619995,7.619995,0,185,46,28,18,-18,1.63636374473572,-1.63636374473572,1,0,0,0,1,-1,0,0,77,0,77,-77
Randy Couture,Gabriel Gonzaga,Randy Couture,2007-08-25,1,0,16,-16,1.727273,1.545455,-2.540009,2.540009,-37,37,-2.539993,2.539993,541,3,30,28,2,-2,0.181818246841431,-0.181818246841431,1,1,3,0,0,0,3,-3,175,126,49,-49
Shane Carwin,Gabriel Gonzaga,Shane Carwin,2009-03-07,1,0,5,-5,6,1.545455,0,0,23,-23,10.16,-10.16,2,29,14,28,-14,14,4.45454549789429,-4.45454549789429,2,0,0,1,2,-2,-1,1,140,560,-420,420
Junior Dos Santos,Gabriel Gonzaga,Junior Dos Santos,2010-03-21,1,0,-4,4,2.333333,1.545455,5.079987,-5.079987,-4,4,2.540009,-2.540009,9,1,30,28,2,-2,0.787878751754761,-0.787878751754761,4,0,0,2,4,-4,-2,2,78,379,-301,301
Travis Browne,Gabriel Gonzaga,Travis Browne,2013-04-13,1,0,-3,3,2.571429,1.545455,10.15999,-10.15999,13,-13,7.62001,-7.62001,0,58,25,28,-3,3,1.02597403526306,-1.02597403526306,0,0,1,3,0,0,-2,2,190,1119,-929,929
Mirko Filipovic,Gabriel Gonzaga,Mirko Filipovic,2015-04-11,1,0,5,-5,3.181818,1.545455,0,0,-12,12,-7.619995,7.619995,60,397,46,28,18,-18,1.63636374473572,-1.63636374473572,0,0,4,4,0,0,0,0,1260,728,532,-532
Konstantin Erokhin,Gabriel Gonzaga,Gabriel Gonzaga,2015-12-11,0,1,-4,4,3,1.545455,-7.62001,7.62001,-12,12,-10.03999,10.03999,10,180,12,28,-16,16,1.45454549789429,-1.45454549789429,0,0,0,5,0,0,-5,5,321,244,77,-77
Lerone Murphy,Gabriel Santos,Lerone Murphy,2023-03-18,1,0,5,-5,13,5,0,0,0,0,7.619995,-7.619995,138,240,13,12,1,-1,8,-8,2,0,0,0,2,-2,0,0,787,0,787,-787
David Onama,Gabriel Santos,David Onama,2023-06-24,1,0,3,-3,5.5,5,5.080002,-5.080002,0,0,10.16,-10.16,173,91,13,12,1,-1,0.5,-0.5,0,0,0,0,0,0,0,0,0,98,-98,98
Ray Borg,Gabriel Silva,Ray Borg,2019-07-20,1,0,1,-1,2.6,4,-5.080002,5.080002,0,0,-20.31999,20.31999,512,266,18,10,8,-8,-1.40000009536743,1.40000009536743,0,0,0,0,0,0,0,0,112,0,112,-112
Kyler Phillips,Gabriel Silva,Kyler Phillips,2020-02-29,1,0,-1,1,5.5,4,5.080002,-5.080002,0,0,2.540009,-2.540009,352,149,13,10,3,-3,1.5,-1.5,0,0,0,0,0,0,0,0,0,224,-224,224
Tereza Bleda,Gabriella Fernandes,Tereza Bleda,2023-06-17,1,0,-8,8,7,2.666667,7.619995,-7.619995,0,0,12.7,-12.7,651,10,8,11,-3,3,4.33333325386047,-4.33333325386047,0,0,1,0,0,0,1,-1,210,0,210,-210
Caio Borralho,Gadzhi Omargadzhiev,Caio Borralho,2022-04-16,1,0,0,0,14,6.5,-7.619995,7.619995,15,-15,10.16,-10.16,611,22,15,15,0,0,7.5,-7.5,0,0,0,0,0,0,0,0,0,0,0,0
Abubakar Nurmagomedov,Gadzhi Omargadzhiev,Abubakar Nurmagomedov,2022-10-22,1,0,3,-3,4.25,6.5,-5.080002,5.080002,0,0,2.540009,-2.540009,475,68,21,15,6,-6,-2.25,2.25,0,0,0,0,0,0,0,0,1078,189,889,-889
Josh Barnett,Gan McGee,Josh Barnett,2000-11-17,1,0,0,0,4.375,2.6,-17.78,17.78,-15,15,-11.88,11.88,78,442,43,18,25,-25,1.77500009536743,-1.77500009536743,0,0,0,0,0,0,0,0,0,0,0,0
Alexandre Dantas,Gan McGee,Gan McGee,2003-02-28,0,1,-3,3,0,2.6,-20.31999,20.31999,-27,27,-19,19,116,83,3,18,-15,15,-2.59999990463257,2.59999990463257,0,0,1,1,0,0,0,0,889,833,56,-56
Alan Patrick,Garett Whiteley,Alan Patrick,2013-10-09,1,0,-2,2,3.75,2.333333,-2.540009,2.540009,0,0,5.080002,-5.080002,53,5,19,10,9,-9,1.41666674613953,-1.41666674613953,0,0,0,0,0,0,0,0,0,0,0,0
Vinc Pichel,Garett Whiteley,Vinc Pichel,2014-01-15,1,0,-2,2,4.666667,2.333333,-5.080002,5.080002,0,0,0,0,653,40,17,10,7,-7,2.33333325386047,-2.33333325386047,0,0,0,1,0,0,-1,1,0,98,-98,98
David Michaud,Garett Whiteley,David Michaud,2014-12-13,1,0,-8,8,3.666667,2.333333,-7.62001,7.62001,0,0,-4.880005,4.880005,452,0,14,10,4,-4,1.33333349227905,-1.33333349227905,0,0,0,1,0,0,-1,1,0,332,-332,332
Bartosz Fabinski,Garreth McLellan,Bartosz Fabinski,2015-04-11,1,0,-4,4,3,2.166667,-2.539993,2.539993,-15,15,7.619995,-7.619995,656,163,20,19,1,-1,0.833333253860474,-0.833333253860474,0,0,0,0,0,0,0,0,0,0,0,0
Bubba Bush,Garreth McLellan,Garreth McLellan,2015-10-24,0,1,-3,3,2.666667,2.166667,-2.539993,2.539993,0,0,3.119995,-3.119995,358,467,11,19,-8,8,0.5,-0.5,0,0,0,0,0,0,0,0,0,196,-196,196
Magnus Cedenblad,Garreth McLellan,Magnus Cedenblad,2016-05-08,1,0,1,-1,2.8,2.166667,10.16,-10.16,0,0,17.78,-17.78,1,0,19,19,0,0,0.633333206176758,-0.633333206176758,2,1,0,0,1,-1,0,0,708,197,511,-511
Alessio Di Chirico,Garreth McLellan,Alessio Di Chirico,2016-08-27,1,0,-7,7,1.857143,2.166667,-2.539993,2.539993,0,0,5.080002,-5.080002,186,223,20,19,1,-1,-0.309523940086365,0.309523940086365,0,0,0,1,0,0,-1,1,139,111,28,-28
Paulo Costa,Garreth McLellan,Paulo Costa,2017-03-11,1,0,-9,9,7,2.166667,0,0,0,0,0,0,5,0,16,19,-3,3,4.83333325386047,-4.83333325386047,0,0,0,1,0,0,-1,1,0,196,-196,196
Jerry Bohlander,Gary Goodridge,Gary Goodridge,1996-02-16,0,1,-8,8,2.75,1.045455,-10.16,10.16,-50,50,-10,10,0,0,15,45,-30,30,1.70454549789429,-1.70454549789429,1,0,0,1,1,-1,-1,1,0,0,0,0
Don Frye,Gary Goodridge,Don Frye,1996-02-16,1,0,0,0,2.222222,1.045455,-5.080002,5.080002,-30,30,-5,5,0,0,29,45,-16,16,1.17676782608032,-1.17676782608032,0,1,0,0,-1,1,0,0,0,0,0,0
Mark Coleman,Gary Goodridge,Mark Coleman,1996-07-12,1,0,1,-1,1.6,1.045455,-5.080002,5.080002,-44,44,-2.5,2.5,0,0,26,45,-19,19,0.554545521736145,-0.554545521736145,0,0,0,1,0,0,-1,1,0,147,-147,147
John Campetella,Gary Goodridge,Gary Goodridge,1996-07-12,0,1,,,0,1.045455,-15.24001,15.24001,-14,14,-15,15,0,0,1,45,-44,44,-1.04545450210571,1.04545450210571,0,0,0,1,0,0,-1,1,0,0,0,0
Don Frye,Gary Goodridge,Don Frye,1996-12-07,1,0,1,-1,2.222222,1.045455,-5.080002,5.080002,-30,30,-5,5,0,0,29,45,-16,16,1.17676782608032,-1.17676782608032,4,1,0,1,3,-3,-1,1,148,148,0,0
Neil Magny,Gasan Umalatov,Neil Magny,2014-02-01,1,0,-5,5,2.333333,4.25,10.16,-10.16,0,0,22.86,-22.86,163,136,40,21,19,-19,-1.91666674613953,1.91666674613953,0,0,0,0,0,0,0,0,182,0,182,-182
Paulo Thiago,Gasan Umalatov,Gasan Umalatov,2014-05-31,0,1,2,-2,2,4.25,0,0,0,0,7.62001,-7.62001,54,240,27,21,6,-6,-2.25,2.25,1,0,0,0,1,-1,0,0,1652,119,1533,-1533
Cathal Pendred,Gasan Umalatov,Cathal Pendred,2014-10-04,1,0,-5,5,4.25,4.25,5.080002,-5.080002,0,0,10.16,-10.16,150,8,21,21,0,0,0,0,0,1,0,0,-1,1,0,0,0,126,-126,126
Viscardi Andrade,Gasan Umalatov,Viscardi Andrade,2015-11-07,1,0,-2,2,3.166667,4.25,0,0,0,0,10.16,-10.16,2,41,25,21,4,-4,-1.08333325386047,1.08333325386047,0,0,0,0,0,0,0,0,630,399,231,-231
Sam Sicilia,Gavin Tucker,Gavin Tucker,2017-02-19,0,1,1,-1,1.875,4.333333,5.080002,-5.080002,0,0,2.539993,-2.539993,26,15,23,16,7,-7,-2.45833349227905,2.45833349227905,0,0,0,0,0,0,0,0,0,0,0,0
Ricky Glenn,Gavin Tucker,Ricky Glenn,2017-09-09,1,0,-3,3,3.142857,4.333333,15.24001,-15.24001,10,-10,10.16,-10.16,466,15,29,16,13,-13,-1.1904764175415,1.1904764175415,1,1,0,0,0,0,0,0,210,202,8,-8
SeungWoo Choi,Gavin Tucker,Gavin Tucker,2019-07-27,0,1,-7,7,1.833333,4.333333,15.24001,-15.24001,0,0,20.32001,-20.32001,49,365,17,16,1,-1,-2.50000011920929,2.50000011920929,0,0,0,0,0,0,0,0,98,686,-588,588
Justin Jaynes,Gavin Tucker,Gavin Tucker,2020-08-08,0,1,-4,4,2,4.333333,2.539993,-2.539993,0,0,5.080002,-5.080002,38,84,24,16,8,-8,-2.33333349227905,2.33333349227905,0,1,0,0,-1,1,0,0,0,378,-378,378
Billy Quarantillo,Gavin Tucker,Gavin Tucker,2020-12-12,0,1,-2,2,3.6,4.333333,10.16,-10.16,0,0,10.16,-10.16,25,314,23,16,7,-7,-0.733333587646484,0.733333587646484,0,2,0,0,-2,2,0,0,0,126,-126,126
Dan Ige,Gavin Tucker,Dan Ige,2021-03-13,1,0,-5,5,2.428571,4.333333,2.539993,-2.539993,0,0,12.7,-12.7,1,0,24,16,8,-8,-1.90476202964783,1.90476202964783,0,3,0,0,-3,3,0,0,241,91,150,-150
Diego Lopes,Gavin Tucker,Diego Lopes,2023-08-05,1,0,-9,9,3.666667,4.333333,12.7,-12.7,0,0,15.24001,-15.24001,0,39,28,16,12,-12,-0.666666746139526,0.666666746139526,0,0,0,1,0,0,-1,1,0,875,-875,875
Ray Borg,Geane Herrera,Ray Borg,2015-08-08,1,0,-3,3,2.6,3,-2.540009,2.540009,10,-10,-7.619995,7.619995,835,15,18,12,6,-6,-0.400000095367432,0.400000095367432,2,0,0,0,2,-2,0,0,175,0,175,-175
Ali Bagautinov,Geane Herrera,Ali Bagautinov,2016-06-18,1,0,5,-5,2.5,3,-2.540009,2.540009,0,0,-2.539993,2.539993,507,56,21,12,9,-9,-0.5,0.5,0,0,0,0,0,0,0,0,259,315,-56,56
Ilir Latifi,Gegard Mousasi,Gegard Mousasi,2013-04-06,0,1,3,-3,1.888889,7,-10.16,10.16,45,-45,-7.619995,7.619995,31,6,26,48,-22,22,-5.11111116409302,5.11111116409302,0,0,0,0,0,0,0,0,0,0,0,0
Lyoto Machida,Gegard Mousasi,Lyoto Machida,2014-02-15,1,0,7,-7,3,7,-2.540009,2.540009,0,0,-5.079987,5.079987,190,102,32,48,-16,16,-4,4,1,1,1,0,0,0,1,-1,112,315,-203,203
Dan Henderson,Gegard Mousasi,Gegard Mousasi,2015-01-24,0,1,15,-15,2.133333,7,-7.62001,7.62001,0,0,-5.079987,5.079987,0,2,47,48,-1,1,-4.86666655540466,4.86666655540466,1,0,0,0,1,-1,0,0,307,343,-36,36
Uriah Hall,Gegard Mousasi,Uriah Hall,2015-09-26,1,0,1,-1,1.636364,7,-5.080002,5.080002,0,0,7.62001,-7.62001,12,286,29,48,-19,19,-5.36363637447357,5.36363637447357,0,1,0,0,-1,1,0,0,126,245,-119,119
Thales Leites,Gegard Mousasi,Gegard Mousasi,2016-02-27,0,1,4,-4,3.111111,7,-2.540009,2.540009,0,0,5.080002,-5.080002,91,222,37,48,-11,11,-3.88888883590698,3.88888883590698,2,0,0,1,2,-2,-1,1,687,154,533,-533
Vitor Belfort,Gegard Mousasi,Gegard Mousasi,2016-10-08,0,1,8,-8,1.857143,7,-5.080002,5.080002,0,0,-5.079987,5.079987,0,92,40,48,-8,8,-5.14285719394684,5.14285719394684,0,1,5,1,-1,1,4,-4,147,224,-77,77
Uriah Hall,Gegard Mousasi,Gegard Mousasi,2016-11-19,0,1,1,-1,1.636364,7,-5.080002,5.080002,0,0,7.62001,-7.62001,0,44,29,48,-19,19,-5.36363637447357,5.36363637447357,0,2,0,1,-2,2,-1,1,371,42,329,-329
Matt Frevola,Genaro Valdez,Matt Frevola,2022-01-22,1,0,1,-1,3.666667,3.333333,0,0,0,0,-2.540009,2.540009,67,8,14,13,1,-1,0.333333492279053,-0.333333492279053,0,0,2,0,0,0,2,-2,224,0,224,-224
Natan Levy,Genaro Valdez,Natan Levy,2022-12-03,1,0,1,-1,8,3.333333,0,0,0,0,-2.540009,2.540009,280,1,9,13,-4,4,4.66666674613953,-4.66666674613953,0,0,0,1,0,0,-1,1,0,315,-315,315
Evan Elder,Genaro Valdez,Evan Elder,2023-07-15,1,0,-5,5,4,3.333333,2.540009,-2.540009,0,0,0,0,6,0,10,13,-3,3,0.666666746139526,-0.666666746139526,0,0,1,1,0,0,0,0,147,224,-77,77
Leigh Remedios,Genki Sudo,Genki Sudo,2002-07-13,0,1,2,-2,1.8,3.75,-5.080002,5.080002,0,0,-5,5,85,211,28,19,9,-9,-1.95000004768372,1.95000004768372,0,0,0,0,0,0,0,0,0,0,0,0
Duane Ludwig,Genki Sudo,Duane Ludwig,2003-04-25,1,0,-1,1,1.5,3.75,2.540009,-2.540009,15,-15,-0.1999969,0.1999969,247,409,35,19,16,-16,-2.25,2.25,0,1,0,0,-1,1,0,0,0,286,-286,286
Mike Brown,Genki Sudo,Genki Sudo,2004-04-02,0,1,2,-2,2.888889,3.75,-7.619995,7.619995,-10,10,-0.1999969,0.1999969,179,12,35,19,16,-16,-0.861111164093018,0.861111164093018,0,0,0,0,0,0,0,0,0,343,-343,343
Brian Camozzi,Geoff Neal,Geoff Neal,2018-02-18,0,1,-1,1,1.4,3,7.62001,-7.62001,0,0,7.619995,-7.619995,0,67,12,20,-8,8,-1.60000002384186,1.60000002384186,0,0,1,0,0,0,1,-1,225,0,225,-225
Frank Camacho,Geoff Neal,Geoff Neal,2018-09-08,0,1,1,-1,2.2,3,-2.539993,2.539993,-15,15,-5.080002,5.080002,11,8,32,20,12,-12,-0.799999952316284,0.799999952316284,0,1,0,0,-1,1,0,0,224,202,22,-22
Belal Muhammad,Geoff Neal,Geoff Neal,2019-01-19,0,1,2,-2,7.666667,3,0,0,0,0,-7.619995,7.619995,23,57,26,20,6,-6,4.66666650772095,-4.66666650772095,1,2,0,0,-1,1,0,0,232,133,99,-99
Neil Magny,Geoff Neal,Neil Magny,2021-05-08,1,0,3,-3,2.333333,3,10.16,-10.16,0,0,12.7,-12.7,103,230,40,20,20,-20,-0.666666746139526,0.666666746139526,1,3,1,0,-2,2,1,-1,336,840,-504,504
Vicente Luque,Geoff Neal,Geoff Neal,2022-08-06,0,1,-1,1,2.444444,3,0,0,0,0,0,0,0,47,31,20,11,-11,-0.555555582046509,0.555555582046509,0,0,0,0,0,0,0,0,112,455,-343,343
Shane Nelson,George Roop,Shane Nelson,2008-12-13,1,0,-3,3,2.285714,1.153846,-10.16,10.16,20,-20,-5.080002,5.080002,478,237,23,28,-5,5,1.13186824321747,-1.13186824321747,0,0,0,0,0,0,0,0,0,0,0,0
David Kaplan,George Roop,George Roop,2009-05-23,0,1,2,-2,0.75,1.153846,-15.24001,15.24001,20,-20,-9.880005,9.880005,314,0,7,28,-21,21,-0.403846144676208,0.403846144676208,0,0,0,0,0,0,0,0,0,161,-161,161
Mark Hominick,George Roop,Mark Hominick,2011-01-22,1,0,-1,1,1.666667,1.153846,-12.7,12.7,10,-10,-10.16,10.16,7,0,32,28,4,-4,0.512820482254028,-0.512820482254028,0,1,0,0,-1,1,0,0,0,609,-609,609
Josh Grispi,George Roop,George Roop,2011-06-04,0,1,-7,7,2.8,1.153846,-5.080002,5.080002,10,-10,5.080002,-5.080002,291,363,19,28,-9,9,1.64615380764008,-1.64615380764008,0,0,0,1,0,0,-1,1,154,133,21,-21
Hatsu Hioki,George Roop,Hatsu Hioki,2011-10-29,1,0,-1,1,2.9,1.153846,-5.080002,5.080002,10,-10,2.539993,-2.539993,411,213,39,28,11,-11,1.74615395069122,-1.74615395069122,0,1,0,1,-1,1,-1,1,0,147,-147,147
Reuben Duran,George Roop,George Roop,2013-03-16,0,1,-2,2,1.571429,1.153846,-15.24001,15.24001,0,0,-2.540009,2.540009,451,263,18,28,-10,10,0.417582392692566,-0.417582392692566,0,0,1,1,0,0,0,0,91,504,-413,413
Brian Bowles,George Roop,George Roop,2013-05-25,0,1,1,-1,3.333333,1.153846,-15.24001,15.24001,0,0,-5.080002,5.080002,49,31,13,28,-15,15,2.17948710918427,-2.17948710918427,0,1,0,1,-1,1,-1,1,553,70,483,-483
Francisco Rivera,George Roop,Francisco Rivera,2013-11-06,1,0,1,-1,1.571429,1.153846,-12.7,12.7,0,0,-5.080002,5.080002,56,139,18,28,-10,10,0.417582392692566,-0.417582392692566,1,2,0,1,-1,1,-1,1,540,165,375,-375
Dustin Kimura,George Roop,George Roop,2014-04-16,0,1,-8,8,3.666667,1.153846,-15.24001,15.24001,0,0,-2.540009,2.540009,144,485,14,28,-14,14,2.51282060146332,-2.51282060146332,0,0,0,2,0,0,-2,2,0,161,-161,161
Rob Font,George Roop,Rob Font,2014-07-05,1,0,-5,5,2.857143,1.153846,-12.7,12.7,0,0,-2.540009,2.540009,4,17,27,28,-1,1,1.70329678058624,-1.70329678058624,0,1,0,2,-1,1,-2,2,0,80,-80,80
Takeya Mizugaki,George Roop,Takeya Mizugaki,2015-09-26,1,0,-2,2,1.909091,1.153846,-15.24001,15.24001,0,0,-7.62001,7.62001,180,352,32,28,4,-4,0.755244731903076,-0.755244731903076,0,0,0,3,0,0,-3,3,161,448,-287,287
Billy Miles,George Sotiropoulos,George Sotiropoulos,2007-12-08,0,1,-1,1,1,2,0,0,15,-15,-2.339996,2.339996,19,72,4,21,-17,17,-1,1,0,0,0,0,0,0,0,0,0,0,0,0
Roman Mitichyan,George Sotiropoulos,George Sotiropoulos,2008-04-02,0,1,-1,1,2.666667,2,0,0,15,-15,-0.3399963,0.3399963,36,330,11,21,-10,10,0.666666746139526,-0.666666746139526,1,1,0,0,0,0,0,0,116,116,0,0
George Roop,George Sotiropoulos,George Sotiropoulos,2009-08-08,0,1,-5,5,1.153846,2,7.619995,-7.619995,-20,20,2.540009,-2.540009,24,258,28,21,7,-7,-0.846153855323792,0.846153855323792,0,2,0,0,-2,2,0,0,0,493,-493,493
Jason Dent,George Sotiropoulos,George Sotiropoulos,2009-11-21,0,1,-3,3,1.692308,2,0,0,0,0,0,0,0,328,35,21,14,-14,-0.307692289352417,0.307692289352417,1,3,0,0,-2,2,0,0,154,105,49,-49
Kurt Pellegrino,George Sotiropoulos,George Sotiropoulos,2010-07-03,0,1,-1,1,2.285714,2,-5.080002,5.080002,0,0,-2.539993,2.539993,192,287,23,21,2,-2,0.285714387893677,-0.285714387893677,1,4,0,0,-3,3,0,0,665,224,441,-441
Joe Lauzon,George Sotiropoulos,George Sotiropoulos,2010-11-20,0,1,-7,7,1.75,2,0,0,0,0,0,0,45,203,44,21,23,-23,-0.25,0.25,1,5,0,0,-4,4,0,0,84,140,-56,56
Dennis Siver,George Sotiropoulos,Dennis Siver,2011-02-26,1,0,-1,1,2.090909,2,-10.16,10.16,-10,10,-2.539993,2.539993,19,8,34,21,13,-13,9.09090042114258e-02,-9.09090042114258e-02,1,6,0,0,-5,5,0,0,105,98,7,-7
Rafael Dos Anjos,George Sotiropoulos,Rafael Dos Anjos,2011-07-02,1,0,-7,7,2.133333,2,-5.080002,5.080002,15,-15,-2.539993,2.539993,3,0,47,21,26,-26,0.133333444595337,-0.133333444595337,0,0,1,0,0,0,1,-1,329,126,203,-203
Ross Pearson,George Sotiropoulos,Ross Pearson,2012-12-14,1,0,-7,7,1.25,2,-5.080002,5.080002,0,0,-5.080002,5.080002,18,91,36,21,15,-15,-0.75,0.75,0,0,1,1,0,0,0,0,175,531,-356,356
KJ Noons,George Sotiropoulos,KJ Noons,2013-10-19,1,0,-6,6,1.444444,2,0,0,0,0,-2.539993,2.539993,0,26,22,21,1,-1,-0.555555582046509,0.555555582046509,0,0,0,2,0,0,-2,2,0,309,-309,309
Mike Rhodes,George Sullivan,George Sullivan,2014-01-25,0,1,-8,8,2,2.428571,2.539993,-2.539993,0,0,2.540009,-2.540009,152,101,15,24,-9,9,-0.428571462631226,0.428571462631226,0,0,0,0,0,0,0,0,0,0,0,0
Igor Araujo,George Sullivan,George Sullivan,2014-09-13,0,1,0,0,2.777778,2.428571,2.539993,-2.539993,0,0,10.16,-10.16,0,324,34,24,10,-10,0.349206209182739,-0.349206209182739,1,1,0,0,0,0,0,0,189,231,-42,42
Tim Means,George Sullivan,Tim Means,2015-04-18,1,0,-3,3,2.2,2.428571,5.080002,-5.080002,0,0,5.080002,-5.080002,226,27,48,24,24,-24,-0.22857141494751,0.22857141494751,2,2,0,0,0,0,0,0,266,217,49,-49
Niko Price,George Sullivan,Niko Price,2018-01-27,1,0,-8,8,2.142857,2.428571,0,0,0,0,7.619995,-7.619995,178,184,22,24,-2,2,-0.285714387893677,0.285714387893677,1,0,0,0,1,-1,0,0,393,1015,-622,622
Mickey Gall,George Sullivan,Mickey Gall,2018-08-25,1,0,-11,11,1.4,2.428571,5.080002,-5.080002,0,0,2.540009,-2.540009,0,42,12,24,-12,12,-1.02857148647308,1.02857148647308,3,0,0,0,3,-3,0,0,616,210,406,-406
Karo Parisyan,Georges St-Pierre,Georges St-Pierre,2004-01-31,0,1,-1,1,2.181818,13,-2.539993,2.539993,-15,15,-10.15999,10.15999,19,727,35,28,7,-7,-10.8181817531586,10.8181817531586,1,0,0,0,1,-1,0,0,127,0,127,-127
Jay Hieron,Georges St-Pierre,Georges St-Pierre,2004-06-19,0,1,4,-4,3.285714,13,2.540009,-2.540009,-15,15,-2.539993,2.539993,6,21,30,28,2,-2,-9.71428561210632,9.71428561210632,0,1,0,0,-1,1,0,0,0,140,-140,140
Matt Hughes,Georges St-Pierre,Matt Hughes,2004-10-22,1,0,8,-8,5,13,-5.080002,5.080002,-15,15,-7.619995,7.619995,140,17,54,28,26,-26,-8,8,1,2,0,0,-1,1,0,0,125,125,0,0
Jason Miller,Georges St-Pierre,Georges St-Pierre,2005-04-16,0,1,1,-1,2.3,13,5.080002,-5.080002,0,0,-5.039993,5.039993,99,583,33,28,5,-5,-10.7000000476837,10.7000000476837,0,0,0,0,0,0,0,0,0,176,-176,176
Sean Sherk,Georges St-Pierre,Georges St-Pierre,2005-11-19,0,1,8,-8,9,13,-12.7,12.7,-30,30,-22.86,22.86,0,186,40,28,12,-12,-4,4,0,1,0,0,-1,1,0,0,0,217,-217,217
BJ Penn,Georges St-Pierre,Georges St-Pierre,2006-03-04,0,1,3,-3,1.142857,13,-5.080002,5.080002,-30,30,-15.23999,15.23999,18,445,30,28,2,-2,-11.8571428060532,11.8571428060532,1,2,0,0,-1,1,0,0,1254,105,1149,-1149
Matt Hughes,Georges St-Pierre,Georges St-Pierre,2006-11-18,0,1,8,-8,5,13,-5.080002,5.080002,-15,15,-7.619995,7.619995,0,37,54,28,26,-26,-8,8,5,3,0,0,2,-2,0,0,56,259,-203,203
Matt Serra,Georges St-Pierre,Matt Serra,2007-04-07,1,0,7,-7,1.571429,13,-12.7,12.7,-15,15,-20.31999,20.31999,0,5,18,28,-10,10,-11.4285714626312,11.4285714626312,0,4,0,0,-4,4,0,0,1499,140,1359,-1359
Josh Koscheck,Georges St-Pierre,Georges St-Pierre,2007-08-25,0,1,3,-3,1.545455,13,-2.539993,2.539993,-15,15,-7.619995,7.619995,87,558,28,28,0,0,-11.4545454978943,11.4545454978943,4,0,0,1,4,-4,-1,1,140,140,0,0
Matt Hughes,Georges St-Pierre,Georges St-Pierre,2007-12-29,0,1,8,-8,5,13,-5.080002,5.080002,-15,15,-7.619995,7.619995,17,420,54,28,26,-26,-8,8,1,1,1,1,0,0,0,0,301,126,175,-175
Matt Serra,Georges St-Pierre,Georges St-Pierre,2008-04-19,0,1,7,-7,1.571429,13,-12.7,12.7,-15,15,-20.31999,20.31999,0,492,18,28,-10,10,-11.4285714626312,11.4285714626312,1,2,0,1,-1,1,-1,1,378,112,266,-266
Jon Fitch,Georges St-Pierre,Georges St-Pierre,2008-08-09,0,1,3,-3,4.285714,13,2.540009,-2.540009,-15,15,-5.079987,5.079987,112,673,37,28,9,-9,-8.7142858505249,8.7142858505249,4,3,0,1,1,-1,-1,1,161,112,49,-49
BJ Penn,Georges St-Pierre,Georges St-Pierre,2009-01-31,0,1,3,-3,1.142857,13,-5.080002,5.080002,-30,30,-15.23999,15.23999,26,897,30,28,2,-2,-11.8571428060532,11.8571428060532,3,4,0,1,-1,1,-1,1,252,175,77,-77
Thiago Alves,Georges St-Pierre,Georges St-Pierre,2009-07-11,0,1,-3,3,1.533333,13,-5.080002,5.080002,-15,15,-15.23999,15.23999,80,794,38,28,10,-10,-11.4666666984558,11.4666666984558,6,5,1,1,1,-1,0,0,259,161,98,-98
Dan Hardy,Georges St-Pierre,Georges St-Pierre,2010-03-27,0,1,-1,1,2.5,13,2.540009,-2.540009,-15,15,-5.079987,5.079987,37,1234,35,28,7,-7,-10.5,10.5,2,6,0,1,-4,4,-1,1,133,259,-126,126
Josh Koscheck,Georges St-Pierre,Georges St-Pierre,2010-12-11,0,1,4,-4,1.545455,13,-2.539993,2.539993,-15,15,-7.619995,7.619995,74,285,28,28,0,0,-11.4545454978943,11.4545454978943,1,7,1,1,-6,6,0,0,448,259,189,-189
Jake Shields,Georges St-Pierre,Georges St-Pierre,2011-04-30,0,1,3,-3,3.444444,13,2.540009,-2.540009,-15,15,-10.15999,10.15999,20,47,40,28,12,-12,-9.55555558204651,9.55555558204651,0,8,0,1,-8,8,-1,1,0,140,-140,140
Carlos Condit,Georges St-Pierre,Georges St-Pierre,2012-11-17,0,1,-3,3,2.285714,13,7.62001,-7.62001,-15,15,-2.539993,2.539993,64,897,46,28,18,-18,-10.7142856121063,10.7142856121063,5,9,0,1,-4,4,-1,1,287,567,-280,280
Nick Diaz,Georges St-Pierre,Georges St-Pierre,2013-03-16,0,1,-2,2,2.6,13,5.080002,-5.080002,-15,15,0,0,36,824,36,28,8,-8,-10.4000000953674,10.4000000953674,3,10,0,1,-7,7,-1,1,504,119,385,-385
Johny Hendricks,Georges St-Pierre,Georges St-Pierre,2013-11-16,0,1,-2,2,2.25,13,-5.080002,5.080002,0,0,-17.78,17.78,328,172,26,28,-2,2,-10.75,10.75,4,11,0,1,-7,7,-1,1,364,245,119,-119
Michael Bisping,Georges St-Pierre,Georges St-Pierre,2017-11-04,0,1,2,-2,3.333333,13,5.080002,-5.080002,0,0,-2.539993,2.539993,0,196,39,28,11,-11,-9.66666674613953,9.66666674613953,5,12,1,1,-7,7,0,0,392,1449,-1057,1057
David Branch,Gerald Harris,Gerald Harris,2010-07-03,0,1,-2,2,3.666667,4.6,5.080002,-5.080002,0,0,2.539993,-2.539993,88,288,28,28,0,0,-0.933333158493042,0.933333158493042,0,0,0,0,0,0,0,0,0,0,0,0
Maiquel Falcao,Gerald Harris,Maiquel Falcao,2010-11-20,1,0,-2,2,3.7,4.6,0,0,0,0,-15.58,15.58,244,58,47,28,19,-19,-0.899999856948853,0.899999856948853,0,1,0,0,-1,1,0,0,0,140,-140,140
Joseph Gigliotti,Gerald Meerschaert,Gerald Meerschaert,2016-12-09,0,1,-5,5,3.5,2.058824,-5.080002,5.080002,0,0,-12.58,12.58,39,65,9,52,-43,43,1.44117641448975,-1.44117641448975,0,0,0,0,0,0,0,0,125,0,125,-125
Ryan Janes,Gerald Meerschaert,Gerald Meerschaert,2017-02-19,0,1,6,-6,3.333333,2.058824,5.080002,-5.080002,0,0,-2.540009,2.540009,78,0,13,52,-39,39,1.27450966835022,-1.27450966835022,0,1,0,0,-1,1,0,0,0,72,-72,72
Jack Hermansson,Gerald Meerschaert,Jack Hermansson,2018-12-15,1,0,0,0,2.875,2.058824,0,0,0,0,0,0,238,15,31,52,-21,21,0.816176414489746,-0.816176414489746,1,2,1,0,-1,1,1,-1,217,664,-447,447
Kevin Holland,Gerald Meerschaert,Kevin Holland,2019-03-30,1,0,-5,5,2.5,2.058824,5.080002,-5.080002,-15,15,10.16,-10.16,252,552,35,52,-17,17,0.441176414489746,-0.441176414489746,1,0,0,0,1,-1,0,0,126,105,21,-21
Trevin Giles,Gerald Meerschaert,Gerald Meerschaert,2019-08-03,0,1,-5,5,3.2,2.058824,-2.539993,2.539993,-15,15,-7.619995,7.619995,256,330,21,52,-31,31,1.14117646217346,-1.14117646217346,0,0,0,0,0,0,0,0,0,126,-126,126
Eryk Anders,Gerald Meerschaert,Eryk Anders,2019-10-12,1,0,1,-1,1.875,2.058824,0,0,0,0,-5.080002,5.080002,9,0,23,52,-29,29,-0.183823585510254,0.183823585510254,1,1,1,0,0,0,1,-1,105,70,35,-35
Ian Heinisch,Gerald Meerschaert,Ian Heinisch,2020-06-06,1,0,-1,1,2.8,2.058824,-5.080002,5.080002,0,0,-12.7,12.7,13,0,19,52,-33,33,0.74117636680603,-0.74117636680603,0,0,0,0,0,0,0,0,0,238,-238,238
Khamzat Chimaev,Gerald Meerschaert,Khamzat Chimaev,2020-09-19,1,0,-6,6,12,2.058824,2.540009,-2.540009,0,0,-5.080002,5.080002,2,0,12,52,-40,40,9.94117641448975,-9.94117641448975,2,0,0,1,2,-2,-1,1,56,105,-49,49
Bartosz Fabinski,Gerald Meerschaert,Gerald Meerschaert,2021-04-17,0,1,1,-1,3,2.058824,-2.539993,2.539993,-15,15,-5.080002,5.080002,13,86,20,52,-32,32,0.941176414489746,-0.941176414489746,0,0,0,2,0,0,-2,2,224,210,14,-14
Krzysztof Jotko,Gerald Meerschaert,Krzysztof Jotko,2022-04-30,1,0,-2,2,4,2.058824,0,0,0,0,0,0,325,114,30,52,-22,22,1.94117641448975,-1.94117641448975,0,1,1,2,-1,1,-1,1,364,378,-14,14
Felipe Colares,Geraldo de Freitas,Geraldo de Freitas,2019-02-02,0,1,-3,3,2.5,2,2.540009,-2.540009,10,-10,-7.62001,7.62001,252,396,14,18,-4,4,0.5,-0.5,0,0,0,0,0,0,0,0,0,0,0,0
Dieusel Berto,Geza Kalman,Geza Kalman,1996-07-12,0,1,,,0,0.4444444,-10.16,10.16,0,0,-10,10,0,0,3,13,-10,10,-0.444444447755814,0.444444447755814,0,0,0,0,0,0,0,0,0,0,0,0
Ovince Saint Preux,Gian Villante,Ovince Saint Preux,2013-04-27,1,0,3,-3,1.529412,1.214286,0,0,-25,25,10.16,-10.16,42,71,43,31,12,-12,0.315126061439514,-0.315126061439514,0,0,0,0,0,0,0,0,0,0,0,0
Cody Donovan,Gian Villante,Gian Villante,2013-11-16,0,1,4,-4,1.6,1.214286,0,0,-25,25,-5.079987,5.079987,16,53,13,31,-18,18,0.385714292526245,-0.385714292526245,0,0,1,0,0,0,1,-1,91,203,-112,112
Fabio Maldonado,Gian Villante,Fabio Maldonado,2014-03-23,1,0,6,-6,2.090909,1.214286,-5.080002,5.080002,-25,25,-2.539993,2.539993,21,346,34,31,3,-3,0.876623272895813,-0.876623272895813,0,1,1,0,-1,1,1,-1,526,127,399,-399
"Sean O'Connell",Gian Villante,Gian Villante,2014-06-28,0,1,2,-2,1.888889,1.214286,-5.080002,5.080002,-25,25,-5.079987,5.079987,251,6,26,31,-5,5,0.67460310459137,-0.67460310459137,0,0,0,0,0,0,0,0,0,97,-97,97
Corey Anderson,Gian Villante,Gian Villante,2015-04-18,0,1,-4,4,2.8,1.214286,0,0,-25,25,7.62001,-7.62001,0,0,19,31,-12,12,1.58571422100067,-1.58571422100067,2,1,0,0,1,-1,0,0,133,294,-161,161
Tom Lawlor,Gian Villante,Tom Lawlor,2015-07-25,1,0,3,-3,1.666667,1.214286,-7.619995,7.619995,-25,25,-5.079987,5.079987,3,3,16,31,-15,15,0.452380895614624,-0.452380895614624,1,2,0,0,-1,1,0,0,1166,98,1068,-1068
Anthony Perosh,Gian Villante,Gian Villante,2015-11-14,0,1,13,-13,1.5,1.214286,0,0,-25,25,-2.539993,2.539993,0,1,25,31,-6,6,0.285714268684387,-0.285714268684387,0,0,0,1,0,0,-1,1,3241,112,3129,-3129
Ilir Latifi,Gian Villante,Ilir Latifi,2016-03-05,1,0,3,-3,1.888889,1.214286,-12.7,12.7,0,0,-7.619995,7.619995,277,9,26,31,-5,5,0.67460310459137,-0.67460310459137,2,1,0,1,1,-1,-1,1,48,112,-64,64
Saparbeg Safarov,Gian Villante,Gian Villante,2016-12-09,0,1,-1,1,3,1.214286,-5.080002,5.080002,-45,45,5.080002,-5.080002,12,23,12,31,-19,19,1.78571426868439,-1.78571426868439,0,0,0,1,0,0,-1,1,0,279,-279,279
Mauricio Rua,Gian Villante,Mauricio Rua,2017-03-11,1,0,4,-4,1.928571,1.214286,-5.080002,5.080002,-25,25,0,0,4,9,41,31,10,-10,0.714285731315613,-0.714285731315613,0,1,1,1,-1,1,0,0,854,92,762,-762
Patrick Cummins,Gian Villante,Patrick Cummins,2017-07-22,1,0,5,-5,1.428571,1.214286,-2.539993,2.539993,-25,25,0,0,186,0,17,31,-14,14,0.214285731315613,-0.214285731315613,0,0,3,2,0,0,1,-1,434,133,301,-301
Francimar Barroso,Gian Villante,Gian Villante,2018-01-20,0,1,5,-5,2.714286,1.214286,-5.080002,5.080002,-25,25,-2.539993,2.539993,0,0,26,31,-5,5,1.49999988079071,-1.49999988079071,0,0,0,2,0,0,-2,2,140,182,-42,42
Sam Alvey,Gian Villante,Sam Alvey,2018-06-01,1,0,0,0,1.833333,1.214286,-2.539993,2.539993,-45,45,-2.539993,2.539993,0,6,51,31,20,-20,0.61904764175415,-0.61904764175415,1,1,1,2,0,0,-1,1,97,132,-35,35
Ed Herman,Gian Villante,Gian Villante,2018-10-27,0,1,5,-5,1.6875,1.214286,-5.080002,5.080002,-25,25,2.540009,-2.540009,6,4,43,31,12,-12,0.473214268684387,-0.473214268684387,0,0,2,2,0,0,0,0,819,148,671,-671
Michal Oleksiejczuk,Gian Villante,Michal Oleksiejczuk,2019-02-23,1,0,-9,9,3.166667,1.214286,-7.619995,7.619995,-45,45,-5.079987,5.079987,2,0,25,31,-6,6,1.95238101482391,-1.95238101482391,0,1,0,2,-1,1,-2,2,0,119,-119,119
Maurice Greene,Gian Villante,Maurice Greene,2020-06-27,1,0,-1,1,1.285714,1.214286,10.16,-10.16,28,-28,10.16,-10.16,0,157,16,31,-15,15,7.14285373687744e-02,-7.14285373687744e-02,0,0,1,3,0,0,-2,2,161,490,-329,329
Jake Collier,Gian Villante,Jake Collier,2020-12-05,1,0,-3,3,1.3,1.214286,0,0,0,0,5.080002,-5.080002,2,0,23,31,-8,8,8.57142210006714e-02,-8.57142210006714e-02,2,0,2,3,2,-2,-1,1,1120,161,959,-959
Chris Barnett,Gian Villante,Chris Barnett,2021-11-06,1,0,-1,1,2.875,1.214286,-15.24001,15.24001,35,-35,-2.539993,2.539993,12,8,31,31,0,0,1.66071426868439,-1.66071426868439,0,0,0,3,0,0,-3,3,168,336,-168,168
David Loiseau,Gideon Ray,David Loiseau,2005-02-05,1,0,-6,6,2.090909,1.133333,5.080002,-5.080002,0,0,13.03999,-13.03999,159,35,34,32,2,-2,0.957575678825378,-0.957575678825378,0,0,0,0,0,0,0,0,498,0,498,-498
Charles McCarthy,Gideon Ray,Charles McCarthy,2006-11-11,1,0,-7,7,2,1.133333,0,0,0,0,0.3399963,-0.3399963,38,0,15,32,-17,17,0.866666674613953,-0.866666674613953,0,0,0,1,0,0,-1,1,0,644,-644,644
Edson Barboza,Giga Chikadze,Giga Chikadze,2021-08-28,0,1,2,-2,2.090909,5,-2.540009,2.540009,0,0,2.539993,-2.539993,0,41,34,18,16,-16,-2.90909099578857,2.90909099578857,1,0,3,0,1,-1,3,-3,105,0,105,-105
Alex Caceres,Giga Chikadze,Giga Chikadze,2023-08-26,0,1,0,0,1.5,5,-5.080002,5.080002,0,0,-2.540009,2.540009,0,0,35,18,17,-17,-3.5,3.5,2,1,1,0,1,-1,1,-1,84,728,-644,644
Chris Brennan,Gil Castillo,Gil Castillo,2002-01-11,0,1,-6,6,1.615385,1.6,-2.539993,2.539993,0,0,-5,5,8,782,34,13,21,-21,1.53845548629761e-02,-1.53845548629761e-02,0,0,0,0,0,0,0,0,1400,0,1400,-1400
Olivier Aubin-Mercier,Gilbert Burns,Gilbert Burns,2018-12-08,0,1,-3,3,2.2,3.666667,-2.540009,2.540009,-15,15,-2.539993,2.539993,51,377,16,28,-12,12,-1.46666669845581,1.46666669845581,0,0,0,0,0,0,0,0,133,0,133,-133
Benson Henderson,Gilbert Melendez,Benson Henderson,2013-04-20,1,0,-2,2,3.428571,2.75,0,0,25,-25,-7.619995,7.619995,87,51,31,30,1,-1,0.678571462631226,-0.678571462631226,1,0,0,0,1,-1,0,0,615,0,615,-615
Eddie Alvarez,Gilbert Melendez,Eddie Alvarez,2015-06-13,1,0,-2,2,4.833333,2.75,0,0,10,-10,-10.16,10.16,227,0,35,30,5,-5,2.08333349227905,-2.08333349227905,0,0,0,0,0,0,0,0,259,784,-525,525
Edson Barboza,Gilbert Melendez,Edson Barboza,2016-07-23,1,0,-4,4,2.090909,2.75,5.080002,-5.080002,0,0,5.080002,-5.080002,38,4,34,30,4,-4,-0.659090995788574,0.659090995788574,1,0,1,0,1,-1,1,-1,91,406,-315,315
Arnold Allen,Gilbert Melendez,Arnold Allen,2019-07-06,1,0,-12,12,9.5,2.75,-2.539993,2.539993,0,0,-7.619995,7.619995,54,0,21,30,-9,9,6.75,-6.75,5,0,0,0,5,-5,0,0,112,1078,-966,966
Robert McDaniel,Gilbert Smith,Robert McDaniel,2013-04-13,1,0,-2,2,2.8,2,15.24001,-15.24001,0,0,12.5,-12.5,377,230,38,18,20,-20,0.799999952316284,-0.799999952316284,0,0,0,0,0,0,0,0,0,0,0,0
Bryan Battle,Gilbert Urbina,Bryan Battle,2021-08-28,1,0,1,-1,5.5,2.333333,-5.080002,5.080002,0,0,5.080002,-5.080002,82,160,13,10,3,-3,3.16666674613953,-3.16666674613953,0,0,0,0,0,0,0,0,0,0,0,0
Orion Cosce,Gilbert Urbina,Gilbert Urbina,2023-05-20,0,1,1,-1,4,2.333333,-10.16,10.16,0,0,-10.16,10.16,5,186,10,10,0,0,1.66666674613953,-1.66666674613953,1,0,1,0,1,-1,1,-1,294,630,-336,336
Junior Dos Santos,Gilbert Yvel,Junior Dos Santos,2010-01-02,1,0,-8,8,2.333333,2.4375,5.079987,-5.079987,13,-13,0,0,7,0,30,55,-25,25,-0.104166746139526,0.104166746139526,3,0,0,0,3,-3,0,0,105,0,105,-105
Ben Rothwell,Gilbert Yvel,Ben Rothwell,2010-06-12,1,0,-5,5,2.785714,2.4375,5.079987,-5.079987,40,-40,2.539993,-2.539993,736,96,53,55,-2,2,0.348214387893677,-0.348214387893677,0,0,1,1,0,0,0,0,231,161,70,-70
Jon Madsen,Gilbert Yvel,Jon Madsen,2010-10-23,1,0,-4,4,4,2.4375,-5.080002,5.080002,15,-15,-12.7,12.7,42,0,10,55,-45,45,1.5625,-1.5625,2,0,0,1,2,-2,-1,1,112,133,-21,21
Molly McCann,Gillian Robertson,Gillian Robertson,2018-05-27,0,1,5,-5,2.166667,1.5,-2.540009,2.540009,10,-10,-2.540009,2.540009,2,272,19,20,-1,1,0.666666746139526,-0.666666746139526,0,0,0,0,0,0,0,0,0,0,0,0
Mayra Bueno Silva,Gillian Robertson,Mayra Bueno Silva,2018-09-22,1,0,4,-4,5.5,1.5,2.539993,-2.539993,20,-20,7.619995,-7.619995,14,162,13,20,-7,7,4,-4,0,1,0,0,-1,1,0,0,0,118,-118,118
Veronica Hardy,Gillian Robertson,Gillian Robertson,2019-02-23,0,1,0,0,1.75,1.5,-2.540009,2.540009,10,-10,2.539993,-2.539993,110,267,11,20,-9,9,0.25,-0.25,0,0,0,0,0,0,0,0,280,154,126,-126
Sarah Frota,Gillian Robertson,Gillian Robertson,2019-07-27,0,1,8,-8,4.5,1.5,2.539993,-2.539993,10,-10,15.23999,-15.23999,0,472,11,20,-9,9,3,-3,0,1,0,0,-1,1,0,0,175,154,21,-21
Maycee Barber,Gillian Robertson,Maycee Barber,2019-10-18,1,0,-3,3,6.5,1.5,0,0,10,-10,5.080002,-5.080002,22,44,15,20,-5,5,5,-5,1,2,0,0,-1,1,0,0,342,83,259,-259
Cortney Casey,Gillian Robertson,Gillian Robertson,2020-06-20,0,1,8,-8,1,1.5,5.079987,-5.079987,10,-10,10.15999,-10.15999,0,665,20,20,0,0,-0.5,0.5,2,0,0,1,2,-2,-1,1,35,246,-211,211
Poliana Botelho,Gillian Robertson,Gillian Robertson,2020-10-17,0,1,6,-6,1.6,1.5,7.619995,-7.619995,10,-10,10.15999,-10.15999,76,574,13,20,-7,7,0.100000023841858,-0.100000023841858,1,1,0,1,0,0,-1,1,553,119,434,-434
Miranda Maverick,Gillian Robertson,Miranda Maverick,2021-03-27,1,0,-2,2,2.8,1.5,-5.080002,5.080002,10,-10,5.080002,-5.080002,280,209,19,20,-1,1,1.29999995231628,-1.29999995231628,0,2,0,1,-2,2,-1,1,0,161,-161,161
Priscila Cachoeira,Gillian Robertson,Gillian Robertson,2021-12-11,0,1,7,-7,2.4,1.5,5.079987,-5.079987,10,-10,5.080002,-5.080002,6,169,17,20,-3,3,0.900000095367432,-0.900000095367432,2,0,0,1,2,-2,-1,1,210,259,-49,49
JJ Aldrich,Gillian Robertson,JJ Aldrich,2022-03-12,1,0,3,-3,2,1.5,0,0,10,-10,10.15999,-10.15999,187,24,18,20,-2,2,0.5,-0.5,2,1,1,1,1,-1,0,0,196,91,105,-105
Mariya Agapova,Gillian Robertson,Gillian Robertson,2022-09-17,0,1,-2,2,2.5,1.5,2.539993,-2.539993,10,-10,12.7,-12.7,29,287,14,20,-6,6,1,-1,0,0,1,1,0,0,0,0,196,189,7,-7
Tabatha Ricci,Gillian Robertson,Tabatha Ricci,2023-06-24,1,0,0,0,9,1.5,-10.16,10.16,0,0,-5.080002,5.080002,38,26,10,20,-10,10,7.5,-7.5,1,1,0,1,0,0,-1,1,399,280,119,-119
Lina Lansberg,Gina Mazany,Lina Lansberg,2018-05-27,1,0,7,-7,1.25,1.166667,2.539993,-2.539993,10,-10,-7.619995,7.619995,451,181,18,13,5,-5,8.33333730697632e-02,-8.33333730697632e-02,1,0,0,0,1,-1,0,0,435,0,435,-435
Macy Chiasson,Gina Mazany,Macy Chiasson,2019-03-02,1,0,-3,3,3,1.166667,12.7,-12.7,10,-10,10.16,-10.16,27,0,12,13,-1,1,1.83333337306976,-1.83333337306976,1,0,0,0,1,-1,0,0,92,279,-187,187
Julia Avila,Gina Mazany,Julia Avila,2020-06-13,1,0,1,-1,4.5,1.166667,2.539993,-2.539993,10,-10,0,0,5,0,11,13,-2,2,3.33333337306976,-3.33333337306976,1,0,0,1,1,-1,-1,1,343,469,-126,126
Priscila Cachoeira,Gina Mazany,Priscila Cachoeira,2021-05-15,1,0,0,0,2.4,1.166667,2.539993,-2.539993,0,0,-7.619995,7.619995,17,404,17,13,4,-4,1.23333346843719,-1.23333346843719,1,0,0,2,1,-1,-2,2,448,336,112,-112
Fernando Bruno,Glaico Franca Moreira,Glaico Franca Moreira,2015-08-01,0,1,9,-9,3.75,3,-15.24001,15.24001,-10,10,-25.58,25.58,336,400,19,20,-1,1,0.75,-0.75,0,0,0,0,0,0,0,0,0,0,0,0
Nick Diaz,Gleison Tibau,Nick Diaz,2006-11-18,1,0,0,0,2.6,2.357143,7.619995,-7.619995,15,-15,12.7,-12.7,197,222,36,47,-11,11,0.242856979370117,-0.242856979370117,1,0,0,0,1,-1,0,0,84,0,84,-84
Jason Dent,Gleison Tibau,Gleison Tibau,2007-03-03,0,1,3,-3,1.692308,2.357143,0,0,0,0,0,0,0,744,35,47,-12,12,-0.664835214614868,0.664835214614868,0,0,0,1,0,0,-1,1,161,105,56,-56
Jeff Cox,Gleison Tibau,Gleison Tibau,2007-06-12,0,1,15,-15,1.428571,2.357143,0,0,0,0,-0.3399963,0.3399963,12,56,17,47,-30,30,-0.928571462631226,0.928571462631226,0,1,0,1,-1,1,-1,1,0,101,-101,101
Terry Etim,Gleison Tibau,Gleison Tibau,2007-09-08,0,1,-2,2,3.2,2.357143,7.619995,-7.619995,0,0,5.080002,-5.080002,0,701,21,47,-26,26,0.842857122421265,-0.842857122421265,1,2,0,1,-1,1,-1,1,140,88,52,-52
Tyson Griffin,Gleison Tibau,Tyson Griffin,2008-02-02,1,0,-1,1,2,2.357143,-10.16,10.16,-10,10,-7.619995,7.619995,100,212,24,47,-23,23,-0.357142925262451,0.357142925262451,3,3,0,1,0,0,-1,1,133,147,-14,14
Joe Stevenson,Gleison Tibau,Joe Stevenson,2008-07-05,1,0,2,-2,2.0625,2.357143,-7.62001,7.62001,-10,10,-2.539993,2.539993,194,151,49,47,2,-2,-0.294642925262451,0.294642925262451,0,0,0,1,0,0,-1,1,0,154,-154,154
Rich Clementi,Gleison Tibau,Gleison Tibau,2009-02-07,0,1,7,-7,1.956522,2.357143,-2.540009,2.540009,0,0,2.540009,-2.540009,20,201,68,47,21,-21,-0.400621175765991,0.400621175765991,0,0,0,1,0,0,-1,1,105,217,-112,112
Jeremy Stephens,Gleison Tibau,Gleison Tibau,2009-04-01,0,1,-3,3,1.473684,2.357143,-2.540009,2.540009,-10,10,0,0,45,607,47,47,0,0,-0.883458733558655,0.883458733558655,0,1,0,1,-1,1,-1,1,676,53,623,-623
Melvin Guillard,Gleison Tibau,Melvin Guillard,2009-06-20,1,0,1,-1,1.777778,2.357143,-2.540009,2.540009,0,0,0,0,10,513,50,47,3,-3,-0.579365134239197,0.579365134239197,1,2,0,1,-1,1,-1,1,350,80,270,-270
Josh Neer,Gleison Tibau,Gleison Tibau,2009-10-24,0,1,0,0,2.25,2.357143,2.539993,-2.539993,15,-15,2.540009,-2.540009,39,276,52,47,5,-5,-0.107142925262451,0.107142925262451,0,0,0,1,0,0,-1,1,77,126,-49,49
Jim Miller,Gleison Tibau,Jim Miller,2010-09-15,1,0,1,-1,2.117647,2.357143,-5.080002,5.080002,0,0,0,0,125,201,53,47,6,-6,-0.239495754241943,0.239495754241943,1,1,0,1,0,0,-1,1,644,326,318,-318
Kurt Pellegrino,Gleison Tibau,Gleison Tibau,2011-03-19,0,1,4,-4,2.285714,2.357143,-5.080002,5.080002,0,0,-2.539993,2.539993,189,172,23,47,-24,24,-7.14285373687744e-02,7.14285373687744e-02,0,0,0,1,0,0,-1,1,259,185,74,-74
Rafaello Oliveira,Gleison Tibau,Gleison Tibau,2011-05-28,0,1,2,-2,2.125,2.357143,-5.080002,5.080002,0,0,0,0,14,141,25,47,-22,22,-0.232142925262451,0.232142925262451,0,1,0,1,-1,1,-1,1,423,70,353,-353
Rafael Dos Anjos,Gleison Tibau,Gleison Tibau,2011-11-19,0,1,-1,1,2.133333,2.357143,-5.080002,5.080002,15,-15,-2.539993,2.539993,121,103,47,47,0,0,-0.223809480667114,0.223809480667114,1,2,1,1,-1,1,0,0,140,175,-35,35
Khabib Nurmagomedov,Gleison Tibau,Khabib Nurmagomedov,2012-07-07,1,0,-5,5,29,2.357143,0,0,0,0,-2.539993,2.539993,266,17,29,47,-18,18,26.6428570747375,-26.6428570747375,1,3,0,1,-2,2,-1,1,169,231,-62,62
Evan Dunham,Gleison Tibau,Evan Dunham,2013-02-02,1,0,2,-2,2,2.357143,0,0,0,0,-2.539993,2.539993,92,110,27,47,-20,20,-0.357142925262451,0.357142925262451,0,0,1,1,0,0,0,0,133,210,-77,77
John Cholish,Gleison Tibau,Gleison Tibau,2013-05-18,0,1,0,0,2.666667,2.357143,2.539993,-2.539993,0,0,7.62001,-7.62001,7,87,11,47,-36,36,0.309523820877075,-0.309523820877075,1,0,0,1,1,-1,-1,1,525,105,420,-420
Michael Johnson,Gleison Tibau,Michael Johnson,2013-12-28,1,0,-3,3,1.157895,2.357143,0,0,0,0,5.080002,-5.080002,2,59,41,47,-6,6,-1.19924819469452,1.19924819469452,1,1,0,1,0,0,-1,1,133,224,-91,91
Pat Healy,Gleison Tibau,Gleison Tibau,2014-07-16,0,1,0,0,1.478261,2.357143,5.080002,-5.080002,0,0,2.540009,-2.540009,134,273,57,47,10,-10,-0.878882050514221,0.878882050514221,0,0,0,2,0,0,-2,2,88,200,-112,112
Piotr Hallmann,Gleison Tibau,Gleison Tibau,2014-09-13,0,1,-3,3,3,2.357143,-2.540009,2.540009,0,0,0,0,98,339,24,47,-23,23,0.642857074737549,-0.642857074737549,0,1,0,2,-1,1,-2,2,322,59,263,-263
Norman Parke,Gleison Tibau,Gleison Tibau,2015-01-18,0,1,-3,3,3.833333,2.357143,2.539993,-2.539993,0,0,-2.539993,2.539993,68,120,29,47,-18,18,1.47619032859802,-1.47619032859802,2,2,0,2,0,0,-2,2,449,127,322,-322
Tony Ferguson,Gleison Tibau,Tony Ferguson,2015-02-28,1,0,0,0,2.888889,2.357143,2.539993,-2.539993,0,0,12.7,-12.7,45,0,35,47,-12,12,0.531745910644531,-0.531745910644531,3,3,0,2,0,0,-2,2,84,41,43,-43
Islam Makhachev,Gleison Tibau,Islam Makhachev,2018-01-20,1,0,-8,8,24,2.357143,0,0,0,0,-2.539993,2.539993,1,0,25,47,-22,22,21.6428570747375,-21.6428570747375,1,0,1,2,1,-1,-1,1,490,1057,-567,567
Desmond Green,Gleison Tibau,Desmond Green,2018-06-01,1,0,-6,6,2.875,2.357143,0,0,0,0,5.080002,-5.080002,0,0,31,47,-16,16,0.517857074737549,-0.517857074737549,0,0,0,3,0,0,-3,3,118,132,-14,14
Diana Belbita,Gloria de Paula,Gloria de Paula,2022-02-19,0,1,-1,1,2.142857,1.2,5.079987,-5.079987,0,0,2.540009,-2.540009,44,324,22,11,11,-11,0.942857027053833,-0.942857027053833,1,0,0,0,1,-1,0,0,210,0,210,-210
Kyle Kingsbury,Glover Teixeira,Glover Teixeira,2012-05-26,0,1,-2,2,1.833333,3.666667,5.079987,-5.079987,0,0,7.62001,-7.62001,0,67,17,42,-25,25,-1.83333337306976,1.83333337306976,2,0,0,0,2,-2,0,0,357,0,357,-357
Fabio Maldonado,Glover Teixeira,Glover Teixeira,2012-10-13,0,1,0,0,2.090909,3.666667,-2.540009,2.540009,0,0,-2.539993,2.539993,0,418,34,42,-8,8,-1.5757577419281,1.5757577419281,0,1,0,0,-1,1,0,0,151,140,11,-11
Quinton Jackson,Glover Teixeira,Glover Teixeira,2013-01-26,0,1,1,-1,3.083333,3.666667,-2.540009,2.540009,0,0,-7.619995,7.619995,5,218,49,42,7,-7,-0.583333492279053,0.583333492279053,0,2,0,0,-2,2,0,0,490,105,385,-385
James Te Huna,Glover Teixeira,Glover Teixeira,2013-05-25,0,1,-2,2,1.777778,3.666667,0,0,-20,20,-2.539993,2.539993,6,88,25,42,-17,17,-1.88888895511627,1.88888895511627,0,3,0,0,-3,3,0,0,0,119,-119,119
Ryan Bader,Glover Teixeira,Glover Teixeira,2013-09-04,0,1,-3,3,4.6,3.666667,0,0,0,0,-5.079987,5.079987,38,51,28,42,-14,14,0.933333158493042,-0.933333158493042,1,4,1,0,-3,3,1,-1,221,102,119,-119
Jon Jones,Glover Teixeira,Jon Jones,2014-04-26,1,0,-8,8,27,3.666667,5.079987,-5.079987,43,-43,20.32001,-20.32001,351,0,28,42,-14,14,23.3333332538605,-23.3333332538605,6,5,0,0,1,-1,0,0,364,234,130,-130
Phil Davis,Glover Teixeira,Phil Davis,2014-10-25,1,0,-4,4,4.25,3.666667,0,0,0,0,7.62001,-7.62001,484,16,21,42,-21,21,0.583333253860474,-0.583333253860474,0,0,0,0,0,0,0,0,182,182,0,0
Ovince Saint Preux,Glover Teixeira,Glover Teixeira,2015-08-08,0,1,-3,3,1.529412,3.666667,2.539993,-2.539993,0,0,10.16,-10.16,86,528,43,42,1,-1,-2.1372549533844,2.1372549533844,1,0,0,0,1,-1,0,0,833,287,546,-546
Patrick Cummins,Glover Teixeira,Glover Teixeira,2015-11-07,0,1,-2,2,1.428571,3.666667,0,0,0,0,0,0,84,14,17,42,-25,25,-2.2380952835083,2.2380952835083,0,1,1,0,-1,1,1,-1,203,91,112,-112
Rashad Evans,Glover Teixeira,Glover Teixeira,2016-04-16,0,1,0,0,2.375,3.666667,-5.080002,5.080002,0,0,-2.539993,2.539993,7,2,27,42,-15,15,-1.29166674613953,1.29166674613953,2,2,1,0,0,0,1,-1,882,161,721,-721
Anthony Johnson,Glover Teixeira,Anthony Johnson,2016-08-20,1,0,-4,4,3.666667,3.666667,0,0,0,0,5.080002,-5.080002,1,0,28,42,-14,14,0,0,2,3,0,0,-1,1,0,0,350,126,224,-224
Jared Cannonier,Glover Teixeira,Glover Teixeira,2017-02-11,0,1,-5,5,2.833333,3.666667,-7.62001,7.62001,-20,20,2.540009,-2.540009,10,638,23,42,-19,19,-0.833333492279053,0.833333492279053,1,0,1,1,1,-1,0,0,70,175,-105,105
Alexander Gustafsson,Glover Teixeira,Alexander Gustafsson,2017-05-28,1,0,-7,7,2.25,3.666667,7.619995,-7.619995,0,0,7.62001,-7.62001,169,34,26,42,-16,16,-1.41666674613953,1.41666674613953,0,1,1,1,-1,1,0,0,855,106,749,-749
Misha Cirkunov,Glover Teixeira,Glover Teixeira,2017-12-16,0,1,-8,8,1.666667,3.666667,2.539993,-2.539993,0,0,2.540009,-2.540009,11,44,24,42,-18,18,-2.00000011920929,2.00000011920929,0,0,1,2,0,0,-1,1,202,202,0,0
Corey Anderson,Glover Teixeira,Corey Anderson,2018-07-22,1,0,-10,10,2.8,3.666667,2.539993,-2.539993,0,0,7.62001,-7.62001,448,40,19,42,-23,23,-0.866666793823242,0.866666793823242,1,1,3,2,0,0,1,-1,92,218,-126,126
Karl Roberson,Glover Teixeira,Glover Teixeira,2019-01-19,0,1,-11,11,1.5,3.666667,-2.540009,2.540009,0,0,-5.079987,5.079987,42,106,15,42,-27,27,-2.16666674613953,2.16666674613953,1,0,0,2,1,-1,-2,2,434,181,253,-253
Ion Cutelaba,Glover Teixeira,Glover Teixeira,2019-04-27,0,1,-14,14,1.888889,3.666667,-2.540009,2.540009,0,0,-2.539993,2.539993,31,61,26,42,-16,16,-1.77777791023254,1.77777791023254,2,1,0,2,1,-1,-2,2,686,98,588,-588
Nikita Krylov,Glover Teixeira,Glover Teixeira,2019-09-14,0,1,-12,12,3.333333,3.666667,2.539993,-2.539993,0,0,2.540009,-2.540009,279,262,39,42,-3,3,-0.333333492279053,0.333333492279053,3,2,1,2,1,-1,-1,1,154,140,14,-14
Anthony Smith,Glover Teixeira,Glover Teixeira,2020-05-13,0,1,-9,9,2.055556,3.666667,5.079987,-5.079987,0,0,0,0,7,478,55,42,13,-13,-1.61111116409302,1.61111116409302,0,3,0,2,-3,3,-2,2,0,242,-242,242
Thiago Santos,Glover Teixeira,Glover Teixeira,2020-11-07,0,1,-5,5,2,3.666667,0,0,0,0,0,0,78,543,33,42,-9,9,-1.66666674613953,1.66666674613953,1,4,0,2,-3,3,-2,2,1008,178,830,-830
Jan Blachowicz,Glover Teixeira,Glover Teixeira,2021-10-30,0,1,-4,4,2.9,3.666667,0,0,0,0,5.080002,-5.080002,15,317,39,42,-3,3,-0.766666650772095,0.766666650772095,3,5,1,2,-2,2,-1,1,399,357,42,-42
Jiri Prochazka,Glover Teixeira,Jiri Prochazka,2022-06-11,1,0,-13,13,9.666667,3.666667,2.539993,-2.539993,0,0,10.16,-10.16,269,587,32,42,-10,10,6.00000023841858,-6.00000023841858,1,6,0,2,-5,5,-2,2,406,224,182,-182
Jamahal Hill,Glover Teixeira,Jamahal Hill,2023-01-21,1,0,-12,12,12,3.666667,5.079987,-5.079987,0,0,7.62001,-7.62001,206,206,13,42,-29,29,8.33333325386047,-8.33333325386047,4,0,0,2,4,-4,-2,2,168,224,-56,56
Rony Jason,Godofredo Pepey,Rony Jason,2012-06-23,1,0,4,-4,2,2.166667,0,0,0,0,0,0,270,65,21,19,2,-2,-0.166666746139526,0.166666746139526,0,0,0,0,0,0,0,0,0,0,0,0
Felipe Arantes,Godofredo Pepey,Felipe Arantes,2013-06-08,1,0,0,0,1.8,2.166667,2.540009,-2.540009,-10,10,0,0,131,61,28,19,9,-9,-0.366666793823242,0.366666793823242,1,0,0,0,1,-1,0,0,511,350,161,-161
Noad Lahat,Godofredo Pepey,Godofredo Pepey,2014-03-23,0,1,3,-3,5.5,2.166667,5.080002,-5.080002,0,0,-10.16,10.16,4,18,13,19,-6,6,3.33333325386047,-3.33333325386047,0,0,0,1,0,0,-1,1,0,288,-288,288
Dashon Johnson,Godofredo Pepey,Godofredo Pepey,2014-09-13,0,1,-1,1,4.5,2.166667,0,0,0,0,-12.42,12.42,58,3,11,19,-8,8,2.33333325386047,-2.33333325386047,0,1,0,1,-1,1,-1,1,77,174,-97,97
Andre Fili,Godofredo Pepey,Godofredo Pepey,2015-03-21,0,1,-3,3,2.2,2.166667,10.16,-10.16,0,0,2.540009,-2.540009,130,11,32,19,13,-13,3.33333015441895e-02,-3.33333015441895e-02,0,2,0,1,-2,2,-1,1,329,189,140,-140
Darren Elkins,Godofredo Pepey,Darren Elkins,2016-07-23,1,0,3,-3,2.454545,2.166667,7.62001,-7.62001,0,0,-5.080002,5.080002,705,61,38,19,19,-19,0.287878751754761,-0.287878751754761,3,3,1,1,0,0,0,0,140,490,-350,350
Mike de la Torre,Godofredo Pepey,Godofredo Pepey,2016-09-24,0,1,1,-1,2,2.166667,10.16,-10.16,0,0,-5.080002,5.080002,14,94,21,19,2,-2,-0.166666746139526,0.166666746139526,0,0,0,1,0,0,-1,1,0,63,-63,63
Shane Burgos,Godofredo Pepey,Shane Burgos,2017-07-22,1,0,-4,4,5,2.166667,10.16,-10.16,0,0,5.080002,-5.080002,55,90,18,19,-1,1,2.83333325386047,-2.83333325386047,1,1,0,1,0,0,-1,1,105,301,-196,196
Mirsad Bektic,Godofredo Pepey,Mirsad Bektic,2018-01-27,1,0,-4,4,3.25,2.166667,2.540009,-2.540009,0,0,-7.619995,7.619995,4,0,17,19,-2,2,1.08333325386047,-1.08333325386047,0,0,1,1,0,0,0,0,329,189,140,-140
Henrique da Silva,Gokhan Saki,Gokhan Saki,2017-09-22,0,1,-5,5,2.8,0.5,7.619995,-7.619995,0,0,7.619995,-7.619995,32,9,19,3,16,-16,2.29999995231628,-2.29999995231628,0,0,0,0,0,0,0,0,237,0,237,-237
Khalil Rountree Jr.,Gokhan Saki,Khalil Rountree Jr.,2018-07-07,1,0,-6,6,2.6,0.5,2.539993,-2.539993,0,0,7.619995,-7.619995,5,0,18,3,15,-15,2.09999990463257,-2.09999990463257,0,1,0,0,-1,1,0,0,729,288,441,-441
Wilson Gouveia,Goran Reljic,Goran Reljic,2008-05-24,0,1,5,-5,1.75,1.875,-5.080002,5.080002,-20,20,-12.70001,12.70001,70,68,22,23,-1,1,-0.125,0.125,3,0,0,0,3,-3,0,0,126,0,126,-126
CB Dollaway,Goran Reljic,CB Dollaway,2010-02-20,1,0,1,-1,1.888889,1.875,-2.539993,2.539993,-20,20,-12.70001,12.70001,379,125,26,23,3,-3,1.38888359069824e-02,-1.38888359069824e-02,1,1,0,0,0,0,0,0,157,637,-480,480
Kendall Grove,Goran Reljic,Kendall Grove,2010-07-03,1,0,1,-1,1.352941,1.875,7.619995,-7.619995,-20,20,-5.080002,5.080002,27,404,40,23,17,-17,-0.522058844566345,0.522058844566345,0,0,2,0,0,0,2,-2,84,133,-49,49
Frankie Edgar,Gray Maynard,Gray Maynard,2008-04-02,0,1,-2,2,2.090909,1.857143,-7.619995,7.619995,-20,20,-5.080002,5.080002,31,378,34,20,14,-14,0.233766198158264,-0.233766198158264,2,0,0,0,2,-2,0,0,137,0,137,-137
Rich Clementi,Gray Maynard,Gray Maynard,2008-10-25,0,1,3,-3,1.956522,1.857143,0,0,0,0,5.080002,-5.080002,13,581,68,20,48,-48,9.93789434432983e-02,-9.93789434432983e-02,5,1,0,0,4,-4,0,0,154,206,-52,52
Roger Huerta,Gray Maynard,Gray Maynard,2009-09-16,0,1,-4,4,2.555556,1.857143,0,0,0,0,0,0,60,194,32,20,12,-12,0.698412775993347,-0.698412775993347,0,2,0,0,-2,2,0,0,0,326,-326,326
Nate Diaz,Gray Maynard,Gray Maynard,2010-01-11,0,1,-6,6,1.692308,1.857143,7.62001,-7.62001,15,-15,15.23999,-15.23999,0,11,35,20,15,-15,-0.164835095405579,0.164835095405579,1,3,0,0,-2,2,0,0,117,117,0,0
Kenny Florian,Gray Maynard,Gray Maynard,2010-08-28,0,1,3,-3,2.333333,1.857143,2.540009,-2.540009,-10,10,10.16,-10.16,0,399,20,20,0,0,0.476190447807312,-0.476190447807312,2,4,1,0,-2,2,1,-1,150,229,-79,79
Frankie Edgar,Gray Maynard,Frankie Edgar,2011-10-08,1,0,-3,3,2.090909,1.857143,-7.619995,7.619995,-20,20,-5.080002,5.080002,15,16,34,20,14,-14,0.233766198158264,-0.233766198158264,5,5,0,0,0,0,0,0,406,406,0,0
Clay Guida,Gray Maynard,Gray Maynard,2012-06-22,0,1,-3,3,1.9,1.857143,-5.080002,5.080002,0,0,0,0,47,70,58,20,38,-38,4.28571701049805e-02,-4.28571701049805e-02,0,0,0,1,0,0,-1,1,223,258,-35,35
TJ Grant,Gray Maynard,TJ Grant,2013-05-25,1,0,-5,5,4.2,1.857143,2.540009,-2.540009,0,0,5.080002,-5.080002,15,0,26,20,6,-6,2.34285700321198,-2.34285700321198,4,1,0,1,3,-3,-1,1,119,337,-218,218
Nate Diaz,Gray Maynard,Nate Diaz,2013-11-30,1,0,-6,6,1.692308,1.857143,7.62001,-7.62001,15,-15,15.23999,-15.23999,6,49,35,20,15,-15,-0.164835095405579,0.164835095405579,0,0,1,2,0,0,-1,1,224,189,35,-35
Fernando Bruno,Gray Maynard,Gray Maynard,2016-07-08,0,1,-3,3,3.75,1.857143,-7.619995,7.619995,-10,10,-7.800003,7.800003,148,401,19,20,-1,1,1.89285719394684,-1.89285719394684,0,0,0,3,0,0,-3,3,342,951,-609,609
Ryan Hall,Gray Maynard,Ryan Hall,2016-12-03,1,0,-6,6,4.5,1.857143,2.540009,-2.540009,-10,10,0,0,0,178,11,20,-9,9,2.64285719394684,-2.64285719394684,1,1,0,3,0,0,-3,3,358,148,210,-210
Teruto Ishihara,Gray Maynard,Gray Maynard,2017-07-07,0,1,-13,13,1.428571,1.857143,-5.080002,5.080002,-20,20,-2.540009,2.540009,6,779,17,20,-3,3,-0.428571343421936,0.428571343421936,0,0,0,3,0,0,-3,3,230,216,14,-14
Nik Lentz,Gray Maynard,Nik Lentz,2018-10-06,1,0,-5,5,2.5,1.857143,-2.539993,2.539993,-10,10,-5.080002,5.080002,214,8,42,20,22,-22,0.642857193946838,-0.642857193946838,0,1,0,3,-1,1,-3,3,127,456,-329,329
Allen Crowder,Greg Hardy,Allen Crowder,2019-01-19,1,0,-1,1,2.5,1.4,-5.080002,5.080002,-20,20,-10.16,10.16,142,76,14,12,2,-2,1.10000002384186,-1.10000002384186,0,0,1,0,0,0,1,-1,413,0,413,-413
Juan Adams,Greg Hardy,Greg Hardy,2019-07-20,0,1,-3,3,1.666667,1.4,0,0,0,0,0,0,0,17,8,12,-4,4,0.266666650772095,-0.266666650772095,0,0,0,0,0,0,0,0,77,182,-105,105
Yorgan De Castro,Greg Hardy,Greg Hardy,2020-05-09,0,1,2,-2,2,1.4,-12.7,12.7,-15,15,-15.23999,15.23999,0,53,9,12,-3,3,0.600000023841858,-0.600000023841858,1,1,0,0,0,0,0,0,217,294,-77,77
Maurice Greene,Greg Hardy,Greg Hardy,2020-10-31,0,1,2,-2,1.285714,1.4,5.080002,-5.080002,-7,7,0,0,0,152,16,12,4,-4,-0.114285707473755,0.114285707473755,1,2,1,0,-1,1,1,-1,126,175,-49,49
Matthew Riddle,Greg Soto,Matthew Riddle,2010-03-27,1,0,1,-1,2.666667,2.25,5.080002,-5.080002,0,0,7.619995,-7.619995,456,41,11,13,-2,2,0.416666746139526,-0.416666746139526,1,0,0,0,1,-1,0,0,644,0,644,-644
Nick Osipczak,Greg Soto,Greg Soto,2010-08-28,0,1,1,-1,2,2.25,7.62001,-7.62001,0,0,7.619995,-7.619995,57,662,9,13,-4,4,-0.25,0.25,0,0,0,0,0,0,0,0,140,154,-14,14
Daniel Roberts,Greg Soto,Daniel Roberts,2011-01-01,1,0,6,-6,2.142857,2.25,-2.539993,2.539993,0,0,2.540009,-2.540009,106,31,22,13,9,-9,-0.107142925262451,0.107142925262451,0,1,0,0,-1,1,0,0,0,126,-126,126
Mark Kerr,Greg Stott,Mark Kerr,1997-10-17,1,0,,,1.363636,0,20.32001,-20.32001,46,-46,23,-23,0,0,26,1,25,-25,1.36363637447357,-1.36363637447357,0,0,0,0,0,0,0,0,0,0,0,0
Glaico Franca Moreira,Gregor Gillespie,Gregor Gillespie,2016-09-24,0,1,-4,4,3,14,12.70001,-12.70001,0,0,15.24001,-15.24001,3,660,20,15,5,-5,-11,11,0,0,0,0,0,0,0,0,154,0,154,-154
Diego Ferreira,Gregor Gillespie,Gregor Gillespie,2021-05-08,0,1,2,-2,3.6,14,5.080002,-5.080002,0,0,7.62001,-7.62001,66,310,23,15,8,-8,-10.4000000953674,10.4000000953674,5,1,1,0,4,-4,1,-1,476,1687,-1211,1211
JunYong Park,Gregory Rodrigues,Gregory Rodrigues,2021-10-23,0,1,1,-1,3.4,2.8,-12.7,12.7,0,0,-5.080002,5.080002,29,200,22,19,3,-3,0.600000143051147,-0.600000143051147,1,0,0,0,1,-1,0,0,371,0,371,-371
Armen Petrosyan,Gregory Rodrigues,Armen Petrosyan,2022-02-26,1,0,1,-1,4.5,2.8,0,0,0,0,-10.16,10.16,0,94,11,19,-8,8,1.70000004768372,-1.70000004768372,0,1,0,0,-1,1,0,0,0,126,-126,126
Julian Marquez,Gregory Rodrigues,Gregory Rodrigues,2022-06-18,0,1,2,-2,2.25,2.8,-2.539993,2.539993,0,0,-7.619995,7.619995,0,52,13,19,-6,6,-0.549999952316284,0.549999952316284,2,0,0,0,2,-2,0,0,490,112,378,-378
Chidi Njokuani,Gregory Rodrigues,Gregory Rodrigues,2022-09-17,0,1,3,-3,2.2,2.8,0,0,0,0,12.7,-12.7,100,74,32,19,13,-13,-0.599999904632568,0.599999904632568,1,1,0,0,0,0,0,0,119,91,28,-28
Brunno Ferreira,Gregory Rodrigues,Brunno Ferreira,2023-01-21,1,0,0,0,10,2.8,-12.7,12.7,0,0,-7.619995,7.619995,1,10,11,19,-8,8,7.20000004768372,-7.20000004768372,0,2,0,0,-2,2,0,0,0,126,-126,126
Davey Grant,Grigory Popov,Davey Grant,2019-11-09,1,0,-2,2,2.142857,4.333333,2.540009,-2.540009,0,0,2.539993,-2.539993,362,58,22,16,6,-6,-2.1904764175415,2.1904764175415,0,0,0,0,0,0,0,0,1127,0,1127,-1127
Marco Beltran,Guangyou Ning,Marco Beltran,2015-11-28,1,0,-4,4,1.333333,1.25,10.16,-10.16,-20,20,12.7,-12.7,2,229,14,9,5,-5,8.33333730697632e-02,-8.33333730697632e-02,1,0,0,0,1,-1,0,0,378,0,378,-378
Henry Briones,Guido Cannetti,Henry Briones,2014-11-15,1,0,0,0,2,1.25,5.080002,-5.080002,0,0,2.539993,-2.539993,33,81,24,18,6,-6,0.75,-0.75,0,0,0,0,0,0,0,0,0,0,0,0
Mario Bautista,Guido Cannetti,Mario Bautista,2023-03-11,1,0,-14,14,6.5,1.25,7.619995,-7.619995,0,0,2.539993,-2.539993,156,16,15,18,-3,3,5.25,-5.25,3,0,1,0,3,-3,1,-1,126,3038,-2912,2912
DaMarques Johnson,Gunnar Nelson,Gunnar Nelson,2012-09-29,0,1,6,-6,1,3.8,5.080002,-5.080002,0,0,7.619995,-7.619995,0,170,30,24,6,-6,-2.79999995231628,2.79999995231628,0,0,3,0,0,0,3,-3,56,0,56,-56
Omari Akhmedov,Gunnar Nelson,Gunnar Nelson,2014-03-08,0,1,1,-1,3.5,3.8,2.540009,-2.540009,15,-15,2.539993,-2.539993,2,185,27,24,3,-3,-0.299999952316284,0.299999952316284,1,1,0,0,0,0,0,0,119,525,-406,406
Zak Cummings,Gunnar Nelson,Gunnar Nelson,2014-07-19,0,1,4,-4,3.571429,3.8,2.540009,-2.540009,35,-35,7.619995,-7.619995,54,43,32,24,8,-8,-0.22857141494751,0.22857141494751,0,2,0,0,-2,2,0,0,0,133,-133,133
Demian Maia,Gunnar Nelson,Demian Maia,2015-12-12,1,0,11,-11,2.545455,3.8,5.080002,-5.080002,0,0,0,0,658,134,39,24,15,-15,-1.25454545021057,1.25454545021057,1,3,1,0,-2,2,1,-1,560,511,49,-49
Alan Jouban,Gunnar Nelson,Gunnar Nelson,2017-03-18,0,1,7,-7,2.428571,3.8,2.540009,-2.540009,0,0,2.539993,-2.539993,0,182,24,24,0,0,-1.37142848968506,1.37142848968506,3,0,1,0,3,-3,1,-1,91,462,-371,371
Leon Edwards,Gunnar Nelson,Leon Edwards,2019-03-16,1,0,-3,3,7,3.8,7.62001,-7.62001,0,0,5.080002,-5.080002,209,263,24,24,0,0,3.20000004768372,-3.20000004768372,4,1,0,0,3,-3,0,0,364,728,-364,364
Gilbert Burns,Gunnar Nelson,Gilbert Burns,2019-09-28,1,0,2,-2,3.666667,3.8,-2.539993,2.539993,0,0,-2.540009,2.540009,115,288,28,24,4,-4,-0.133333206176758,0.133333206176758,2,0,1,0,2,-2,1,-1,49,196,-147,147
Bryan Barberena,Gunnar Nelson,Gunnar Nelson,2023-03-18,0,1,-1,1,1.636364,3.8,2.540009,-2.540009,0,0,0,0,0,193,29,24,5,-5,-2.16363632678986,2.16363632678986,0,0,2,0,0,0,2,-2,105,1267,-1162,1162
Mateusz Gamrot,Guram Kutateladze,Guram Kutateladze,2020-10-17,0,1,1,-1,11.5,3,-2.539993,2.539993,0,0,-5.080002,5.080002,209,1,25,16,9,-9,8.5,-8.5,0,0,0,0,0,0,0,0,0,0,0,0
Damir Ismagulov,Guram Kutateladze,Damir Ismagulov,2022-06-18,1,0,1,-1,8,3,-2.539993,2.539993,0,0,5.080002,-5.080002,46,39,27,16,11,-11,5,-5,1,1,0,0,0,0,0,0,1022,609,413,-413
Elves Brener,Guram Kutateladze,Elves Brener,2023-07-01,1,0,-6,6,5,3,-2.539993,2.539993,0,0,0,0,168,143,18,16,2,-2,2,-2,1,0,0,0,1,-1,0,0,140,378,-238,238
Merab Dvalishvili,Gustavo Lopez,Merab Dvalishvili,2020-06-13,1,0,-1,1,4,2,2.539993,-2.539993,0,0,2.540009,-2.540009,555,2,20,18,2,-2,2,-2,3,0,0,0,3,-3,0,0,119,0,119,-119
Anthony Birchak,Gustavo Lopez,Gustavo Lopez,2020-11-07,0,1,3,-3,2,2,7.619995,-7.619995,0,0,5.080002,-5.080002,0,66,24,18,6,-6,0,0,2,0,0,0,2,-2,0,0,1584,147,1437,-1437
Jason Fairn,Guy Mezger,Guy Mezger,1994-12-16,0,1,,,0.8,2.142857,0,0,30,-30,-3,3,0,0,9,44,-35,35,-1.34285706281662,1.34285706281662,0,0,0,0,0,0,0,0,0,0,0,0
John Dowdy,Guy Mezger,Guy Mezger,1995-04-07,0,1,,,0,2.142857,,,,,-18,18,0,0,1,44,-43,43,-2.14285707473755,2.14285707473755,0,1,0,0,-1,1,0,0,0,112,-112,112
Christophe Leninger,Guy Mezger,Guy Mezger,1997-05-30,0,1,,,0.75,2.142857,-2.539993,2.539993,0,0,-5,5,0,0,7,44,-37,37,-1.39285707473755,1.39285707473755,0,2,1,0,-2,2,1,-1,994,784,210,-210
Iuri Alcantara,Hacran Dias,Hacran Dias,2012-06-23,0,1,3,-3,3.5,3.833333,2.539993,-2.539993,-20,20,5.080002,-5.080002,67,541,45,29,16,-16,-0.333333253860474,0.333333253860474,2,0,0,0,2,-2,0,0,161,0,161,-161
Austin Arnett,Hakeem Dawodu,Hakeem Dawodu,2018-07-28,0,1,-1,1,2.666667,3.25,10.16,-10.16,0,0,-2.539993,2.539993,0,46,22,17,5,-5,-0.583333253860474,0.583333253860474,0,0,1,0,0,0,1,-1,182,0,182,-182
Kyle Bochniak,Hakeem Dawodu,Hakeem Dawodu,2018-12-08,0,1,4,-4,1.6,3.25,-2.540009,2.540009,0,0,-7.619995,7.619995,111,2,13,17,-4,4,-1.64999997615814,1.64999997615814,0,1,0,0,-1,1,0,0,245,133,112,-112
Julio Arce,Hakeem Dawodu,Hakeem Dawodu,2019-11-02,0,1,2,-2,3,3.25,-2.540009,2.540009,-10,10,-7.619995,7.619995,56,219,24,17,7,-7,-0.25,0.25,1,2,0,0,-1,1,0,0,168,329,-161,161
Maycee Barber,Hannah Cifers,Maycee Barber,2018-11-10,1,0,-6,6,6.5,1.428571,10.16,-10.16,10,-10,7.62001,-7.62001,213,28,15,17,-2,2,5.07142853736877,-5.07142853736877,0,0,0,0,0,0,0,0,0,0,0,0
Mariya Agapova,Hannah Cifers,Mariya Agapova,2020-06-13,1,0,-4,4,2.5,1.428571,12.7,-12.7,10,-10,15.24001,-15.24001,24,30,14,17,-3,3,1.07142853736877,-1.07142853736877,0,0,0,1,0,0,-1,1,0,581,-581,581
Diana Belbita,Hannah Goldy,Diana Belbita,2021-07-24,1,0,-4,4,2.142857,1.5,7.619995,-7.619995,0,0,17.78,-17.78,6,319,22,10,12,-12,0.642857074737549,-0.642857074737549,0,0,0,0,0,0,0,0,374,0,374,-374
Francimar Barroso,Hans Stringer,Hans Stringer,2014-03-23,0,1,8,-8,2.714286,2.75,-5.080002,5.080002,0,0,-2.5,2.5,181,352,26,30,-4,4,-3.57143878936768e-02,3.57143878936768e-02,1,0,0,0,1,-1,0,0,232,0,232,-232
Fabio Maldonado,Hans Stringer,Fabio Maldonado,2014-10-25,1,0,7,-7,2.090909,2.75,-5.080002,5.080002,0,0,-2.5,2.5,103,357,34,30,4,-4,-0.659090995788574,0.659090995788574,0,1,2,0,-1,1,2,-2,147,216,-69,69
Ilir Latifi,Hans Stringer,Ilir Latifi,2015-07-18,1,0,4,-4,1.888889,2.75,-12.7,12.7,25,-25,-7.580002,7.580002,2,0,26,30,-4,4,-0.861111164093018,0.861111164093018,0,0,0,1,0,0,-1,1,833,266,567,-567
Mark Hall,Harold Howard,Mark Hall,1995-09-08,1,0,,,0.8333333,0.3333333,-5.080002,5.080002,-50,50,-5,5,0,0,11,4,7,-7,0.499999970197678,-0.499999970197678,0,0,0,0,0,0,0,0,0,0,0,0
Alex Hunter,Harry Moskowitz,Alex Hunter,1997-10-17,1,0,,,2,0.5,-20.32001,20.32001,-49,49,-22,22,0,0,2,18,-16,16,1.5,-1.5,0,0,0,0,0,0,0,0,0,0,0,0
Clay Guida,Hatsu Hioki,Clay Guida,2013-01-26,1,0,2,-2,1.9,2.9,-10.16,10.16,10,-10,-7.619995,7.619995,513,10,58,39,19,-19,-1.00000011920929,1.00000011920929,0,0,0,0,0,0,0,0,218,0,218,-218
Darren Elkins,Hatsu Hioki,Darren Elkins,2013-08-28,1,0,-1,1,2.454545,2.9,-2.539993,2.539993,0,0,-5.080002,5.080002,417,90,38,39,-1,1,-0.445454597473145,0.445454597473145,0,0,1,0,0,0,1,-1,130,214,-84,84
Matt Hughes,Hayato Sakurai,Matt Hughes,2002-03-22,1,0,2,-2,5,2.923077,5.080002,-5.080002,2,-2,12.42,-12.42,952,0,54,51,3,-3,2.07692313194275,-2.07692313194275,2,0,0,0,2,-2,0,0,140,0,140,-140
Tim Boetsch,Hector Lombard,Tim Boetsch,2012-07-21,1,0,-3,3,1.615385,3.4,7.62001,-7.62001,0,0,7.62001,-7.62001,7,143,34,44,-10,10,-1.7846155166626,1.7846155166626,3,0,1,0,3,-3,1,-1,147,0,147,-147
Dan Henderson,Hector Lombard,Dan Henderson,2016-06-04,1,0,7,-7,2.133333,3.4,5.080002,-5.080002,0,0,7.62001,-7.62001,2,136,47,44,3,-3,-1.26666665077209,1.26666665077209,0,0,1,0,0,0,1,-1,497,1414,-917,917
Johny Hendricks,Hector Lombard,Johny Hendricks,2017-02-19,1,0,-6,6,2.25,3.4,0,0,0,0,-5.080002,5.080002,0,122,26,44,-18,18,-1.15000009536743,1.15000009536743,0,0,1,1,0,0,0,0,51,260,-209,209
CB Dollaway,Hector Lombard,CB Dollaway,2018-03-03,1,0,-6,6,1.888889,3.4,12.70001,-12.70001,0,0,12.7,-12.7,0,0,26,44,-18,18,-1.51111125946045,1.51111125946045,1,0,4,1,1,-1,3,-3,239,377,-138,138
Thales Leites,Hector Lombard,Thales Leites,2018-09-22,1,0,-3,3,3.111111,3.4,10.16,-10.16,0,0,17.78,-17.78,20,93,37,44,-7,7,-0.288888931274414,0.288888931274414,0,0,0,1,0,0,-1,1,350,203,147,-147
James Irvin,Hector Ramirez,James Irvin,2006-11-18,1,0,-2,2,1.7,1.666667,5.080002,-5.080002,0,0,5.5,-5.5,6,221,27,16,11,-11,3.3333420753479e-02,-3.3333420753479e-02,1,0,1,0,1,-1,1,-1,455,0,455,-455
Forrest Griffin,Hector Ramirez,Forrest Griffin,2007-06-16,1,0,-3,3,2.714286,1.666667,7.619995,-7.619995,0,0,10.58,-10.58,9,36,26,16,10,-10,1.04761898517609,-1.04761898517609,0,0,1,1,0,0,0,0,168,210,-42,42
Wilson Reis,Hector Sandoval,Wilson Reis,2016-07-30,1,0,1,-1,2.3,3.5,5.080002,-5.080002,0,0,2.540009,-2.540009,65,7,33,18,15,-15,-1.20000004768372,1.20000004768372,1,0,0,0,1,-1,0,0,707,0,707,-707
Dustin Ortiz,Hector Sandoval,Dustin Ortiz,2017-08-05,1,0,-3,3,2.375,3.5,7.62001,-7.62001,0,0,2.540009,-2.540009,2,0,27,18,9,-9,-1.125,1.125,0,0,0,0,0,0,0,0,553,371,182,-182
Edgar Garcia,Hector Urbina,Hector Urbina,2014-11-15,0,1,3,-3,2.8,1.7,-2.539993,2.539993,0,0,-5.080002,5.080002,99,71,19,27,-8,8,1.09999990463257,-1.09999990463257,0,0,0,0,0,0,0,0,1799,0,1799,-1799
Bartosz Fabinski,Hector Urbina,Bartosz Fabinski,2015-11-21,1,0,1,-1,3,1.7,2.540009,-2.540009,0,0,5.080002,-5.080002,813,19,20,27,-7,7,1.29999995231628,-1.29999995231628,1,1,0,0,0,0,0,0,224,371,-147,147
Vicente Luque,Hector Urbina,Vicente Luque,2016-09-24,1,0,-5,5,2.444444,1.7,0,0,0,0,5.080002,-5.080002,1,16,31,27,4,-4,0.744444370269775,-0.744444370269775,0,0,0,0,0,0,0,0,0,308,-308,308
Joachim Christensen,Henrique da Silva,Henrique da Silva,2016-10-01,0,1,10,-10,2.333333,2.8,0,0,0,0,0,0,168,173,20,19,1,-1,-0.466666698455811,0.466666698455811,0,0,0,0,0,0,0,0,0,0,0,0
Paul Craig,Henrique da Silva,Paul Craig,2016-12-17,1,0,2,-2,2.833333,2.8,0,0,-20,20,0,0,128,201,23,19,4,-4,3.33333015441895e-02,-3.33333015441895e-02,0,1,0,0,-1,1,0,0,0,77,-77,77
Ion Cutelaba,Henrique da Silva,Ion Cutelaba,2017-06-10,1,0,-4,4,1.888889,2.8,-5.080002,5.080002,0,0,-2.539993,2.539993,9,0,26,19,7,-7,-0.911111116409302,0.911111116409302,1,0,0,0,1,-1,0,0,252,175,77,-77
Chris Cariaso,Henry Cejudo,Henry Cejudo,2015-03-14,0,1,5,-5,2.125,5.333333,-2.539993,2.539993,-10,10,0,0,42,569,25,19,6,-6,-3.20833349227905,3.20833349227905,0,0,0,0,0,0,0,0,168,0,168,-168
Chico Camus,Henry Cejudo,Henry Cejudo,2015-06-13,0,1,2,-2,2.428571,5.333333,5.080002,-5.080002,-10,10,5.080002,-5.080002,31,305,24,19,5,-5,-2.90476202964783,2.90476202964783,1,1,0,0,0,0,0,0,203,91,112,-112
Joseph Benavidez,Henry Cejudo,Joseph Benavidez,2016-12-03,1,0,3,-3,3.5,5.333333,0,0,-10,10,2.540009,-2.540009,1,13,36,19,17,-17,-1.83333349227905,1.83333349227905,4,2,1,0,2,-2,1,-1,301,539,-238,238
Bernardo Magalhaes,Henry Martinez,Henry Martinez,2012-06-08,0,1,3,-3,3.25,2.25,5.080002,-5.080002,0,0,2.740005,-2.740005,1,14,17,13,4,-4,1,-1,0,0,0,0,0,0,0,0,114,0,114,-114
Daron Cruickshank,Henry Martinez,Daron Cruickshank,2012-12-08,1,0,-2,2,1.8,2.25,2.540009,-2.540009,0,0,7.62001,-7.62001,1,129,28,13,15,-15,-0.450000047683716,0.450000047683716,1,1,0,0,0,0,0,0,190,183,7,-7
Bill Algeo,Herbert Burns,Bill Algeo,2022-07-16,1,0,-1,1,2.428571,2.75,7.62001,-7.62001,0,0,0,0,326,32,24,15,9,-9,-0.321428537368774,0.321428537368774,1,0,0,0,1,-1,0,0,182,0,182,-182
Richard Crunkilton,Hermes Franca,Hermes Franca,2003-04-25,0,1,-5,5,4.75,1.411765,2.539993,-2.539993,0,0,-7.339996,7.339996,441,43,23,41,-18,18,3.33823525905609,-3.33823525905609,0,0,0,0,0,0,0,0,0,0,0,0
Yves Edwards,Hermes Franca,Yves Edwards,2004-04-02,1,0,-2,2,1.909091,1.411765,7.619995,-7.619995,0,0,5.080002,-5.080002,291,227,64,41,23,-23,0.497326135635376,-0.497326135635376,2,1,0,0,1,-1,0,0,301,343,-42,42
Spencer Fisher,Hermes Franca,Hermes Franca,2007-01-25,0,1,-2,2,2.666667,1.411765,2.539993,-2.539993,0,0,-7.619995,7.619995,4,233,33,41,-8,8,1.25490200519562,-1.25490200519562,2,0,0,0,2,-2,0,0,103,1028,-925,925
Frankie Edgar,Hermes Franca,Frankie Edgar,2008-07-19,1,0,-7,7,2.090909,1.411765,0,0,-20,20,-7.619995,7.619995,728,0,34,41,-7,7,0.679144263267517,-0.679144263267517,0,1,0,0,-1,1,0,0,108,541,-433,433
Marcus Aurelio,Hermes Franca,Hermes Franca,2008-10-25,0,1,1,-1,2.2,1.411765,10.16,-10.16,0,0,7.62001,-7.62001,110,2,32,41,-9,9,0.788235306739807,-0.788235306739807,0,0,0,0,0,0,0,0,112,98,14,-14
Jordan Mein,Hernani Perpetuo,Jordan Mein,2014-04-19,1,0,-4,4,2.583333,3.6,0,0,0,0,0.4199982,-0.4199982,192,44,43,23,20,-20,-1.01666665077209,1.01666665077209,1,0,0,0,1,-1,0,0,399,0,399,-399
Tim Means,Hernani Perpetuo,Tim Means,2014-07-26,1,0,1,-1,2.2,3.6,5.080002,-5.080002,0,0,5.5,-5.5,33,2,48,23,25,-25,-1.39999985694885,1.39999985694885,1,0,0,0,1,-1,0,0,778,98,680,-680
Germaine de Randamie,Holly Holm,Germaine de Randamie,2017-02-11,1,0,-3,3,2.5,2.142857,2.539993,-2.539993,0,0,5.080002,-5.080002,38,497,14,22,-8,8,0.357142925262451,-0.357142925262451,2,0,1,0,2,-2,1,-1,279,0,279,-279
Bethe Correia,Holly Holm,Holly Holm,2017-06-17,0,1,-2,2,1.833333,2.142857,-7.619995,7.619995,0,0,-12.7,12.7,13,2,17,22,-5,5,-0.309523701667786,0.309523701667786,1,0,1,0,1,-1,1,-1,280,126,154,-154
Megan Anderson,Holly Holm,Holly Holm,2018-06-09,0,1,-8,8,2.2,2.142857,10.16,-10.16,10,-10,7.62001,-7.62001,0,643,16,22,-6,6,5.7142972946167e-02,-5.7142972946167e-02,0,1,0,0,-1,1,0,0,0,357,-357,357
Irene Aldana,Holly Holm,Holly Holm,2020-10-03,0,1,-6,6,2,2.142857,2.539993,-2.539993,0,0,-2.539993,2.539993,3,316,21,22,-1,1,-0.142857074737549,0.142857074737549,2,2,0,0,0,0,0,0,294,847,-553,553
Mayra Bueno Silva,Holly Holm,Mayra Bueno Silva,2023-07-15,1,0,-10,10,5.5,2.142857,-5.080002,5.080002,0,0,-7.619995,7.619995,0,185,13,22,-9,9,3.35714292526245,-3.35714292526245,3,3,0,0,0,0,0,0,147,1015,-868,868
Enrique Barzola,Horacio Gutierrez,Enrique Barzola,2015-11-21,1,0,1,-1,3.4,1.333333,-7.62001,7.62001,0,0,-5.199997,5.199997,660,0,22,7,15,-15,2.06666672229767,-2.06666672229767,0,0,0,0,0,0,0,0,0,0,0,0
Dwayne Cason,Houston Dorr,Dwayne Cason,1997-10-17,1,0,,,1,0.5,-7.619995,7.619995,2,-2,-5,5,0,0,2,3,-1,1,0.5,-0.5,0,0,0,0,0,0,0,0,0,0,0,0
Cyril Asker,Hu Yaozong,Cyril Asker,2017-11-25,1,0,9,-9,2.25,1,-7.619995,7.619995,62,-62,5.080002,-5.080002,370,14,13,6,7,-7,1.25,-1.25,0,0,2,0,0,0,2,-2,161,0,161,-161
Rashad Coulter,Hu Yaozong,Rashad Coulter,2018-11-24,1,0,13,-13,2.25,1,-10.16,10.16,20,-20,10.15999,-10.15999,12,322,13,6,7,-7,1.25,-1.25,0,0,3,0,0,0,3,-3,168,364,-196,196
Andre Petroski,Hu Yaozong,Andre Petroski,2021-10-30,1,0,4,-4,5,1,-7.619995,7.619995,0,0,2.539993,-2.539993,579,13,12,6,6,-6,4,-4,0,0,0,0,0,0,0,0,0,1071,-1071,1071
David Abbott,Hugo Duarte,David Abbott,1998-05-15,1,0,,,0.6666667,2,0,0,25,-25,-3.5,3.5,0,0,25,9,16,-16,-1.33333331346512,1.33333331346512,1,0,1,0,1,-1,1,-1,145,0,145,-145
John Teixeira,Hugo Viana,Hugo Viana,2012-06-23,0,1,-4,4,10.5,2,2.539993,-2.539993,10,-10,2.820007,-2.820007,106,74,23,12,11,-11,8.5,-8.5,0,0,0,0,0,0,0,0,0,0,0,0
Reuben Duran,Hugo Viana,Hugo Viana,2012-12-15,0,1,-1,1,1.571429,2,2.539993,-2.539993,0,0,10.16,-10.16,22,37,18,12,6,-6,-0.428571462631226,0.428571462631226,1,1,0,0,0,0,0,0,560,175,385,-385
TJ Dillashaw,Hugo Viana,TJ Dillashaw,2013-04-20,1,0,-3,3,3.6,2,0,0,0,0,0,0,62,0,23,12,11,-11,1.59999990463257,-1.59999990463257,3,2,1,0,1,-1,1,-1,35,126,-91,91
Ramiro Hernandez,Hugo Viana,Hugo Viana,2014-01-25,0,1,-4,4,2.111111,2,7.619995,-7.619995,0,0,7.820007,-7.820007,0,4,28,12,16,-16,0.111111164093018,-0.111111164093018,0,0,0,1,0,0,-1,1,143,280,-137,137
Aljamain Sterling,Hugo Viana,Aljamain Sterling,2014-07-16,1,0,-7,7,5.75,2,2.539993,-2.539993,0,0,10.16,-10.16,514,0,27,12,15,-15,3.75,-3.75,0,1,0,1,-1,1,-1,1,0,172,-172,172
Guido Cannetti,Hugo Viana,Guido Cannetti,2015-08-01,1,0,3,-3,1.25,2,0,0,0,0,2.540009,-2.540009,237,362,18,12,6,-6,-0.75,0.75,0,0,0,2,0,0,-2,2,0,381,-381,381
Austin Arnett,Humberto Bandenay,Austin Arnett,2018-11-17,1,0,3,-3,2.666667,2,2.540009,-2.540009,0,0,2.540009,-2.540009,358,15,22,21,1,-1,0.666666746139526,-0.666666746139526,0,0,1,0,0,0,1,-1,112,0,112,-112
Gabriel Benitez,Humberto Brown Morrison,Gabriel Benitez,2014-11-15,1,0,-4,4,2.090909,0.6666667,-5.080002,5.080002,10,-10,0.3399963,-0.3399963,25,367,34,10,24,-24,1.42424231767654,-1.42424231767654,0,0,0,0,0,0,0,0,0,0,0,0
Marcelo Guimaraes,Hyun Gyu Lim,Hyun Gyu Lim,2013-03-02,0,1,1,-1,4.5,1.857143,-7.619995,7.619995,15,-15,-10.16,10.16,64,2,11,20,-9,9,2.64285719394684,-2.64285719394684,1,0,0,0,1,-1,0,0,234,0,234,-234
Daichi Abe,Hyun Gyu Lim,Daichi Abe,2017-09-22,1,0,-7,7,3,1.857143,-10.16,10.16,0,0,-15.24001,15.24001,5,0,8,20,-12,12,1.14285719394684,-1.14285719394684,0,1,0,0,-1,1,0,0,0,1665,-1665,1665
SeungGuk Choi,HyunSung Park,HyunSung Park,2023-02-04,0,1,-1,1,2.333333,8,-2.539993,2.539993,0,0,-5.080002,5.080002,158,107,10,8,2,-2,-5.66666674613953,5.66666674613953,0,0,0,0,0,0,0,0,0,0,0,0
Anthony Birchak,Ian Entwistle,Ian Entwistle,2014-12-13,0,1,0,0,2,3,7.619995,-7.619995,0,0,7.259995,-7.259995,26,0,24,12,12,-12,-1,1,0,0,0,0,0,0,0,0,0,0,0,0
Scott Adams,Ian Freeman,Scott Adams,2000-03-10,1,0,,,8,2.857143,2.540009,-2.540009,0,0,12,-12,77,17,9,27,-18,18,5.14285707473755,-5.14285707473755,0,0,0,0,0,0,0,0,0,0,0,0
Andrei Arlovski,Ian Freeman,Andrei Arlovski,2002-11-22,1,0,-13,13,1.545455,2.857143,10.16,-10.16,15,-15,12.58,-12.58,3,0,56,27,29,-29,-1.31168842315674,1.31168842315674,0,0,2,0,0,0,2,-2,245,987,-742,742
Cezar Ferreira,Ian Heinisch,Ian Heinisch,2018-11-17,0,1,3,-3,1.625,2.8,5.080002,-5.080002,0,0,15.23999,-15.23999,320,90,21,19,2,-2,-1.17499995231628,1.17499995231628,2,0,1,0,2,-2,1,-1,189,0,189,-189
Antonio Carlos Junior,Ian Heinisch,Ian Heinisch,2019-05-18,0,1,-1,1,2.2,2.8,7.62001,-7.62001,0,0,17.78,-17.78,384,282,16,19,-3,3,-0.599999904632568,0.599999904632568,4,1,1,0,3,-3,1,-1,567,182,385,-385
Derek Brunson,Ian Heinisch,Derek Brunson,2019-08-17,1,0,4,-4,2.555556,2.8,5.080002,-5.080002,0,0,12.7,-12.7,132,0,32,19,13,-13,-0.244444370269775,0.244444370269775,1,2,3,0,-1,1,3,-3,105,91,14,-14
Omari Akhmedov,Ian Heinisch,Omari Akhmedov,2019-12-14,1,0,1,-1,3.5,2.8,2.540009,-2.540009,0,0,2.539993,-2.539993,93,150,27,19,8,-8,0.700000047683716,-0.700000047683716,4,0,2,0,4,-4,2,-2,98,119,-21,21
Kelvin Gastelum,Ian Heinisch,Kelvin Gastelum,2021-02-13,1,0,-3,3,2.25,2.8,-5.080002,5.080002,-15,15,-2.540009,2.540009,410,71,26,19,7,-7,-0.549999952316284,0.549999952316284,0,0,0,0,0,0,0,0,210,427,-217,217
Joseph Benavidez,Ian Loveland,Joseph Benavidez,2011-03-19,1,0,-1,1,3.5,1.8,-10.16,10.16,-20,20,-12.89999,12.89999,227,15,36,28,8,-8,1.70000004768372,-1.70000004768372,0,0,0,0,0,0,0,0,0,0,0,0
Yves Jabouin,Ian Loveland,Yves Jabouin,2011-08-27,1,0,5,-5,1.818182,1.8,-2.540009,2.540009,-10,10,-5.279999,5.279999,59,151,31,28,3,-3,1.81819200515747e-02,-1.81819200515747e-02,0,0,0,0,0,0,0,0,0,161,-161,161
Demetrious Johnson,Ian McCall,Demetrious Johnson,2012-06-08,1,0,-3,3,9,2.6,-5.080002,5.080002,0,0,5.080002,-5.080002,123,185,30,18,12,-12,6.40000009536743,-6.40000009536743,2,0,0,0,2,-2,0,0,377,0,377,-377
Joseph Benavidez,Ian McCall,Joseph Benavidez,2013-02-02,1,0,0,0,3.5,2.6,-2.540009,2.540009,0,0,2.540009,-2.540009,26,89,36,18,18,-18,0.900000095367432,-0.900000095367432,0,0,0,0,0,0,0,0,133,239,-106,106
John Lineker,Ian McCall,John Lineker,2015-01-31,1,0,-6,6,3.444444,2.6,-5.080002,5.080002,10,-10,7.619995,-7.619995,46,210,40,18,22,-22,0.844444513320923,-0.844444513320923,3,0,0,0,3,-3,0,0,199,728,-529,529
Yazmin Jauregui,Iasmin Lucindo,Yazmin Jauregui,2022-08-13,1,0,3,-3,10,3,0,0,0,0,-5.080002,5.080002,13,34,11,20,-9,9,7,-7,0,0,0,0,0,0,0,0,0,0,0,0
Ildemar Alcantara,Igor Araujo,Igor Araujo,2013-10-09,0,1,-2,2,1.909091,2.777778,2.540009,-2.540009,15,-15,2.539993,-2.539993,271,439,32,34,-2,2,-0.86868679523468,0.86868679523468,2,0,0,0,2,-2,0,0,123,0,123,-123
Vladimir Matyushenko,Igor Pokrajac,Vladimir Matyushenko,2009-09-19,1,0,8,-8,3.375,2.153846,0,0,0,0,0,0,402,43,35,41,-6,6,1.2211537361145,-1.2211537361145,2,0,0,0,2,-2,0,0,2395,0,2395,-2395
James Irvin,Igor Pokrajac,Igor Pokrajac,2010-08-01,0,1,0,0,1.7,2.153846,5.080002,-5.080002,0,0,2.539993,-2.539993,66,62,27,41,-14,14,-0.453846216201782,0.453846216201782,0,0,4,0,0,0,4,-4,133,316,-183,183
Stephan Bonnar,Igor Pokrajac,Stephan Bonnar,2010-12-04,1,0,2,-2,1.666667,2.153846,10.15999,-10.15999,0,0,12.7,-12.7,718,83,24,41,-17,17,-0.487179636955261,0.487179636955261,1,1,1,0,0,0,1,-1,154,125,29,-29
Todd Brown,Igor Pokrajac,Igor Pokrajac,2011-03-03,0,1,2,-2,4,2.153846,-2.540009,2.540009,0,0,-4.960007,4.960007,126,35,20,41,-21,21,1.8461537361145,-1.8461537361145,0,0,0,0,0,0,0,0,0,89,-89,89
Fabio Maldonado,Igor Pokrajac,Igor Pokrajac,2012-05-15,0,1,-1,1,2.090909,2.153846,2.539993,-2.539993,0,0,2.539993,-2.539993,166,367,34,41,-7,7,-6.29372596740723e-02,6.29372596740723e-02,1,1,0,0,0,0,0,0,577,439,138,-138
Vinny Magalhaes,Igor Pokrajac,Vinny Magalhaes,2012-09-22,1,0,-5,5,1.555556,2.153846,7.619995,-7.619995,0,0,2.539993,-2.539993,99,185,23,41,-18,18,-0.598290681838989,0.598290681838989,0,2,0,0,-2,2,0,0,1253,130,1123,-1123
Ryan Jimmo,Igor Pokrajac,Ryan Jimmo,2013-06-15,1,0,-3,3,3.8,2.153846,2.539993,-2.539993,0,0,-2.540009,2.540009,644,58,24,41,-17,17,1.64615368843079,-1.64615368843079,0,0,0,0,0,0,0,0,119,266,-147,147
Rafael Cavalcante,Igor Pokrajac,Rafael Cavalcante,2013-11-09,1,0,-1,1,1.714286,2.153846,2.539993,-2.539993,0,0,0,0,3,50,19,41,-22,22,-0.439560532569885,0.439560532569885,0,0,1,0,0,0,1,-1,154,147,7,-7
Jan Blachowicz,Igor Pokrajac,Jan Blachowicz,2016-04-10,1,0,-4,4,2.9,2.153846,5.080002,-5.080002,0,0,10.15999,-10.15999,504,197,39,41,-2,2,0.746153831481934,-0.746153831481934,0,0,0,1,0,0,-1,1,365,883,-518,518
Frank Shamrock,Igor Zinoviev,Frank Shamrock,1998-03-13,1,0,,,2.3,4,-7.619995,7.619995,-14,14,-8,8,0,0,33,5,28,-28,-1.70000004768372,1.70000004768372,0,0,0,0,0,0,0,0,0,0,0,0
Nicolae Negumereanu,Ihor Potieria,Nicolae Negumereanu,2022-07-30,1,0,1,-1,6.5,4.75,-7.619995,7.619995,0,0,7.619995,-7.619995,241,0,15,23,-8,8,1.75,-1.75,2,0,0,0,2,-2,0,0,147,0,147,-147
Chase Sherman,Ike Villanueva,Chase Sherman,2020-05-13,1,0,-6,6,1.333333,1.285714,7.619995,-7.619995,45,-45,12.7,-12.7,0,0,28,32,-4,4,4.7619104385376e-02,-4.7619104385376e-02,0,0,0,0,0,0,0,0,753,0,753,-753
Vinicius Moreira,Ike Villanueva,Ike Villanueva,2021-01-20,0,1,-5,5,1.8,1.285714,7.619995,-7.619995,0,0,7.619995,-7.619995,0,0,14,32,-18,18,0.514285683631897,-0.514285683631897,0,0,0,1,0,0,-1,1,0,252,-252,252
Marcin Prachnio,Ike Villanueva,Marcin Prachnio,2021-06-26,1,0,-5,5,2.285714,1.285714,5.080002,-5.080002,0,0,2.540009,-2.540009,0,5,23,32,-9,9,1.00000011920929,-1.00000011920929,1,1,1,1,0,0,0,0,154,157,-3,3
Nicolae Negumereanu,Ike Villanueva,Nicolae Negumereanu,2021-10-23,1,0,-10,10,6.5,1.285714,-2.539993,2.539993,0,0,12.7,-12.7,20,0,15,32,-17,17,5.21428573131561,-5.21428573131561,0,0,0,2,0,0,-2,2,952,119,833,-833
Tyson Pedro,Ike Villanueva,Tyson Pedro,2022-04-23,1,0,-8,8,2.5,1.285714,5.080002,-5.080002,0,0,15.24001,-15.24001,0,0,14,32,-18,18,1.21428573131561,-1.21428573131561,0,0,1,3,0,0,-2,2,1239,182,1057,-1057
Damon Jackson,Ilia Topuria,Ilia Topuria,2020-12-05,0,1,9,-9,3.666667,14,10.16,-10.16,0,0,5.080002,-5.080002,13,3,28,14,14,-14,-10.3333332538605,10.3333332538605,0,0,0,0,0,0,0,0,2289,0,2289,-2289
Ryan Hall,Ilia Topuria,Ilia Topuria,2021-07-10,0,1,12,-12,4.5,14,7.62001,-7.62001,0,0,2.540009,-2.540009,0,80,11,14,-3,3,-9.5,9.5,3,1,0,0,2,-2,0,0,924,217,707,-707
Jai Herbert,Ilia Topuria,Ilia Topuria,2022-03-19,0,1,8,-8,2.4,14,15.24001,-15.24001,10,-10,20.32001,-20.32001,7,161,17,14,3,-3,-11.5999999046326,11.5999999046326,1,2,1,0,-1,1,1,-1,147,252,-105,105
Bryce Mitchell,Ilia Topuria,Ilia Topuria,2022-12-10,0,1,3,-3,8,14,7.62001,-7.62001,0,0,2.540009,-2.540009,89,78,18,14,4,-4,-6,6,3,3,0,0,0,0,0,0,945,266,679,-679
Josh Emmett,Ilia Topuria,Ilia Topuria,2023-06-24,0,1,12,-12,4.5,14,-2.539993,2.539993,0,0,2.540009,-2.540009,0,215,22,14,8,-8,-9.5,9.5,0,4,1,0,-4,4,1,-1,133,196,-63,63
Iuri Alcantara,Iliarde Santos,Iuri Alcantara,2013-05-18,1,0,0,0,3.5,2.307692,10.15999,-10.15999,10,-10,10.16,-10.16,5,25,45,43,2,-2,1.19230771064758,-1.19230771064758,0,0,0,0,0,0,0,0,329,0,329,-329
Ian McCall,Iliarde Santos,Ian McCall,2013-08-03,1,0,-3,3,2.6,2.307692,0,0,0,0,-7.619995,7.619995,61,38,18,43,-25,25,0.292307615280151,-0.292307615280151,0,0,0,1,0,0,-1,1,0,77,-77,77
Chris Cariaso,Iliarde Santos,Chris Cariaso,2013-10-09,1,0,-1,1,2.125,2.307692,-5.080002,5.080002,0,0,-7.619995,7.619995,43,140,25,43,-18,18,-0.182692289352417,0.182692289352417,0,0,0,1,0,0,-1,1,144,67,77,-77
Cyrille Diabate,Ilir Latifi,Ilir Latifi,2014-03-08,0,1,9,-9,1.9,1.888889,20.31999,-20.31999,-25,25,20.32001,-20.32001,0,109,29,26,3,-3,1.11111402511597e-02,-1.11111402511597e-02,0,0,1,0,0,0,1,-1,385,0,385,-385
Chris Dempsey,Ilir Latifi,Ilir Latifi,2014-07-19,0,1,-5,5,2.2,1.888889,0,0,-45,45,-2.539993,2.539993,0,3,16,26,-10,10,0.311111211776733,-0.311111211776733,0,1,0,0,-1,1,0,0,0,133,-133,133
Jan Blachowicz,Ilir Latifi,Jan Blachowicz,2014-10-04,1,0,-1,1,2.9,1.888889,10.16,-10.16,-25,25,12.7,-12.7,6,0,39,26,13,-13,1.01111125946045,-1.01111125946045,0,2,0,0,-2,2,0,0,0,77,-77,77
Ryan Bader,Ilir Latifi,Ryan Bader,2016-09-03,1,0,-1,1,4.6,1.888889,10.16,-10.16,-25,25,2.540009,-2.540009,2,26,28,26,2,-2,2.71111106872559,-2.71111106872559,0,0,3,1,0,0,2,-2,217,700,-483,483
Corey Anderson,Ilir Latifi,Corey Anderson,2018-12-29,1,0,-7,7,2.8,1.888889,12.7,-12.7,-25,25,15.24001,-15.24001,23,46,19,26,-7,7,0.911111116409302,-0.911111116409302,2,0,3,2,2,-2,1,-1,160,847,-687,687
Tanner Boser,Ilir Latifi,Ilir Latifi,2021-06-05,0,1,-9,9,2.1,1.888889,10.16,-10.16,-25,25,5.080002,-5.080002,42,398,31,26,5,-5,0.211111068725586,-0.211111068725586,2,0,0,2,2,-2,-2,2,315,889,-574,574
Joaquin Buckley,Impa Kasanganay,Joaquin Buckley,2020-10-10,1,0,0,0,2.666667,4.5,-2.539993,2.539993,0,0,2.539993,-2.539993,63,0,22,11,11,-11,-1.83333325386047,1.83333325386047,0,0,1,0,0,0,1,-1,63,0,63,-63
Carlston Harris,Impa Kasanganay,Carlston Harris,2021-09-18,1,0,7,-7,3.8,4.5,2.540009,-2.540009,0,0,2.539993,-2.539993,21,0,24,11,13,-13,-0.700000047683716,0.700000047683716,0,0,0,1,0,0,-1,1,0,343,-343,343
Misha Cirkunov,Ion Cutelaba,Misha Cirkunov,2016-06-18,1,0,7,-7,1.666667,1.888889,5.080002,-5.080002,0,0,5.080002,-5.080002,73,9,24,26,-2,2,-0.222222208976746,0.222222208976746,2,0,0,0,2,-2,0,0,133,0,133,-133
Jared Cannonier,Ion Cutelaba,Jared Cannonier,2016-12-03,1,0,10,-10,2.833333,1.888889,-5.080002,5.080002,-20,20,5.080002,-5.080002,189,286,23,26,-3,3,0.944444417953491,-0.944444417953491,0,0,1,0,0,0,1,-1,700,168,532,-532
Gadzhimurad Antigulov,Ion Cutelaba,Ion Cutelaba,2018-07-28,0,1,7,-7,2.5,1.888889,-5.080002,5.080002,0,0,-12.7,12.7,201,28,28,26,2,-2,0.611111164093018,-0.611111164093018,2,0,0,0,2,-2,0,0,441,602,-161,161
Magomed Ankalaev,Ion Cutelaba,Magomed Ankalaev,2020-02-29,1,0,1,-1,18,1.888889,5.080002,-5.080002,0,0,0,0,0,0,19,26,-7,7,16.111111164093,-16.111111164093,2,1,0,0,1,-1,0,0,112,581,-469,469
Magomed Ankalaev,Ion Cutelaba,Magomed Ankalaev,2020-10-24,1,0,2,-2,18,1.888889,5.080002,-5.080002,0,0,0,0,5,0,19,26,-7,7,16.111111164093,-16.111111164093,3,0,0,1,3,-3,-1,1,238,238,0,0
Devin Clark,Ion Cutelaba,Ion Cutelaba,2021-09-18,0,1,4,-4,1.75,1.888889,-2.539993,2.539993,0,0,0,0,118,528,22,26,-4,4,-0.138888835906982,0.138888835906982,0,0,2,2,0,0,0,0,294,329,-35,35
Tanner Boser,Ion Cutelaba,Ion Cutelaba,2023-04-15,0,1,2,-2,2.1,1.888889,2.540009,-2.540009,0,0,0,0,0,17,31,26,5,-5,0.211111068725586,-0.211111068725586,0,1,0,2,-1,1,-2,2,210,574,-364,364
Giga Chikadze,Irwin Rivera,Giga Chikadze,2020-05-16,1,0,0,0,5,1.666667,15.24001,-15.24001,10,-10,17.78001,-17.78001,6,3,18,16,2,-2,3.33333337306976,-3.33333337306976,2,0,0,0,2,-2,0,0,70,0,70,-70
Ali AlQaisi,Irwin Rivera,Irwin Rivera,2020-08-08,0,1,-2,2,1.6,1.666667,0,0,0,0,2.540009,-2.540009,115,62,13,16,-3,3,-6.66666030883789e-02,6.66666030883789e-02,0,0,0,0,0,0,0,0,0,84,-84,84
Andre Ewell,Irwin Rivera,Andre Ewell,2020-09-19,1,0,1,-1,1.888889,1.666667,5.080002,-5.080002,10,-10,20.32001,-20.32001,48,18,26,16,10,-10,0.222222208976746,-0.222222208976746,1,1,1,0,0,0,1,-1,224,42,182,-182
Yves Edwards,Isaac Vallie-Flagg,Isaac Vallie-Flagg,2013-02-02,0,1,2,-2,1.909091,2.285714,2.539993,-2.539993,0,0,7.619995,-7.619995,171,134,64,23,41,-41,-0.376623511314392,0.376623511314392,1,0,2,0,1,-1,2,-2,56,0,56,-56
Elias Silverio,Isaac Vallie-Flagg,Elias Silverio,2014-01-15,1,0,-8,8,4.333333,2.285714,7.619995,-7.619995,0,0,7.619995,-7.619995,679,0,16,23,-7,7,2.04761910438538,-2.04761910438538,1,1,0,0,0,0,0,0,133,347,-214,214
Takanori Gomi,Isaac Vallie-Flagg,Takanori Gomi,2014-04-26,1,0,-1,1,2.5,2.285714,-2.540009,2.540009,0,0,0,0,232,71,49,23,26,-26,0.214285612106323,-0.214285612106323,0,0,0,0,0,0,0,0,420,101,319,-319
Leo Kuntz,Islam Makhachev,Islam Makhachev,2015-05-23,0,1,8,-8,4.5,24,0,0,0,0,2.199997,-2.199997,0,180,22,25,-3,3,-19.5,19.5,0,0,0,0,0,0,0,0,0,0,0,0
Nik Lentz,Islam Makhachev,Islam Makhachev,2017-02-11,0,1,7,-7,2.5,24,-5.080002,5.080002,-10,10,-5.080002,5.080002,31,714,42,25,17,-17,-21.5,21.5,1,1,0,0,0,0,0,0,154,630,-476,476
Kajan Johnson,Islam Makhachev,Islam Makhachev,2018-07-28,0,1,8,-8,1.769231,24,2.539993,-2.539993,0,0,12.7,-12.7,0,88,36,25,11,-11,-22.230769276619,22.230769276619,4,2,0,0,2,-2,0,0,133,532,-399,399
Drew Dober,Islam Makhachev,Islam Makhachev,2021-03-06,0,1,3,-3,2.166667,24,-5.080002,5.080002,0,0,0,0,12,566,38,25,13,-13,-21.8333332538605,21.8333332538605,6,3,0,0,3,-3,0,0,297,952,-655,655
Dan Hooker,Islam Makhachev,Islam Makhachev,2021-10-30,0,1,1,-1,1.916667,24,5.080002,-5.080002,0,0,12.7,-12.7,0,108,35,25,10,-10,-22.0833333730698,22.0833333730698,0,4,0,0,-4,4,0,0,490,238,252,-252
Bobby Green,Islam Makhachev,Islam Makhachev,2022-02-26,0,1,5,-5,2.142857,24,0,0,0,0,2.539993,-2.539993,0,117,44,25,19,-19,-21.8571429252625,21.8571429252625,2,5,1,0,-3,3,1,-1,14,119,-105,105
Siyar Bahadurzada,Ismail Naurdiev,Ismail Naurdiev,2019-09-28,0,1,12,-12,3,4.75,2.539993,-2.539993,0,0,-2.540009,2.540009,0,344,32,23,9,-9,-1.75,1.75,0,0,0,0,0,0,0,0,273,0,273,-273
Sean Brady,Ismail Naurdiev,Sean Brady,2020-02-29,1,0,4,-4,15,4.75,0,0,0,0,-5.080002,5.080002,478,18,16,23,-7,7,10.25,-10.25,1,1,0,0,0,0,0,0,134,154,-20,20
Raphael Assuncao,Issei Tamura,Raphael Assuncao,2012-07-11,1,0,1,-1,2.8,1.25,0,0,0,0,7.619995,-7.619995,43,0,38,18,20,-20,1.54999995231628,-1.54999995231628,1,0,1,0,1,-1,1,-1,319,0,319,-319
TJ Dillashaw,Issei Tamura,TJ Dillashaw,2013-03-16,1,0,-2,2,3.6,1.25,2.539993,-2.539993,0,0,10.15999,-10.15999,175,0,23,18,5,-5,2.34999990463257,-2.34999990463257,2,0,1,1,2,-2,0,0,248,248,0,0
Ariane Carnelossi,Istela Nunes,Ariane Carnelossi,2021-10-16,1,0,-1,1,4.666667,1.2,-5.080002,5.080002,0,0,-12.7,12.7,424,0,17,11,6,-6,3.46666646003723,-3.46666646003723,1,0,1,0,1,-1,1,-1,175,0,175,-175
Sam Hughes,Istela Nunes,Sam Hughes,2022-04-16,1,0,0,0,1.6,1.2,2.540009,-2.540009,0,0,-5.080002,5.080002,206,0,13,11,2,-2,0.399999976158142,-0.399999976158142,0,0,1,0,0,0,1,-1,147,182,-35,35
Yazmin Jauregui,Istela Nunes,Yazmin Jauregui,2022-12-03,1,0,-7,7,10,1.2,-2.539993,2.539993,0,0,-5.080002,5.080002,170,15,11,11,0,0,8.79999995231628,-8.79999995231628,1,0,0,0,1,-1,0,0,112,231,-119,119
Viktoriia Dudakova,Istela Nunes,Viktoriia Dudakova,2023-07-15,1,0,-6,6,7,1.2,2.540009,-2.540009,0,0,2.539993,-2.539993,6,0,7,11,-4,4,5.79999995231628,-5.79999995231628,0,0,0,1,0,0,-1,1,0,224,-224,224
Rodrigo Damm,Ivan Jorge,Rodrigo Damm,2014-02-15,1,0,1,-1,1.444444,3.857143,-5.080002,5.080002,0,0,-5.080002,5.080002,11,118,22,34,-12,12,-2.41269850730896,2.41269850730896,2,0,0,0,2,-2,0,0,252,0,252,-252
Joe Duffy,Ivan Jorge,Joe Duffy,2015-07-18,1,0,-7,7,3.2,3.857143,2.540009,-2.540009,0,0,0,0,0,69,21,34,-13,13,-0.657142877578735,0.657142877578735,1,0,0,0,1,-1,0,0,126,518,-392,392
John Albert,Ivan Menjivar,Ivan Menjivar,2012-02-15,0,1,-4,4,1.2,2.083333,5.080002,-5.080002,-10,10,10.16,-10.16,13,129,11,37,-26,26,-0.883333206176758,0.883333206176758,1,0,0,0,1,-1,0,0,74,0,74,-74
Mike Easton,Ivan Menjivar,Mike Easton,2012-07-07,1,0,-2,2,2.166667,2.083333,0,0,-10,10,15.24001,-15.24001,48,0,19,37,-18,18,8.33334922790527e-02,-8.33334922790527e-02,1,1,0,0,0,0,0,0,169,143,26,-26
Azamat Gashimov,Ivan Menjivar,Ivan Menjivar,2012-11-17,0,1,-8,8,2.666667,2.083333,0,0,-20,20,7.440002,-7.440002,120,0,11,37,-26,26,0.583333492279053,-0.583333492279053,0,0,0,0,0,0,0,0,0,133,-133,133
Urijah Faber,Ivan Menjivar,Urijah Faber,2013-02-23,1,0,3,-3,3.181818,2.083333,0,0,-10,10,7.619995,-7.619995,242,4,46,37,9,-9,1.09848499298096,-1.09848499298096,1,1,0,0,0,0,0,0,707,98,609,-609
Hatsu Hioki,Ivan Menjivar,Hatsu Hioki,2014-03-01,1,0,-1,1,2.9,2.083333,12.7,-12.7,0,0,22.86,-22.86,338,98,39,37,2,-2,0.816666841506958,-0.816666841506958,0,0,0,0,0,0,0,0,617,371,246,-246
Matt Lindland,Ivan Salaverry,Matt Lindland,2002-09-27,1,0,1,-1,2.444444,1.555556,0,0,0,0,2.960007,-2.960007,478,36,31,23,8,-8,0.888888835906982,-0.888888835906982,1,0,0,0,1,-1,0,0,189,0,189,-189
Tony Fryklund,Ivan Salaverry,Ivan Salaverry,2004-10-22,0,1,0,0,1.555556,1.555556,0,0,0,0,1,-1,2,60,23,23,0,0,0,0,1,0,0,0,1,-1,0,0,853,756,97,-97
Joe Riggs,Ivan Salaverry,Ivan Salaverry,2005-04-16,0,1,-12,12,2.588235,1.555556,0,0,0,0,-7.199997,7.199997,81,0,61,23,38,-38,1.03267979621887,-1.03267979621887,0,1,0,0,-1,1,0,0,0,176,-176,176
Nate Marquardt,Ivan Salaverry,Nate Marquardt,2005-08-06,1,0,-8,8,1.842105,1.555556,0,0,0,0,2.960007,-2.960007,301,9,54,23,31,-31,0.286549687385559,-0.286549687385559,0,2,0,0,-2,2,0,0,0,112,-112,112
Terry Martin,Ivan Salaverry,Terry Martin,2007-05-26,1,0,-10,10,2.090909,1.555556,-10.16,10.16,0,0,-4.660004,4.660004,45,0,34,23,11,-11,0.535353422164917,-0.535353422164917,1,0,0,0,1,-1,0,0,112,658,-546,546
Rousimar Palhares,Ivan Salaverry,Rousimar Palhares,2008-05-24,1,0,-9,9,2.375,1.555556,-10.16,10.16,-15,15,-4.660004,4.660004,137,0,27,23,4,-4,0.819444417953491,-0.819444417953491,0,0,0,1,0,0,-1,1,0,364,-364,364
Tomasz Drwal,Ivan Serati,Tomasz Drwal,2009-01-17,1,0,,,4.2,3,2.539993,-2.539993,0,0,8.039993,-8.039993,38,0,26,16,10,-10,1.19999980926514,-1.19999980926514,0,0,1,0,0,0,1,-1,497,0,497,-497
Luana Carolina,Ivana Petrovic,Luana Carolina,2023-07-01,1,0,1,-1,2.25,6,-5.080002,5.080002,0,0,-2.540009,2.540009,345,251,13,7,6,-6,-3.75,3.75,0,0,1,0,0,0,1,-1,105,0,105,-105
Aleksandra Albu,Izabela Badurek,Aleksandra Albu,2015-04-11,1,0,1,-1,1.5,2,-7.62001,7.62001,0,0,-8.37999,8.37999,109,189,5,9,-4,4,-0.5,0.5,0,0,0,0,0,0,0,0,0,0,0,0
Chris Camozzi,Jacare Souza,Jacare Souza,2013-05-18,0,1,-7,7,1.846154,2.6,2.540009,-2.540009,0,0,7.619995,-7.619995,9,158,37,36,1,-1,-0.753846049308777,0.753846049308777,4,0,0,0,4,-4,0,0,63,0,63,-63
Yushin Okami,Jacare Souza,Jacare Souza,2013-09-04,0,1,-1,1,2.833333,2.6,2.540009,-2.540009,-15,15,7.619995,-7.619995,0,27,46,36,10,-10,0.233333349227905,-0.233333349227905,1,1,1,0,0,0,1,-1,389,109,280,-280
Francis Carmont,Jacare Souza,Jacare Souza,2014-02-15,0,1,-2,2,2.083333,2.6,5.080002,-5.080002,20,-20,15.23999,-15.23999,14,521,37,36,1,-1,-0.516666650772095,0.516666650772095,5,2,0,0,3,-3,0,0,147,164,-17,17
Gegard Mousasi,Jacare Souza,Jacare Souza,2014-09-05,0,1,-5,5,7,2.6,2.540009,-2.540009,0,0,10.15999,-10.15999,14,648,48,36,12,-12,4.40000009536743,-4.40000009536743,1,3,0,0,-2,2,0,0,97,202,-105,105
Chris Camozzi,Jacare Souza,Jacare Souza,2015-04-18,0,1,-7,7,1.846154,2.6,2.540009,-2.540009,0,0,7.619995,-7.619995,0,90,37,36,1,-1,-0.753846049308777,0.753846049308777,0,4,0,0,-4,4,0,0,225,225,0,0
Yoel Romero,Jacare Souza,Yoel Romero,2015-12-12,1,0,2,-2,2.6,2.6,-2.539993,2.539993,0,0,2.539993,-2.539993,118,153,18,36,-18,18,0,0,2,5,0,0,-3,3,0,0,602,238,364,-364
Vitor Belfort,Jacare Souza,Jacare Souza,2016-05-14,0,1,3,-3,1.857143,2.6,-2.539993,2.539993,0,0,5.080002,-5.080002,2,191,40,36,4,-4,-0.742857098579407,0.742857098579407,1,0,4,0,1,-1,4,-4,189,154,35,-35
Tim Boetsch,Jacare Souza,Jacare Souza,2017-02-11,0,1,-1,1,1.615385,2.6,-2.539993,2.539993,0,0,5.080002,-5.080002,0,74,34,36,-2,2,-0.984615325927734,0.984615325927734,2,1,4,0,1,-1,4,-4,91,273,-182,182
Derek Brunson,Jacare Souza,Jacare Souza,2018-01-27,0,1,-4,4,2.555556,2.6,0,0,0,0,12.7,-12.7,0,4,32,36,-4,4,-4.44443225860596e-02,4.44443225860596e-02,2,2,2,0,0,0,2,-2,91,350,-259,259
Kelvin Gastelum,Jacare Souza,Kelvin Gastelum,2018-05-12,1,0,-12,12,2.25,2.6,-10.16,10.16,-15,15,-2.540009,2.540009,35,208,26,36,-10,10,-0.349999904632568,0.349999904632568,0,3,0,0,-3,3,0,0,294,105,189,-189
Jack Hermansson,Jacare Souza,Jack Hermansson,2019-04-27,1,0,-9,9,2.875,2.6,0,0,0,0,12.7,-12.7,412,29,31,36,-5,5,0.275000095367432,-0.275000095367432,2,0,1,0,2,-2,1,-1,133,350,-217,217
Jan Blachowicz,Jacare Souza,Jan Blachowicz,2019-11-16,1,0,-3,3,2.9,2.6,2.540009,-2.540009,20,-20,15.23999,-15.23999,4,505,39,36,3,-3,0.300000190734863,-0.300000190734863,1,0,1,0,1,-1,1,-1,133,203,-70,70
Kevin Holland,Jacare Souza,Kevin Holland,2020-12-12,1,0,-13,13,2.5,2.6,5.080002,-5.080002,-15,15,22.86,-22.86,2,87,35,36,-1,1,-9.99999046325684e-02,9.99999046325684e-02,4,0,0,0,4,-4,0,0,42,392,-350,350
Andre Muniz,Jacare Souza,Andre Muniz,2021-05-15,1,0,-10,10,3.833333,2.6,0,0,0,0,15.23999,-15.23999,70,53,29,36,-7,7,1.23333334922791,-1.23333334922791,0,0,0,1,0,0,-1,1,0,154,-154,154
Randy Brown,Jack Della Maddalena,Jack Della Maddalena,2023-02-11,0,1,6,-6,3.4,8,10.16,-10.16,0,0,12.7,-12.7,0,15,22,18,4,-4,-4.59999990463257,4.59999990463257,4,0,2,0,4,-4,2,-2,133,0,133,-133
Scott Askham,Jack Hermansson,Jack Hermansson,2016-09-03,0,1,0,0,3.5,2.875,5.080002,-5.080002,0,0,-5.080002,5.080002,105,196,18,31,-13,13,0.625,-0.625,1,0,0,0,1,-1,0,0,189,0,189,-189
Cezar Ferreira,Jack Hermansson,Cezar Ferreira,2016-11-19,1,0,3,-3,1.625,2.875,0,0,0,0,2.539993,-2.539993,81,2,21,31,-10,10,-1.25,1.25,1,1,1,0,0,0,1,-1,134,77,57,-57
David Branch,Jack Hermansson,Jack Hermansson,2019-03-30,0,1,7,-7,3.666667,2.875,0,0,0,0,2.539993,-2.539993,4,10,28,31,-3,3,0.791666746139526,-0.791666746139526,0,0,3,0,0,0,3,-3,147,861,-714,714
Jared Cannonier,Jack Hermansson,Jared Cannonier,2019-09-28,1,0,4,-4,2.833333,2.875,-5.080002,5.080002,0,0,0,0,22,45,23,31,-8,8,-4.16667461395264e-02,4.16667461395264e-02,1,1,2,0,0,0,2,-2,140,182,-42,42
Kelvin Gastelum,Jack Hermansson,Jack Hermansson,2020-07-18,0,1,-4,4,2.25,2.875,-10.16,10.16,-15,15,-15.24001,15.24001,33,0,26,31,-5,5,-0.625,0.625,0,0,0,1,0,0,-1,1,259,294,-35,35
Chris Curtis,Jack Hermansson,Jack Hermansson,2022-07-23,0,1,1,-1,3,2.875,-7.619995,7.619995,0,0,-5.080002,5.080002,0,0,40,31,9,-9,0.125,-0.125,2,1,0,1,1,-1,-1,1,28,735,-707,707
Roman Dolidze,Jack Hermansson,Roman Dolidze,2022-12-03,1,0,0,0,6,2.875,2.540009,-2.540009,0,0,-2.540009,2.540009,30,112,14,31,-17,17,3.125,-3.125,2,2,0,1,0,0,-1,1,35,133,-98,98
Jamall Emmers,Jack Jenkins,Jack Jenkins,2023-06-24,0,1,4,-4,2.714286,4,7.62001,-7.62001,0,0,15.24001,-15.24001,257,15,26,15,11,-11,-1.28571438789368,1.28571438789368,0,0,0,0,0,0,0,0,665,0,665,-665
Magnus Cedenblad,Jack Marshman,Jack Marshman,2016-11-19,0,1,8,-8,2.8,2.3,12.7,-12.7,0,0,15.24001,-15.24001,270,13,19,33,-14,14,0.5,-0.5,3,0,0,0,3,-3,0,0,195,0,195,-195
Ryan Janes,Jack Marshman,Jack Marshman,2017-07-16,0,1,8,-8,3.333333,2.3,7.619995,-7.619995,0,0,7.619995,-7.619995,104,0,13,33,-20,20,1.03333330154419,-1.03333330154419,0,1,0,0,-1,1,0,0,147,239,-92,92
Antonio Carlos Junior,Jack Marshman,Antonio Carlos Junior,2017-10-28,1,0,0,0,2.2,2.3,5.080002,-5.080002,0,0,15.24001,-15.24001,189,0,16,33,-17,17,-9.99999046325684e-02,9.99999046325684e-02,3,2,1,0,1,-1,1,-1,147,104,43,-43
Derrick Lewis,Jack May,Derrick Lewis,2014-04-19,1,0,-4,4,2.454545,3,-12.7,12.7,5,-5,4.660004,-4.660004,107,111,38,12,26,-26,-0.545454502105713,0.545454502105713,0,0,0,0,0,0,0,0,0,0,0,0
Shawn Jordan,Jack May,Shawn Jordan,2014-08-16,1,0,-4,4,2.375,3,-20.31999,20.31999,5,-5,-5.5,5.5,317,0,27,12,15,-15,-0.625,0.625,0,0,1,1,0,0,0,0,168,119,49,-49
Tai Bowden,Jack Nilson,Tai Bowden,1996-12-07,1,0,,,1,0.3333333,,,,,10,-10,0,0,2,8,-6,6,0.666666656732559,-0.666666656732559,0,0,1,0,0,0,1,-1,204,0,204,-204
Saeed Hosseini,Jack Nilson,Jack Nilson,1997-05-30,0,1,,,0,0.3333333,,,,,10,-10,0,0,1,8,-7,7,-0.333333343267441,0.333333343267441,0,0,0,1,0,0,-1,1,0,174,-174,174
Nohelin Hernandez,Jack Shore,Jack Shore,2019-09-28,0,1,1,-1,2.25,17,5.080002,-5.080002,0,0,0,0,40,391,13,18,-5,5,-14.75,14.75,0,0,0,0,0,0,0,0,84,0,84,-84
Aaron Phillips,Jack Shore,Jack Shore,2020-07-15,0,1,5,-5,2.4,17,2.539993,-2.539993,0,0,0,0,5,325,17,18,-1,1,-14.5999999046326,14.5999999046326,0,1,0,0,-1,1,0,0,2244,291,1953,-1953
Hunter Azure,Jack Shore,Jack Shore,2021-04-10,0,1,3,-3,4.5,17,0,0,10,-10,-5.080002,5.080002,242,317,11,18,-7,7,-12.5,12.5,1,2,1,0,-1,1,1,-1,217,269,-52,52
Liudvik Sholinian,Jack Shore,Jack Shore,2021-09-04,0,1,5,-5,2.25,17,5.080002,-5.080002,0,0,0,0,86,268,13,18,-5,5,-14.75,14.75,0,3,0,0,-3,3,0,0,0,147,-147,147
Makwan Amirkhani,Jack Shore,Jack Shore,2023-03-18,0,1,6,-6,1.888889,17,5.080002,-5.080002,10,-10,2.540009,-2.540009,211,135,26,18,8,-8,-15.111111164093,15.111111164093,0,4,3,0,-4,4,3,-3,238,560,-322,322
Phil Hawes,Jacob Malkoun,Phil Hawes,2020-10-24,1,0,6,-6,2.4,2.333333,7.62001,-7.62001,0,0,10.16,-10.16,1,0,17,10,7,-7,6.6666841506958e-02,-6.6666841506958e-02,0,0,0,0,0,0,0,0,0,0,0,0
AJ Dobson,Jacob Malkoun,Jacob Malkoun,2022-02-12,0,1,4,-4,3.5,2.333333,10.16,-10.16,0,0,7.619995,-7.619995,27,557,9,10,-1,1,1.16666674613953,-1.16666674613953,0,0,0,1,0,0,-1,1,0,476,-476,476
Brendan Allen,Jacob Malkoun,Brendan Allen,2022-06-11,1,0,0,0,4.4,2.333333,12.70001,-12.70001,0,0,5.080002,-5.080002,204,429,27,10,17,-17,2.06666684150696,-2.06666684150696,1,1,2,1,0,0,1,-1,126,119,7,-7
Cody Brundage,Jacob Malkoun,Cody Brundage,2023-09-23,1,0,1,-1,1.8,2.333333,7.62001,-7.62001,0,0,-2.539993,2.539993,26,219,14,10,4,-4,-0.533333301544189,0.533333301544189,0,0,1,1,0,0,0,0,91,469,-378,378
Paulo Thiago,Jacob Volkmann,Paulo Thiago,2009-11-21,1,0,-1,1,2,2.714286,5.080002,-5.080002,15,-15,7.62001,-7.62001,360,367,27,26,1,-1,-0.714285612106323,0.714285612106323,0,0,0,0,0,0,0,0,0,0,0,0
Martin Kampmann,Jacob Volkmann,Martin Kampmann,2010-01-02,1,0,-2,2,2.857143,2.714286,7.62001,-7.62001,15,-15,2.540009,-2.540009,104,2,27,26,1,-1,0.142857313156128,-0.142857313156128,0,0,1,0,0,0,1,-1,483,42,441,-441
Ronys Torres,Jacob Volkmann,Jacob Volkmann,2010-03-31,0,1,5,-5,7,2.714286,-5.080002,5.080002,0,0,-7.339996,7.339996,187,601,40,26,14,-14,4.28571438789368,-4.28571438789368,0,0,0,0,0,0,0,0,0,88,-88,88
Paul Kelly,Jacob Volkmann,Jacob Volkmann,2010-08-01,0,1,-4,4,2.8,2.714286,0,0,0,0,-2.539993,2.539993,234,472,19,26,-7,7,8.57143402099609e-02,-8.57143402099609e-02,1,1,1,0,0,0,1,-1,113,123,-10,10
Antonio McKee,Jacob Volkmann,Jacob Volkmann,2011-01-01,0,1,10,-10,4.833333,2.714286,-2.539993,2.539993,0,0,-7.339996,7.339996,168,264,35,26,9,-9,2.11904788017273,-2.11904788017273,0,2,0,0,-2,2,0,0,0,153,-153,153
Danny Castillo,Jacob Volkmann,Jacob Volkmann,2011-08-14,0,1,1,-1,1.7,2.714286,0,0,0,0,0,0,186,467,27,26,1,-1,-1.01428556442261,1.01428556442261,1,3,0,0,-2,2,0,0,164,225,-61,61
Efrain Escudero,Jacob Volkmann,Jacob Volkmann,2011-12-30,0,1,-6,6,2.333333,2.714286,0,0,0,0,0,0,75,681,40,26,14,-14,-0.38095235824585,0.38095235824585,0,4,0,0,-4,4,0,0,471,138,333,-333
Paul Sass,Jacob Volkmann,Paul Sass,2012-05-26,1,0,-8,8,7,2.714286,7.62001,-7.62001,0,0,5.080002,-5.080002,1,91,16,26,-10,10,4.28571438789368,-4.28571438789368,0,5,0,0,-5,5,0,0,0,148,-148,148
Shane Roller,Jacob Volkmann,Jacob Volkmann,2012-10-05,0,1,1,-1,1.571429,2.714286,2.540009,-2.540009,0,0,2.540009,-2.540009,0,84,18,26,-8,8,-1.14285707473755,1.14285707473755,1,0,0,0,1,-1,0,0,582,132,450,-450
Bobby Green,Jacob Volkmann,Bobby Green,2013-02-02,1,0,-6,6,2.142857,2.714286,2.540009,-2.540009,0,0,0,0,273,337,44,26,18,-18,-0.571428537368774,0.571428537368774,0,1,0,0,-1,1,0,0,0,120,-120,120
Daniel Barez,Jafel Filho,Jafel Filho,2023-07-22,0,1,4,-4,2.666667,5,-2.539993,2.539993,0,0,-5.080002,5.080002,12,55,22,18,4,-4,-2.33333325386047,2.33333325386047,0,0,0,0,0,0,0,0,0,0,0,0
Shamil Abdurakhimov,Jailton Almeida,Jailton Almeida,2023-01-21,0,1,10,-10,2.5,9.5,0,0,30,-30,-7.62001,7.62001,0,448,28,21,7,-7,-7,7,0,0,5,0,0,0,5,-5,308,0,308,-308
Junior Albini,Jairzinho Rozenstruik,Jairzinho Rozenstruik,2019-02-02,0,1,-3,3,2.333333,2.6,2.539993,-2.539993,22,-22,-10.15999,10.15999,187,14,20,18,2,-2,-0.266666650772095,0.266666650772095,0,0,0,0,0,0,0,0,266,0,266,-266
Allen Crowder,Jairzinho Rozenstruik,Jairzinho Rozenstruik,2019-06-22,0,1,-2,2,2.5,2.6,2.539993,-2.539993,3,-3,-5.080002,5.080002,0,2,14,18,-4,4,-9.99999046325684e-02,9.99999046325684e-02,1,1,1,0,0,0,1,-1,154,140,14,-14
Andrei Arlovski,Jairzinho Rozenstruik,Jairzinho Rozenstruik,2019-11-02,0,1,9,-9,1.545455,2.6,2.539993,-2.539993,-2,2,-2.539993,2.539993,0,2,56,18,38,-38,-1.05454540252686,1.05454540252686,1,2,6,0,-1,1,6,-6,105,133,-28,28
Alistair Overeem,Jairzinho Rozenstruik,Jairzinho Rozenstruik,2019-12-07,0,1,8,-8,2.473684,2.6,5.079987,-5.079987,23,-23,5.080002,-5.080002,501,6,66,18,48,-48,-0.126315593719482,0.126315593719482,3,3,2,0,0,0,2,-2,378,35,343,-343
Francis Ngannou,Jairzinho Rozenstruik,Francis Ngannou,2020-05-09,1,0,1,-1,5.666667,2.6,5.079987,-5.079987,8,-8,12.70001,-12.70001,2,0,20,18,2,-2,3.06666660308838,-3.06666660308838,2,4,0,0,-2,2,0,0,447,154,293,-293
Junior Dos Santos,Jairzinho Rozenstruik,Jairzinho Rozenstruik,2020-08-15,0,1,4,-4,2.333333,2.6,5.079987,-5.079987,-4,4,-2.539993,2.539993,0,9,30,18,12,-12,-0.266666650772095,0.266666650772095,0,0,4,1,0,0,3,-3,413,98,315,-315
Ciryl Gane,Jairzinho Rozenstruik,Ciryl Gane,2021-02-27,1,0,-2,2,6,2.6,5.079987,-5.079987,3,-3,7.62001,-7.62001,269,0,14,18,-4,4,3.40000009536743,-3.40000009536743,2,1,0,1,1,-1,-1,1,490,196,294,-294
Curtis Blaydes,Jairzinho Rozenstruik,Curtis Blaydes,2021-09-25,1,0,-3,3,4.25,2.6,5.079987,-5.079987,23,-23,5.080002,-5.080002,379,0,21,18,3,-3,1.65000009536743,-1.65000009536743,0,0,3,1,0,0,2,-2,217,210,7,-7
Chris Daukaus,Jairzinho Rozenstruik,Jairzinho Rozenstruik,2022-12-10,0,1,-1,1,1.714286,2.6,2.539993,-2.539993,-37,37,-5.080002,5.080002,0,6,19,18,1,-1,-0.885714173316956,0.885714173316956,0,0,1,1,0,0,0,0,357,441,-84,84
Jailton Almeida,Jairzinho Rozenstruik,Jailton Almeida,2023-05-13,1,0,-4,4,9.5,2.6,2.539993,-2.539993,-37,37,2.540009,-2.540009,189,0,21,18,3,-3,6.90000009536743,-6.90000009536743,3,1,0,1,2,-2,-1,1,245,154,91,-91
Ricardo Abreu,Jake Collier,Jake Collier,2015-06-06,0,1,5,-5,5,1.3,-10.16,10.16,-45,45,-18.12,18.12,186,14,6,23,-17,17,3.70000004768372,-3.70000004768372,1,0,0,0,1,-1,0,0,371,0,371,-371
Devin Clark,Jake Collier,Devin Clark,2017-04-15,1,0,-1,1,1.75,1.3,-7.619995,7.619995,-25,25,-7.619995,7.619995,465,132,22,23,-1,1,0.450000047683716,-0.450000047683716,1,1,1,0,0,0,1,-1,133,679,-546,546
Tom Aspinall,Jake Collier,Tom Aspinall,2020-07-25,1,0,-4,4,4.333333,1.3,5.080002,-5.080002,26,-26,0,0,2,0,16,23,-7,7,3.03333353996277,-3.03333353996277,0,0,0,0,0,0,0,0,0,1197,-1197,1197
Andrei Arlovski,Jake Collier,Andrei Arlovski,2022-04-30,1,0,10,-10,1.545455,1.3,0,0,10,-10,-2.539993,2.539993,1,218,56,23,33,-33,0.245454549789429,-0.245454549789429,3,0,7,1,3,-3,6,-6,77,644,-567,567
Chris Barnett,Jake Collier,Chris Barnett,2022-09-10,1,0,3,-3,2.875,1.3,-15.24001,15.24001,35,-35,-7.619995,7.619995,67,86,31,23,8,-8,1.57500004768372,-1.57500004768372,0,0,0,1,0,0,-1,1,147,133,14,-14
Martin Buday,Jake Collier,Martin Buday,2023-04-29,1,0,-3,3,13,1.3,2.539993,-2.539993,35,-35,-2.539993,2.539993,105,271,14,23,-9,9,11.7000000476837,-11.7000000476837,0,0,0,2,0,0,-2,2,0,231,-231,231
Carlos Condit,Jake Ellenberger,Carlos Condit,2009-09-16,1,0,1,-1,2.285714,2.066667,12.70001,-12.70001,0,0,10.16,-10.16,238,406,46,46,0,0,0.219047784805298,-0.219047784805298,0,0,0,0,0,0,0,0,168,0,168,-168
Carlos Eduardo Rocha,Jake Ellenberger,Jake Ellenberger,2011-02-05,0,1,4,-4,2.25,2.066667,2.540009,-2.540009,0,0,5.080002,-5.080002,214,105,13,46,-33,33,0.183333396911621,-0.183333396911621,1,0,0,0,1,-1,0,0,84,507,-423,423
Matt Brown,Jake Ellenberger,Jake Ellenberger,2016-07-30,0,1,4,-4,1.368421,2.066667,7.62001,-7.62001,0,0,10.16,-10.16,0,41,45,46,-1,1,-0.698245525360107,0.698245525360107,0,1,0,0,-1,1,0,0,77,2002,-1925,1925
Bryan Barberena,Jake Ellenberger,Bryan Barberena,2018-08-25,1,0,-4,4,1.636364,2.066667,7.62001,-7.62001,0,0,2.540009,-2.540009,0,21,29,46,-17,17,-0.430302977561951,0.430302977561951,0,2,0,0,-2,2,0,0,357,756,-399,399
Carlos Candelario,Jake Hadley,Jake Hadley,2022-11-05,0,1,5,-5,2.666667,5,2.540009,-2.540009,0,0,-5.080002,5.080002,99,0,11,12,-1,1,-2.33333325386047,2.33333325386047,0,0,0,0,0,0,0,0,175,0,175,-175
Malcolm Gordon,Jake Hadley,Jake Hadley,2023-03-18,0,1,6,-6,2,5,0,0,0,0,2.539993,-2.539993,0,4,21,12,9,-9,-3,3,0,1,0,0,-1,1,0,0,147,133,14,-14
Cody Durden,Jake Hadley,Cody Durden,2023-08-05,1,0,5,-5,4,5,0,0,0,0,-7.62001,7.62001,445,124,20,12,8,-8,-1,1,2,2,0,0,0,0,0,0,98,140,-42,42
Rich Attonito,Jake Hecht,Jake Hecht,2011-12-10,0,1,7,-7,2,2.75,-5.080002,5.080002,0,0,-2.539993,2.539993,244,13,15,15,0,0,-0.75,0.75,1,0,0,0,1,-1,0,0,167,0,167,-167
Olivier Aubin-Mercier,Jake Lindsey,Olivier Aubin-Mercier,2014-10-04,1,0,-3,3,2.2,1.714286,-5.080002,5.080002,0,0,-5.199997,5.199997,185,40,16,19,-3,3,0.485714316368103,-0.485714316368103,0,0,0,0,0,0,0,0,171,0,171,-171
Joe Duffy,Jake Lindsey,Joe Duffy,2015-03-14,1,0,-1,1,3.2,1.714286,-2.539993,2.539993,0,0,2.419998,-2.419998,1,0,21,19,2,-2,1.4857143163681,-1.4857143163681,0,0,0,0,0,0,0,0,0,161,-161,161
Dashon Johnson,Jake Matthews,Jake Matthews,2014-06-28,0,1,7,-7,4.5,3.166667,-10.16,10.16,-25,25,-12.42,12.42,19,627,11,25,-14,14,1.33333325386047,-1.33333325386047,0,0,0,0,0,0,0,0,0,0,0,0
Akbarh Arreola,Jake Matthews,Jake Matthews,2015-11-14,0,1,11,-11,2.090909,3.166667,-2.539993,2.539993,-15,15,-5.080002,5.080002,119,339,34,25,9,-9,-1.0757577419281,1.0757577419281,0,1,0,0,-1,1,0,0,238,504,-266,266
Johnny Case,Jake Matthews,Jake Matthews,2016-03-19,0,1,5,-5,3.666667,3.166667,-2.539993,2.539993,-15,15,-2.539993,2.539993,196,74,28,25,3,-3,0.5,-0.5,3,2,0,0,1,-1,0,0,280,126,154,-154
Kevin Lee,Jake Matthews,Kevin Lee,2016-07-08,1,0,2,-2,2.25,3.166667,-5.080002,5.080002,0,0,10.16,-10.16,155,0,26,25,1,-1,-0.916666746139526,0.916666746139526,0,3,1,0,-3,3,1,-1,209,111,98,-98
Andrew Holbrook,Jake Matthews,Andrew Holbrook,2016-11-26,1,0,8,-8,4,3.166667,0,0,-15,15,-7.619995,7.619995,173,319,15,25,-10,10,0.833333253860474,-0.833333253860474,0,0,1,1,0,0,0,0,141,141,0,0
Li Jingliang,Jake Matthews,Jake Matthews,2018-02-10,0,1,6,-6,2.375,3.166667,2.540009,-2.540009,0,0,-5.080002,5.080002,71,206,27,25,2,-2,-0.791666746139526,0.791666746139526,3,0,0,1,3,-3,-1,1,77,441,-364,364
Shinsho Anzai,Jake Matthews,Jake Matthews,2018-06-23,0,1,9,-9,3.333333,3.166667,-10.16,10.16,0,0,-7.619995,7.619995,56,60,13,25,-12,12,0.166666507720947,-0.166666507720947,2,1,1,1,1,-1,0,0,274,133,141,-141
Rostem Akman,Jake Matthews,Jake Matthews,2019-10-05,0,1,2,-2,3,3.166667,-2.539993,2.539993,0,0,-2.539993,2.539993,3,49,8,25,-17,17,-0.166666746139526,0.166666746139526,0,2,0,1,-2,2,-1,1,126,469,-343,343
Sean Brady,Jake Matthews,Sean Brady,2021-03-06,1,0,2,-2,15,3.166667,-2.539993,2.539993,0,0,-2.539993,2.539993,488,4,16,25,-9,9,11.8333332538605,-11.8333332538605,2,3,0,1,-1,1,-1,1,371,518,-147,147
Andre Fialho,Jake Matthews,Jake Matthews,2022-06-11,0,1,1,-1,2,3.166667,2.540009,-2.540009,0,0,2.540009,-2.540009,0,0,24,25,-1,1,-1.16666674613953,1.16666674613953,1,0,0,1,1,-1,-1,1,35,462,-427,427
Darrius Flowers,Jake Matthews,Jake Matthews,2023-07-29,0,1,0,0,2,3.166667,-5.080002,5.080002,0,0,-5.080002,5.080002,63,75,18,25,-7,7,-1.16666674613953,1.16666674613953,0,1,0,1,-1,1,-1,1,0,413,-413,413
Kristof Midoux,"Jake O'Brien","Jake O'Brien",2006-08-17,0,1,11,-11,0.6,3.75,-5.080002,5.080002,15,-15,-5.039993,5.039993,0,284,16,19,-3,3,-3.14999997615814,3.14999997615814,0,0,0,0,0,0,0,0,0,0,0,0
Heath Herring,"Jake O'Brien","Jake O'Brien",2007-01-25,0,1,6,-6,1.75,3.75,2.539993,-2.539993,45,-45,5.080002,-5.080002,41,598,44,19,25,-25,-2,2,0,1,0,0,-1,1,0,0,0,161,-161,161
Andrei Arlovski,"Jake O'Brien",Andrei Arlovski,2008-03-01,1,0,6,-6,1.545455,3.75,0,0,35,-35,2.540009,-2.540009,119,284,56,19,37,-37,-2.20454549789429,2.20454549789429,2,2,3,0,0,0,3,-3,315,401,-86,86
Jon Jones,"Jake O'Brien",Jon Jones,2009-07-11,1,0,-3,3,27,3.75,2.539993,-2.539993,43,-43,20.32001,-20.32001,34,3,28,19,9,-9,23.25,-23.25,0,0,0,1,0,0,-1,1,0,497,-497,497
Dan Miller,Jake Rosholt,Dan Miller,2009-02-07,1,0,1,-1,1.75,2.4,0,0,0,0,-3.999329e-02,3.999329e-02,22,26,22,17,5,-5,-0.650000095367432,0.650000095367432,0,0,0,0,0,0,0,0,0,0,0,0
Chris Leben,Jake Rosholt,Jake Rosholt,2009-08-29,0,1,2,-2,2,2.4,-5.080002,5.080002,0,0,-2.580002,2.580002,209,144,33,17,16,-16,-0.400000095367432,0.400000095367432,2,0,1,0,2,-2,1,-1,546,203,343,-343
Kendall Grove,Jake Rosholt,Kendall Grove,2009-11-21,1,0,0,0,1.352941,2.4,12.7,-12.7,0,0,12.66,-12.66,61,125,40,17,23,-23,-1.04705893993378,1.04705893993378,1,1,1,0,0,0,1,-1,518,84,434,-434
Martin Kampmann,Jake Shields,Jake Shields,2010-10-23,0,1,-3,3,2.857143,3.444444,0,0,0,0,0,0,195,448,27,40,-13,13,-0.58730149269104,0.58730149269104,2,0,1,0,2,-2,1,-1,133,0,133,-133
Jake Ellenberger,Jake Shields,Jake Ellenberger,2011-09-17,1,0,-6,6,2.066667,3.444444,-7.62001,7.62001,0,0,-2.540009,2.540009,4,7,46,40,6,-6,-1.37777781486511,1.37777781486511,3,1,0,0,2,-2,0,0,140,329,-189,189
Yoshihiro Akiyama,Jake Shields,Jake Shields,2012-02-25,0,1,3,-3,2.333333,3.444444,-5.080002,5.080002,0,0,7.619995,-7.619995,68,223,20,40,-20,20,-1.11111116409302,1.11111116409302,0,0,1,1,0,0,0,0,203,161,42,-42
Demian Maia,Jake Shields,Jake Shields,2013-10-09,0,1,1,-1,2.545455,3.444444,2.539993,-2.539993,0,0,0,0,319,703,39,40,-1,1,-0.898989915847778,0.898989915847778,1,1,1,1,0,0,0,0,361,592,-231,231
Hector Lombard,Jake Shields,Hector Lombard,2014-03-15,1,0,1,-1,3.4,3.444444,-7.62001,7.62001,15,-15,-2.540009,2.540009,448,0,44,40,4,-4,-4.44443225860596e-02,4.44443225860596e-02,1,2,0,1,-1,1,-1,1,147,157,-10,10
Vicente Luque,Jalin Turner,Vicente Luque,2018-10-06,1,0,3,-3,2.444444,1.857143,-10.16,10.16,15,-15,-5.080002,5.080002,4,0,31,20,11,-11,0.58730161190033,-0.58730161190033,3,0,0,0,3,-3,0,0,343,0,343,-343
Callan Potter,Jalin Turner,Jalin Turner,2019-02-09,0,1,11,-11,2,1.857143,-7.619995,7.619995,15,-15,-12.7,12.7,0,13,27,20,7,-7,0.142857193946838,-0.142857193946838,0,0,0,1,0,0,-1,1,0,126,-126,126
Matt Frevola,Jalin Turner,Matt Frevola,2019-04-13,1,0,5,-5,3.666667,1.857143,-15.24001,15.24001,0,0,-15.24001,15.24001,307,66,14,20,-6,6,1.80952394008636,-1.80952394008636,0,1,1,1,-1,1,0,0,454,63,391,-391
Josh Culibao,Jalin Turner,Jalin Turner,2020-02-22,0,1,1,-1,5.5,1.857143,-12.7,12.7,-10,10,-10.16,10.16,10,261,13,20,-7,7,3.64285719394684,-3.64285719394684,0,0,0,1,0,0,-1,1,0,315,-315,315
Uros Medic,Jalin Turner,Jalin Turner,2021-09-25,0,1,2,-2,9,1.857143,-5.080002,5.080002,15,-15,-15.24001,15.24001,0,144,10,20,-10,10,7.14285719394684,-7.14285719394684,0,1,0,1,-1,1,-1,1,0,581,-581,581
Jamie Mullarkey,Jalin Turner,Jalin Turner,2022-03-05,0,1,1,-1,2.833333,1.857143,-7.619995,7.619995,0,0,-7.619995,7.619995,91,2,23,20,3,-3,0.976190447807312,-0.976190447807312,2,2,0,1,0,0,-1,1,154,161,-7,7
Brad Riddell,Jalin Turner,Jalin Turner,2022-07-02,0,1,3,-3,2.5,1.857143,-20.32001,20.32001,0,0,-15.24001,15.24001,0,13,14,20,-6,6,0.642857193946838,-0.642857193946838,0,3,0,1,-3,3,-1,1,0,119,-119,119
Mateusz Gamrot,Jalin Turner,Mateusz Gamrot,2023-03-04,1,0,5,-5,11.5,1.857143,-12.7,12.7,0,0,-17.78,17.78,412,32,25,20,5,-5,9.64285719394684,-9.64285719394684,3,4,0,1,-1,1,-1,1,252,245,7,-7
Dan Hooker,Jalin Turner,Dan Hooker,2023-07-08,1,0,5,-5,1.916667,1.857143,-7.619995,7.619995,0,0,-5.080002,5.080002,189,18,35,20,15,-15,5.95238208770752e-02,-5.95238208770752e-02,1,0,0,1,1,-1,-1,1,238,126,112,-112
Paul Craig,Jamahal Hill,Paul Craig,2021-06-12,1,0,3,-3,2.833333,12,-2.539993,2.539993,-20,20,-7.62001,7.62001,3,53,23,13,10,-10,-9.16666674613953,9.16666674613953,2,0,3,0,2,-2,3,-3,203,0,203,-203
Jimmy Crute,Jamahal Hill,Jamahal Hill,2021-12-04,0,1,-5,5,3,12,-5.079987,5.079987,0,0,-12.7,12.7,0,1,16,13,3,-3,-9,9,0,0,1,1,0,0,0,0,224,175,49,-49
Josh Parisian,Jamal Pogues,Jamal Pogues,2023-02-18,0,1,6,-6,2.142857,2.5,2.539993,-2.539993,60,-60,5.080002,-5.080002,72,349,22,14,8,-8,-0.357142925262451,0.357142925262451,0,0,0,0,0,0,0,0,812,0,812,-812
Mick Parkin,Jamal Pogues,Mick Parkin,2023-07-22,1,0,0,0,7,2.5,2.539993,-2.539993,60,-60,5.080002,-5.080002,0,77,7,14,-7,7,4.5,-4.5,0,1,0,0,-1,1,0,0,0,154,-154,154
Giga Chikadze,Jamall Emmers,Giga Chikadze,2020-03-07,1,0,1,-1,5,2.714286,5.080002,-5.080002,0,0,0,0,20,123,18,26,-8,8,2.28571438789368,-2.28571438789368,1,0,0,0,1,-1,0,0,161,0,161,-161
Vince Cachero,Jamall Emmers,Jamall Emmers,2020-08-01,0,1,-1,1,1.75,2.714286,-10.16,10.16,0,0,-15.24001,15.24001,28,347,11,26,-15,15,-0.964285612106323,0.964285612106323,0,0,0,0,0,0,0,0,0,147,-147,147
Khusein Askhabov,Jamall Emmers,Jamall Emmers,2023-02-18,0,1,-5,5,23,2.714286,-5.080002,5.080002,0,0,-12.70001,12.70001,58,285,24,26,-2,2,20.2857143878937,-20.2857143878937,0,1,0,0,-1,1,0,0,0,931,-931,931
Brad Blackburn,James Giboo,Brad Blackburn,2008-07-19,1,0,1,-1,1.384615,2.6,-2.539993,2.539993,0,0,2.419998,-2.419998,219,28,31,18,13,-13,-1.2153844833374,1.2153844833374,0,0,0,0,0,0,0,0,0,0,0,0
Chris Camozzi,James Hammortree,Chris Camozzi,2010-06-19,1,0,-3,3,1.846154,2,-2.539993,2.539993,0,0,-2.5,2.5,224,143,37,9,28,-28,-0.153846144676208,0.153846144676208,0,0,0,0,0,0,0,0,0,0,0,0
Papy Abedi,James Head,James Head,2012-04-14,0,1,5,-5,2.5,2.25,-5.080002,5.080002,15,-15,3.779999,-3.779999,115,43,14,13,1,-1,0.25,-0.25,0,0,0,0,0,0,0,0,161,0,161,-161
Brian Ebersole,James Head,James Head,2012-07-21,0,1,3,-3,2.833333,2.25,-2.539993,2.539993,0,0,0,0,174,196,69,13,56,-56,0.583333253860474,-0.583333253860474,4,1,0,0,3,-3,0,0,29,98,-69,69
Stephan Bonnar,James Irvin,Stephan Bonnar,2006-01-16,1,0,1,-1,1.666667,1.7,5.079987,-5.079987,0,0,10.16,-10.16,243,0,24,27,-3,3,-3.3333420753479e-02,3.3333420753479e-02,1,0,0,0,1,-1,0,0,163,0,163,-163
Luiz Cane,James Irvin,James Irvin,2007-12-29,0,1,-3,3,2.428571,1.7,0,0,-20,20,5.080002,-5.080002,12,1,24,27,-3,3,0.72857141494751,-0.72857141494751,0,0,0,0,0,0,0,0,0,712,-712,712
Houston Alexander,James Irvin,James Irvin,2008-04-02,0,1,7,-7,1.133333,1.7,-5.080002,5.080002,0,0,-7.619995,7.619995,0,2,32,27,5,-5,-0.566666722297668,0.566666722297668,0,1,1,0,-1,1,1,-1,137,95,42,-42
Bobby Green,James Krause,Bobby Green,2013-11-06,1,0,0,0,2.142857,3.111111,-10.16,10.16,-15,15,-5.080002,5.080002,0,0,44,37,7,-7,-0.968254089355469,0.968254089355469,1,0,0,0,1,-1,0,0,277,0,277,-277
Daron Cruickshank,James Krause,James Krause,2015-07-25,0,1,1,-1,1.8,3.111111,-15.24001,15.24001,-15,15,-2.539993,2.539993,3,10,28,37,-9,9,-1.31111121177673,1.31111121177673,0,0,0,1,0,0,-1,1,133,626,-493,493
Shane Campbell,James Krause,James Krause,2016-02-21,0,1,0,0,2.333333,3.111111,-5.080002,5.080002,-15,15,-5.080002,5.080002,204,342,20,37,-17,17,-0.777777910232544,0.777777910232544,1,1,1,1,0,0,0,0,182,211,-29,29
Tom Gallicchio,James Krause,James Krause,2017-07-07,0,1,-1,1,1.9,3.111111,-10.16,10.16,0,0,-5.419998,5.419998,60,9,29,37,-8,8,-1.21111118793488,1.21111118793488,0,2,0,1,-2,2,-1,1,0,502,-502,502
Warlley Alves,James Krause,James Krause,2018-08-25,0,1,-5,5,2.5,3.111111,-7.62001,7.62001,0,0,-2.539993,2.539993,63,125,21,37,-16,16,-0.611111164093018,0.611111164093018,1,3,0,1,-2,2,-1,1,308,414,-106,106
Trevin Giles,James Krause,Trevin Giles,2020-02-08,1,0,-6,6,3.2,3.111111,-5.080002,5.080002,0,0,2.540009,-2.540009,219,232,21,37,-16,16,8.88888835906982e-02,-8.88888835906982e-02,0,4,0,1,-4,4,-1,1,189,532,-343,343
Travis Browne,James McSweeney,Travis Browne,2010-06-19,1,0,-2,2,2.571429,1,5.080002,-5.080002,25,-25,5.080002,-5.080002,141,0,25,30,-5,5,1.57142853736877,-1.57142853736877,0,0,0,0,0,0,0,0,0,0,0,0
Fabio Maldonado,James McSweeney,Fabio Maldonado,2010-10-16,1,0,1,-1,2.090909,1,-7.619995,7.619995,-25,25,-5.080002,5.080002,204,71,34,30,4,-4,1.09090900421143,-1.09090900421143,0,0,0,1,0,0,-1,1,0,119,-119,119
Joe Ellenberger,James Moontasri,Joe Ellenberger,2014-06-28,1,0,3,-3,7.5,1.8,-2.540009,2.540009,-15,15,2.540009,-2.540009,389,303,17,14,3,-3,5.70000004768372,-5.70000004768372,0,0,0,0,0,0,0,0,0,0,0,0
Kevin Lee,James Moontasri,Kevin Lee,2015-07-15,1,0,-5,5,2.25,1.8,-2.540009,2.540009,0,0,15.24001,-15.24001,68,6,26,14,12,-12,0.450000047683716,-0.450000047683716,3,0,0,0,3,-3,0,0,151,382,-231,231
Igor Pokrajac,James Te Huna,James Te Huna,2010-02-20,0,1,3,-3,2.153846,1.777778,-5.080002,5.080002,20,-20,-2.539993,2.539993,119,550,41,25,16,-16,0.376068472862244,-0.376068472862244,0,0,0,0,0,0,0,0,0,0,0,0
Alexander Gustafsson,James Te Huna,Alexander Gustafsson,2011-02-26,1,0,-5,5,2.25,1.777778,7.619995,-7.619995,20,-20,10.16,-10.16,57,175,26,25,1,-1,0.472222208976746,-0.472222208976746,1,1,0,0,0,0,0,0,469,371,98,-98
Ricardo Romero,James Te Huna,James Te Huna,2011-09-24,0,1,4,-4,3.666667,1.777778,-5.080002,5.080002,20,-20,2.539993,-2.539993,0,10,14,25,-11,11,1.88888895511627,-1.88888895511627,0,0,0,0,0,0,0,0,0,210,-210,210
Aaron Rosa,James Te Huna,James Te Huna,2012-03-02,0,1,-2,2,3,1.777778,5.079987,-5.079987,20,-20,5.080002,-5.080002,0,66,24,25,-1,1,1.22222220897675,-1.22222220897675,0,1,0,0,-1,1,0,0,0,160,-160,160
Joey Beltran,James Te Huna,James Te Huna,2012-07-11,0,1,0,0,1.214286,1.777778,-2.540009,2.540009,0,0,0,0,111,170,31,25,6,-6,-0.563492059707642,0.563492059707642,0,2,1,0,-2,2,1,-1,165,131,34,-34
Ryan Jimmo,James Te Huna,James Te Huna,2013-02-16,0,1,0,0,3.8,1.777778,-2.540009,2.540009,20,-20,-5.080002,5.080002,381,398,24,25,-1,1,2.02222216129303,-2.02222216129303,1,3,0,0,-2,2,0,0,210,220,-10,10
Mauricio Rua,James Te Huna,Mauricio Rua,2013-12-06,1,0,0,0,1.928571,1.777778,-2.540009,2.540009,20,-20,2.539993,-2.539993,3,0,41,25,16,-16,0.150793671607971,-0.150793671607971,0,4,0,0,-4,4,0,0,111,293,-182,182
Nate Marquardt,James Te Huna,Nate Marquardt,2014-06-28,1,0,3,-3,1.842105,1.777778,-5.080002,5.080002,0,0,-2.539993,2.539993,194,39,54,25,29,-29,6.43274784088135e-02,-6.43274784088135e-02,1,0,1,1,1,-1,0,0,1197,204,993,-993
Steve Bosse,James Te Huna,Steve Bosse,2016-03-19,1,0,0,0,6,1.777778,-7.62001,7.62001,20,-20,-7.619995,7.619995,1,0,14,25,-11,11,4.22222220897675,-4.22222220897675,0,0,1,1,0,0,0,0,266,630,-364,364
Randy Couture,James Toney,Randy Couture,2010-08-28,1,0,5,-5,1.727273,0,10.16,-10.16,-15,15,2.5,-2.5,182,0,30,1,29,-29,1.72727274894714,-1.72727274894714,1,0,4,0,1,-1,4,-4,287,0,287,-287
Ramsey Nijem,James Vick,James Vick,2013-08-17,0,1,-1,1,1.5,2.6,-10.16,10.16,0,0,-2.539993,2.539993,22,17,15,18,-3,3,-1.09999990463257,1.09999990463257,1,0,0,0,1,-1,0,0,252,0,252,-252
Valmir Lazaro,James Vick,James Vick,2014-08-23,0,1,2,-2,3,2.6,-7.619995,7.619995,0,0,-7.619995,7.619995,58,23,20,18,2,-2,0.400000095367432,-0.400000095367432,0,1,0,0,-1,1,0,0,0,371,-371,371
Nick Hein,James Vick,James Vick,2014-11-22,0,1,3,-3,2.8,2.6,-22.86,22.86,0,0,-25.39999,25.39999,60,15,19,18,1,-1,0.200000047683716,-0.200000047683716,0,2,0,0,-2,2,0,0,0,91,-91,91
Jake Matthews,James Vick,James Vick,2015-05-09,0,1,-8,8,3.166667,2.6,-10.16,10.16,15,-15,-7.619995,7.619995,90,7,25,18,7,-7,0.566666841506958,-0.566666841506958,1,3,0,0,-2,2,0,0,183,168,15,-15
Glaico Franca Moreira,James Vick,James Vick,2016-04-23,0,1,-4,4,3,2.6,-7.619995,7.619995,0,0,2.540009,-2.540009,329,37,20,18,2,-2,0.400000095367432,-0.400000095367432,0,4,0,0,-4,4,0,0,0,350,-350,350
Beneil Dariush,James Vick,Beneil Dariush,2016-06-04,1,0,-2,2,4.4,2.6,-12.7,12.7,0,0,-10.15999,10.15999,80,28,27,18,9,-9,1.80000019073486,-1.80000019073486,4,5,1,0,-1,1,1,-1,301,42,259,-259
Abel Trujillo,James Vick,James Vick,2017-02-04,0,1,4,-4,1.875,2.6,-17.78,17.78,0,0,-15.23999,15.23999,135,141,23,18,5,-5,-0.724999904632568,0.724999904632568,1,0,0,1,1,-1,-1,1,1099,245,854,-854
Marco Polo Reyes,James Vick,James Vick,2017-05-13,0,1,2,-2,1.142857,2.6,-10.16,10.16,0,0,-12.7,12.7,0,4,15,18,-3,3,-1.45714271068573,1.45714271068573,0,1,0,1,-1,1,-1,1,0,98,-98,98
Joe Duffy,James Vick,James Vick,2017-11-04,0,1,-1,1,3.2,2.6,-12.7,12.7,0,0,-7.619995,7.619995,30,4,21,18,3,-3,0.600000143051147,-0.600000143051147,1,2,0,1,-1,1,-1,1,231,175,56,-56
Francisco Trinaldo,James Vick,James Vick,2018-02-18,0,1,9,-9,3.111111,2.6,-15.24001,15.24001,15,-15,-15.23999,15.23999,96,27,37,18,19,-19,0.511111259460449,-0.511111259460449,0,3,0,1,-3,3,-1,1,0,106,-106,106
Justin Gaethje,James Vick,Justin Gaethje,2018-08-25,1,0,-2,2,6.25,2.6,-10.16,10.16,0,0,-15.23999,15.23999,4,0,29,18,11,-11,3.65000009536743,-3.65000009536743,0,4,1,1,-4,4,0,0,133,188,-55,55
Paul Felder,James Vick,Paul Felder,2019-02-17,1,0,3,-3,2.833333,2.6,-10.16,10.16,0,0,-15.23999,15.23999,73,134,23,18,5,-5,0.233333349227905,-0.233333349227905,0,0,1,2,0,0,-1,1,225,176,49,-49
Dan Hooker,James Vick,Dan Hooker,2019-07-20,1,0,-3,3,1.916667,2.6,-7.619995,7.619995,0,0,-2.539993,2.539993,3,0,35,18,17,-17,-0.683333277702332,0.683333277702332,2,0,0,2,2,-2,-2,2,455,153,302,-302
Niko Price,James Vick,Niko Price,2019-10-12,1,0,-2,2,2.142857,2.6,-7.619995,7.619995,15,-15,0,0,47,13,22,18,4,-4,-0.45714282989502,0.45714282989502,0,0,1,3,0,0,-2,2,399,84,315,-315
DaMarques Johnson,James Wilks,James Wilks,2009-06-20,0,1,-5,5,1,1.75,0,0,0,0,0,0,76,136,30,11,19,-19,-0.75,0.75,0,0,0,0,0,0,0,0,0,0,0,0
Matt Brown,James Wilks,Matt Brown,2009-11-14,1,0,-3,3,1.368421,1.75,-2.539993,2.539993,0,0,0,0,165,371,45,11,34,-34,-0.381578922271729,0.381578922271729,2,1,0,0,1,-1,0,0,252,147,105,-105
Peter Sobotta,James Wilks,James Wilks,2010-06-12,0,1,-9,9,2.428571,1.75,-2.539993,2.539993,0,0,0,0,487,198,24,11,13,-13,0.678571462631226,-0.678571462631226,0,0,0,1,0,0,-1,1,364,210,154,-154
Claude Patrick,James Wilks,Claude Patrick,2010-10-16,1,0,-2,2,7,1.75,-5.080002,5.080002,0,0,0,0,749,46,16,11,5,-5,5.25,-5.25,0,1,0,1,-1,1,-1,1,0,126,-126,126
Phillip Miller,James Zikic,Phillip Miller,2002-07-13,1,0,-2,2,16,2.1,-7.62001,7.62001,-20,20,-8,8,583,166,16,31,-15,15,13.9000000953674,-13.9000000953674,0,0,0,0,0,0,0,0,0,0,0,0
Giga Chikadze,Jamey Simmons,Giga Chikadze,2020-11-07,1,0,4,-4,5,1.75,15.24001,-15.24001,10,-10,10.16,-10.16,9,44,18,11,7,-7,3.25,-3.25,4,0,0,0,4,-4,0,0,28,0,28,-28
Johnny Munoz,Jamey Simmons,Johnny Munoz,2021-08-07,1,0,0,0,4,1.75,7.619995,-7.619995,0,0,2.539993,-2.539993,124,0,15,11,4,-4,2.25,-2.25,0,0,0,1,0,0,-1,1,0,273,-273,273
Hailey Cowan,Jamey-Lyn Horth,Jamey-Lyn Horth,2023-04-29,0,1,-2,2,2.333333,6,2.540009,-2.540009,0,0,2.539993,-2.539993,290,67,10,6,4,-4,-3.66666674613953,3.66666674613953,0,0,0,0,0,0,0,0,0,0,0,0
Kailin Curran,Jamie Moyle,Jamie Moyle,2016-12-03,0,1,-2,2,0.8,1.333333,7.619995,-7.619995,0,0,0,0,439,86,9,7,2,-2,-0.533333361148834,0.533333361148834,0,0,1,0,0,0,1,-1,133,0,133,-133
Michael Johnson,Jamie Mullarkey,Jamie Mullarkey,2022-07-09,0,1,9,-9,1.157895,2.833333,-5.080002,5.080002,0,0,-2.540009,2.540009,37,17,41,23,18,-18,-1.67543852329254,1.67543852329254,1,0,0,0,1,-1,0,0,56,0,56,-56
John Makdessi,Jamie Mullarkey,Jamie Mullarkey,2023-09-09,0,1,9,-9,2,2.833333,-10.16,10.16,0,0,-15.24001,15.24001,0,0,27,23,4,-4,-0.833333253860474,0.833333253860474,0,1,1,0,-1,1,1,-1,1274,427,847,-847
Tafon Nchukwi,Jamie Pickett,Tafon Nchukwi,2020-12-19,1,0,-6,6,1.5,1.3,-5.080002,5.080002,0,0,-7.619995,7.619995,171,34,10,23,-13,13,0.200000047683716,-0.200000047683716,0,0,0,0,0,0,0,0,0,0,0,0
Joseph Holmes,Jamie Pickett,Jamie Pickett,2022-01-15,0,1,-7,7,2,1.3,5.079987,-5.079987,0,0,0,0,195,182,12,23,-11,11,0.700000047683716,-0.700000047683716,0,0,0,0,0,0,0,0,0,392,-392,392
Kyle Daukaus,Jamie Pickett,Kyle Daukaus,2022-02-19,1,0,-5,5,2.75,1.3,2.539993,-2.539993,0,0,-10.16,10.16,252,15,15,23,-8,8,1.45000004768372,-1.45000004768372,0,1,0,0,-1,1,0,0,287,35,252,-252
Bo Nickal,Jamie Pickett,Bo Nickal,2023-03-04,1,0,-7,7,5,1.3,-2.540009,2.540009,0,0,-10.16,10.16,150,0,5,23,-18,18,3.70000004768372,-3.70000004768372,0,0,0,0,0,0,0,0,0,378,-378,378
Josh Fremd,Jamie Pickett,Josh Fremd,2023-08-12,1,0,-5,5,2.2,1.3,5.079987,-5.079987,0,0,-10.16,10.16,435,181,16,23,-7,7,0.900000095367432,-0.900000095367432,0,0,0,0,0,0,0,0,287,161,126,-126
Hermes Franca,Jamie Varner,Hermes Franca,2006-08-26,1,0,11,-11,1.411765,1.909091,-5.080002,5.080002,0,0,0,0,69,430,41,32,9,-9,-0.497326135635376,0.497326135635376,1,0,0,0,1,-1,0,0,49,0,49,-49
Jason Gilliam,Jamie Varner,Jamie Varner,2007-03-03,0,1,,,1.555556,1.909091,10.16,-10.16,15,-15,5.660004,-5.660004,0,80,23,32,-9,9,-0.353535294532776,0.353535294532776,0,0,0,0,0,0,0,0,0,189,-189,189
Edson Barboza,Jamie Varner,Jamie Varner,2012-05-26,0,1,-1,1,2.090909,1.909091,7.619995,-7.619995,-10,10,10.16,-10.16,0,71,34,32,2,-2,0.181818127632141,-0.181818127632141,4,1,0,0,3,-3,0,0,133,1911,-1778,1778
Joe Lauzon,Jamie Varner,Joe Lauzon,2012-08-04,1,0,1,-1,1.75,1.909091,5.080002,-5.080002,0,0,0,0,131,101,44,32,12,-12,-0.159090876579285,0.159090876579285,0,2,1,0,-2,2,1,-1,161,70,91,-91
Melvin Guillard,Jamie Varner,Jamie Varner,2012-12-29,0,1,1,-1,1.777778,1.909091,2.539993,-2.539993,0,0,0,0,59,235,50,32,18,-18,-0.13131308555603,0.13131308555603,0,0,0,0,0,0,0,0,344,147,197,-197
Gleison Tibau,Jamie Varner,Gleison Tibau,2013-08-31,1,0,1,-1,2.357143,1.909091,5.080002,-5.080002,0,0,0,0,340,116,47,32,15,-15,0.448052048683167,-0.448052048683167,2,1,0,0,1,-1,0,0,322,245,77,-77
Abel Trujillo,Jamie Varner,Abel Trujillo,2014-02-01,1,0,1,-1,1.875,1.909091,0,0,0,0,-2.539993,2.539993,9,150,23,32,-9,9,-3.40908765792847e-02,3.40908765792847e-02,0,0,0,0,0,0,0,0,0,154,-154,154
James Krause,Jamie Varner,James Krause,2014-05-24,1,0,-2,2,3.111111,1.909091,15.24001,-15.24001,15,-15,5.080002,-5.080002,138,35,37,32,5,-5,1.20202028751373,-1.20202028751373,1,0,0,1,1,-1,-1,1,343,112,231,-231
Drew Dober,Jamie Varner,Drew Dober,2014-12-13,1,0,-4,4,2.166667,1.909091,0,0,0,0,-2.539993,2.539993,40,0,38,32,6,-6,0.257575869560242,-0.257575869560242,0,0,0,2,0,0,-2,2,196,203,-7,7
Rich Attonito,Jamie Yager,Rich Attonito,2010-06-19,1,0,7,-7,2,2,-7.619995,7.619995,-15,15,-5.119995,5.119995,116,0,15,12,3,-3,0,0,0,0,0,0,0,0,0,0,0,0,0,0
Corey Anderson,Jan Blachowicz,Corey Anderson,2015-09-05,1,0,-7,7,2.8,2.9,2.539993,-2.539993,0,0,2.540009,-2.540009,640,23,19,39,-20,20,-0.100000143051147,0.100000143051147,0,0,1,0,0,0,1,-1,140,0,140,-140
Corey Anderson,Jan Blachowicz,Jan Blachowicz,2020-02-15,0,1,-6,6,2.8,2.9,2.539993,-2.539993,0,0,2.540009,-2.540009,3,2,19,39,-20,20,-0.100000143051147,0.100000143051147,4,0,3,0,4,-4,3,-3,105,1624,-1519,1519
Israel Adesanya,Jan Blachowicz,Jan Blachowicz,2021-03-06,0,1,-7,7,8,2.9,5.079987,-5.079987,-20,20,5.080002,-5.080002,1,426,27,39,-12,12,5.09999990463257,-5.09999990463257,9,1,0,0,8,-8,0,0,161,385,-224,224
Cyril Asker,Jared Cannonier,Jared Cannonier,2016-04-10,0,1,-2,2,2.25,2.833333,2.540009,-2.540009,62,-62,-7.619995,7.619995,40,6,13,23,-10,10,-0.583333253860474,0.583333253860474,0,0,0,0,0,0,0,0,0,0,0,0
Jan Blachowicz,Jared Cannonier,Jan Blachowicz,2017-12-16,1,0,1,-1,2.9,2.833333,7.62001,-7.62001,20,-20,2.539993,-2.539993,170,22,39,23,16,-16,6.6666841506958e-02,-6.6666841506958e-02,1,1,0,0,0,0,0,0,56,615,-559,559
David Branch,Jared Cannonier,Jared Cannonier,2018-11-03,0,1,3,-3,3.666667,2.833333,5.080002,-5.080002,0,0,2.539993,-2.539993,119,42,28,23,5,-5,0.833333492279053,-0.833333492279053,1,0,2,0,1,-1,2,-2,196,322,-126,126
Derek Brunson,Jared Cannonier,Jared Cannonier,2022-02-12,0,1,1,-1,2.555556,2.833333,5.080002,-5.080002,0,0,0,0,158,5,32,23,9,-9,-0.277777671813965,0.277777671813965,5,1,3,0,4,-4,3,-3,161,1197,-1036,1036
Israel Adesanya,Jared Cannonier,Israel Adesanya,2022-07-02,1,0,-6,6,8,2.833333,12.7,-12.7,0,0,7.619995,-7.619995,0,254,27,23,4,-4,5.16666674613953,-5.16666674613953,2,2,0,0,0,0,0,0,140,140,0,0
Randy Brown,Jared Gooden,Randy Brown,2021-10-09,1,0,4,-4,3.4,2.444444,7.619995,-7.619995,0,0,2.539993,-2.539993,6,44,22,31,-9,9,0.95555567741394,-0.95555567741394,1,0,2,0,1,-1,2,-2,168,0,168,-168
Hacran Dias,Jared Gordon,Jared Gordon,2017-10-28,0,1,4,-4,3.833333,3.166667,-2.539993,2.539993,0,0,2.539993,-2.539993,37,365,29,25,4,-4,0.666666507720947,-0.666666507720947,0,0,0,0,0,0,0,0,392,0,392,-392
Diego Ferreira,Jared Gordon,Diego Ferreira,2018-02-18,1,0,4,-4,3.6,3.166667,0,0,0,0,15.24001,-15.24001,18,0,23,25,-2,2,0.433333158493042,-0.433333158493042,0,1,1,0,-1,1,1,-1,1051,113,938,-938
Chris Fishgold,Jared Gordon,Jared Gordon,2020-07-15,0,1,-3,3,4.5,3.166667,-2.539993,2.539993,-10,10,0,0,43,622,22,25,-3,3,1.33333325386047,-1.33333325386047,1,0,1,1,1,-1,0,0,508,878,-370,370
Danny Chavez,Jared Gordon,Jared Gordon,2021-02-20,0,1,1,-1,2.2,3.166667,-2.539993,2.539993,-10,10,-2.540009,2.540009,10,367,16,25,-9,9,-0.966666698455811,0.966666698455811,0,1,0,1,-1,1,-1,1,0,220,-220,220
Grant Dawson,Jared Gordon,Grant Dawson,2022-04-30,1,0,-5,5,20,3.166667,2.540009,-2.540009,0,0,10.16,-10.16,431,72,21,25,-4,4,16.8333332538605,-16.8333332538605,5,2,0,1,3,-3,-1,1,406,434,-28,28
Alexander Gustafsson,Jared Hamman,Alexander Gustafsson,2009-11-14,1,0,-5,5,2.25,2.333333,5.080002,-5.080002,20,-20,10.16,-10.16,5,0,26,20,6,-6,-8.33332538604736e-02,8.33332538604736e-02,0,0,0,0,0,0,0,0,0,0,0,0
CB Dollaway,Jared Hamman,Jared Hamman,2011-08-14,0,1,-1,1,1.888889,2.333333,-2.539993,2.539993,0,0,2.539993,-2.539993,175,219,26,20,6,-6,-0.444444417953491,0.444444417953491,0,0,1,1,0,0,0,0,164,638,-474,474
Magnus Cedenblad,Jared Hamman,Magnus Cedenblad,2013-08-31,1,0,0,0,2.8,2.333333,5.080002,-5.080002,0,0,10.16,-10.16,8,1,19,20,-1,1,0.466666698455811,-0.466666698455811,0,1,0,1,-1,1,-1,1,0,748,-748,748
Mike Easton,Jared Papazian,Mike Easton,2012-01-20,1,0,4,-4,2.166667,1.538462,-5.080002,5.080002,0,0,7.62001,-7.62001,134,183,19,33,-14,14,0.628205180168152,-0.628205180168152,0,0,0,0,0,0,0,0,0,0,0,0
Dustin Pague,Jared Papazian,Dustin Pague,2012-06-08,1,0,0,0,1.090909,1.538462,2.539993,-2.539993,0,0,17.78001,-17.78001,155,0,23,33,-10,10,-0.447552442550659,0.447552442550659,0,0,0,0,0,0,0,0,0,140,-140,140
Tim Elliott,Jared Papazian,Tim Elliott,2012-12-15,1,0,1,-1,1.666667,1.538462,-2.540009,2.540009,-10,10,-2.539993,2.539993,428,129,32,33,-1,1,0.128205060958862,-0.128205060958862,0,0,0,0,0,0,0,0,0,190,-190,190
War Machine,Jared Rollins,War Machine,2007-12-08,1,0,-4,4,2.8,2,5.080002,-5.080002,0,0,5,-5,434,223,19,12,7,-7,0.799999952316284,-0.799999952316284,0,0,0,0,0,0,0,0,0,0,0,0
Walt Harris,Jared Rosholt,Jared Rosholt,2013-11-30,0,1,3,-3,1.3,3.5,7.619995,-7.619995,-15,15,5.080002,-5.080002,4,228,23,18,5,-5,-2.20000004768372,2.20000004768372,0,0,0,0,0,0,0,0,0,0,0,0
Daniel Omielanczuk,Jared Rosholt,Jared Rosholt,2014-04-11,0,1,4,-4,2.375,3.5,-5.080002,5.080002,-18,18,-2.539993,2.539993,5,787,27,18,9,-9,-1.125,1.125,0,1,0,0,-1,1,0,0,0,132,-132,132
Soa Palelei,Jared Rosholt,Jared Rosholt,2014-06-28,0,1,9,-9,4.4,3.5,5.079987,-5.079987,0,0,15.24001,-15.24001,42,695,27,18,9,-9,0.900000095367432,-0.900000095367432,1,2,1,0,-1,1,1,-1,49,78,-29,29
Aleksei Oleinik,Jared Rosholt,Aleksei Oleinik,2014-11-22,1,0,9,-9,3.529412,3.5,0,0,-25,25,12.7,-12.7,4,73,77,18,59,-59,2.9411792755127e-02,-2.9411792755127e-02,0,3,0,0,-3,3,0,0,0,147,-147,147
Josh Copeland,Jared Rosholt,Jared Rosholt,2015-03-14,0,1,4,-4,3,3.5,-2.540009,2.540009,0,0,-2.5,2.5,0,319,16,18,-2,2,-0.5,0.5,0,0,0,1,0,0,-1,1,112,112,0,0
Timothy Johnson,Jared Rosholt,Jared Rosholt,2015-08-08,0,1,1,-1,3,3.5,2.539993,-2.539993,0,0,5.080002,-5.080002,524,145,16,18,-2,2,-0.5,0.5,0,1,0,1,-1,1,-1,1,0,147,-147,147
Roy Nelson,Jared Rosholt,Roy Nelson,2016-02-06,1,0,10,-10,1.571429,3.5,-5.080002,5.080002,-2,2,-5.080002,5.080002,0,0,36,18,18,-18,-1.92857146263123,1.92857146263123,0,2,0,1,-2,2,-1,1,329,182,147,-147
Serghei Spivac,Jared Vanderaa,Serghei Spivac,2021-02-20,1,0,-2,2,4,1.2,-2.539993,2.539993,-5,5,-5.080002,5.080002,509,0,20,22,-2,2,2.79999995231628,-2.79999995231628,0,0,0,0,0,0,0,0,357,0,357,-357
Justin Tafa,Jared Vanderaa,Jared Vanderaa,2021-05-22,0,1,-2,2,2.333333,1.2,-10.15999,10.15999,-1,1,-15.23999,15.23999,11,24,10,22,-12,12,1.13333320617676,-1.13333320617676,0,0,0,1,0,0,-1,1,0,91,-91,91
Alexandr Romanov,Jared Vanderaa,Alexandr Romanov,2021-10-09,1,0,1,-1,8.5,1.2,-5.079987,5.079987,-3,3,-12.7,12.7,391,0,19,22,-3,3,7.29999995231628,-7.29999995231628,0,1,0,1,-1,1,-1,1,0,140,-140,140
Andrei Arlovski,Jared Vanderaa,Andrei Arlovski,2022-02-12,1,0,14,-14,1.545455,1.2,-2.539993,2.539993,-25,25,-7.619995,7.619995,0,164,56,22,34,-34,0.345454454421997,-0.345454454421997,2,0,7,2,2,-2,5,-5,119,126,-7,7
Aleksei Oleinik,Jared Vanderaa,Aleksei Oleinik,2022-04-09,1,0,15,-15,3.529412,1.2,-5.079987,5.079987,-25,25,0,0,44,54,77,22,55,-55,2.32941174507141,-2.32941174507141,0,0,1,2,0,0,-1,1,294,56,238,-238
Chase Sherman,Jared Vanderaa,Chase Sherman,2022-07-09,1,0,2,-2,1.333333,1.2,0,0,-15,15,-5.080002,5.080002,0,0,28,22,6,-6,0.133333325386047,-0.133333325386047,1,0,0,2,1,-1,-2,2,787,91,696,-696
Waldo Cortes-Acosta,Jared Vanderaa,Waldo Cortes-Acosta,2022-10-29,1,0,1,-1,10,1.2,0,0,-5,5,-5.080002,5.080002,3,13,11,22,-11,11,8.79999995231628,-8.79999995231628,0,0,0,3,0,0,-3,3,0,112,-112,112
SeungWoo Choi,Jarno Errens,SeungWoo Choi,2023-08-26,1,0,2,-2,1.833333,2.6,2.540009,-2.540009,0,0,2.540009,-2.540009,321,94,17,18,-1,1,-0.766666531562805,0.766666531562805,0,0,1,0,0,0,1,-1,287,0,287,-287
Kay Hansen,Jasmine Jasudavicius,Jasmine Jasudavicius,2022-01-22,0,1,-10,10,1.166667,3,-12.7,12.7,-10,10,-12.7,12.7,83,364,13,12,1,-1,-1.83333337306976,1.83333337306976,0,0,0,0,0,0,0,0,434,0,434,-434
Gabriella Fernandes,Jasmine Jasudavicius,Jasmine Jasudavicius,2023-02-25,0,1,-4,4,2.666667,3,-2.539993,2.539993,0,0,-5.080002,5.080002,4,691,11,12,-1,1,-0.333333253860474,0.333333253860474,0,1,0,0,-1,1,0,0,0,399,-399,399
Tracy Cortez,Jasmine Jasudavicius,Tracy Cortez,2023-09-16,1,0,-5,5,11,3,-5.079987,5.079987,0,0,-7.619995,7.619995,26,180,12,12,0,0,8,-8,4,2,0,0,2,-2,0,0,497,203,294,-294
Tim Boetsch,Jason Brilz,Jason Brilz,2009-03-07,0,1,-5,5,1.615385,3.666667,2.540009,-2.540009,-20,20,7.62001,-7.62001,2,478,34,28,6,-6,-2.05128216743469,2.05128216743469,1,0,1,0,1,-1,1,-1,182,0,182,-182
Ryan Bader,Jason Brilz,Ryan Bader,2011-11-19,1,0,-8,8,4.6,3.666667,7.62001,-7.62001,0,0,7.62001,-7.62001,1,0,28,28,0,0,0.933333158493042,-0.933333158493042,0,1,0,0,-1,1,0,0,140,987,-847,847
Alan Belcher,Jason Day,Jason Day,2008-04-19,0,1,-3,3,2.25,1.583333,5.080002,-5.080002,0,0,7.619995,-7.619995,162,0,26,31,-5,5,0.666666626930237,-0.666666626930237,2,0,0,0,2,-2,0,0,182,0,182,-182
Michael Bisping,Jason Day,Michael Bisping,2008-06-07,1,0,2,-2,3.333333,1.583333,2.539993,-2.539993,0,0,7.619995,-7.619995,142,3,39,31,8,-8,1.74999988079071,-1.74999988079071,1,1,0,0,0,0,0,0,49,49,0,0
Scott Baker,Jason DeLucia,Jason DeLucia,1994-03-11,0,1,,,1,1.571429,2.540009,-2.540009,20,-20,3.539993,-3.539993,0,0,2,54,-52,52,-0.571428537368774,0.571428537368774,0,0,0,0,0,0,0,0,0,0,0,0
Drew Dober,Jason Gonzalez,Drew Dober,2016-09-10,1,0,1,-1,2.166667,2.2,-15.24001,15.24001,0,0,-10.16,10.16,11,0,38,16,22,-22,-3.33333015441895e-02,3.33333015441895e-02,1,0,0,0,1,-1,0,0,252,0,252,-252
JC Cottrell,Jason Gonzalez,Jason Gonzalez,2017-01-28,0,1,1,-1,3.4,2.2,-12.70001,12.70001,0,0,-9.960007,9.960007,157,7,22,16,6,-6,1.20000004768372,-1.20000004768372,0,0,0,1,0,0,-1,1,189,140,49,-49
Gregor Gillespie,Jason Gonzalez,Gregor Gillespie,2017-09-16,1,0,3,-3,14,2.2,-17.78001,17.78001,0,0,-7.62001,7.62001,348,0,15,16,-1,1,11.7999999523163,-11.7999999523163,1,1,0,1,0,0,-1,1,161,231,-70,70
Charlie Brenneman,Jason High,Charlie Brenneman,2010-03-31,1,0,1,-1,2.375,3.5,5.080002,-5.080002,0,0,-7.619995,7.619995,528,163,27,27,0,0,-1.125,1.125,0,0,0,0,0,0,0,0,0,0,0,0
James Head,Jason High,Jason High,2013-08-28,0,1,-2,2,2.25,3.5,12.7,-12.7,15,-15,0,0,3,61,13,27,-14,14,-1.25,1.25,0,0,1,0,0,0,1,-1,256,1246,-990,990
Rafael Dos Anjos,Jason High,Rafael Dos Anjos,2014-06-07,1,0,-3,3,2.133333,3.5,0,0,15,-15,-7.619995,7.619995,112,174,47,27,20,-20,-1.36666655540466,1.36666655540466,0,1,1,0,-1,1,1,-1,49,283,-234,234
Tatsuya Kawajiri,Jason Knight,Tatsuya Kawajiri,2015-12-11,1,0,14,-14,3.272727,4,-7.62001,7.62001,0,0,-5.080002,5.080002,815,0,47,25,22,-22,-0.727272748947144,0.727272748947144,2,0,0,0,2,-2,0,0,174,0,174,-174
Jim Alers,Jason Knight,Jason Knight,2016-07-23,0,1,5,-5,4.333333,4,-2.540009,2.540009,0,0,0,0,202,46,16,25,-9,9,0.333333492279053,-0.333333492279053,0,0,1,0,0,0,1,-1,525,225,300,-300
Dan Hooker,Jason Knight,Jason Knight,2016-11-26,0,1,2,-2,1.916667,4,5.080002,-5.080002,10,-10,10.16,-10.16,43,293,35,25,10,-10,-2.08333337306976,2.08333337306976,0,1,0,0,-1,1,0,0,420,126,294,-294
Alex Caceres,Jason Knight,Jason Knight,2017-01-28,0,1,4,-4,1.5,4,0,0,0,0,5.080002,-5.080002,1,204,35,25,10,-10,-2.5,2.5,0,2,1,0,-2,2,1,-1,175,63,112,-112
Gabriel Benitez,Jason Knight,Gabriel Benitez,2017-12-09,1,0,4,-4,2.090909,4,-5.080002,5.080002,10,-10,0,0,77,64,34,25,9,-9,-1.90909099578857,1.90909099578857,1,3,1,0,-2,2,1,-1,448,315,133,-133
Makwan Amirkhani,Jason Knight,Makwan Amirkhani,2018-05-27,1,0,4,-4,1.888889,4,0,0,0,0,2.540009,-2.540009,14,414,26,25,1,-1,-2.11111116409302,2.11111116409302,3,0,0,0,3,-3,0,0,820,169,651,-651
Rashad Evans,Jason Lambert,Rashad Evans,2006-09-23,1,0,-5,5,2.375,2,-7.619995,7.619995,20,-20,0,0,323,31,27,39,-12,12,0.375,-0.375,2,0,0,0,2,-2,0,0,170,0,170,-170
Wilson Gouveia,Jason Lambert,Wilson Gouveia,2008-01-19,1,0,-3,3,1.75,2,-5.080002,5.080002,0,0,2.539993,-2.539993,7,290,22,39,-17,17,-0.25,0.25,2,0,0,1,2,-2,-1,1,238,483,-245,245
Luiz Cane,Jason Lambert,Luiz Cane,2008-06-07,1,0,-6,6,2.428571,2,-2.539993,2.539993,0,0,5.080002,-5.080002,54,14,24,39,-15,15,0.428571462631226,-0.428571462631226,0,0,0,2,0,0,-2,2,161,140,21,-21
Ed Herman,Jason MacDonald,Jason MacDonald,2006-10-10,0,1,-5,5,1.6875,1.5625,-5.080002,5.080002,20,-20,-7.619995,7.619995,78,57,43,41,2,-2,0.125,-0.125,0,0,0,0,0,0,0,0,0,0,0,0
Chris Leben,Jason MacDonald,Jason MacDonald,2006-12-30,0,1,-5,5,2,1.5625,-10.16,10.16,0,0,-17.78,17.78,108,287,33,41,-8,8,0.4375,-0.4375,1,1,1,0,0,0,1,-1,135,81,54,-54
Rich Franklin,Jason MacDonald,Rich Franklin,2007-03-03,1,0,1,-1,4.142857,1.5625,-5.080002,5.080002,0,0,-10.16,10.16,295,117,36,41,-5,5,2.58035707473755,-2.58035707473755,0,2,1,0,-2,2,1,-1,140,63,77,-77
Joe Doerksen,Jason MacDonald,Jason MacDonald,2008-04-19,0,1,-2,2,3.1875,1.5625,-7.619995,7.619995,0,0,-12.7,12.7,227,91,67,41,26,-26,1.625,-1.625,0,0,2,1,0,0,1,-1,154,413,-259,259
Jason Lambert,Jason MacDonald,Jason MacDonald,2008-09-06,0,1,0,0,2,1.5625,0,0,0,0,-12.7,12.7,0,356,39,41,-2,2,0.4375,-0.4375,4,1,0,1,3,-3,-1,1,553,140,413,-413
Wilson Gouveia,Jason MacDonald,Wilson Gouveia,2008-12-13,1,0,-3,3,1.75,1.5625,-5.080002,5.080002,0,0,-10.16,10.16,45,37,22,41,-19,19,0.1875,-0.1875,1,2,1,1,-1,1,0,0,87,98,-11,11
Ryan Jensen,Jason MacDonald,Jason MacDonald,2011-04-30,0,1,-2,2,2.625,1.5625,-5.080002,5.080002,0,0,-10.16,10.16,45,39,29,41,-12,12,1.0625,-1.0625,0,0,1,2,0,0,-1,1,189,868,-679,679
Alan Belcher,Jason MacDonald,Alan Belcher,2011-09-17,1,0,-9,9,2.25,1.5625,-2.539993,2.539993,0,0,-12.7,12.7,177,25,26,41,-15,15,0.6875,-0.6875,4,1,1,2,3,-3,-1,1,497,140,357,-357
Tom Lawlor,Jason MacDonald,Tom Lawlor,2012-05-15,1,0,-7,7,1.666667,1.5625,-7.619995,7.619995,20,-20,-15.23999,15.23999,1,2,16,41,-25,25,0.104166626930237,-0.104166626930237,0,0,0,3,0,0,-3,3,178,241,-63,63
Michael Bisping,Jason Miller,Michael Bisping,2011-12-03,1,0,2,-2,3.333333,2.3,0,0,0,0,2.5,-2.5,192,149,39,33,6,-6,1.03333330154419,-1.03333330154419,2,0,1,0,2,-2,1,-1,280,0,280,-280
CB Dollaway,Jason Miller,CB Dollaway,2012-05-26,1,0,-3,3,1.888889,2.3,2.540009,-2.540009,0,0,5.039993,-5.039993,745,5,26,33,-7,7,-0.411111116409302,0.411111116409302,0,0,2,1,0,0,1,-1,286,175,111,-111
Joe Lauzon,Jason Reinhardt,Joe Lauzon,2007-11-17,1,0,-15,15,1.75,6.666667,10.16,-10.16,20,-20,10.34,-10.34,56,0,44,23,21,-21,-4.91666650772095,4.91666650772095,2,0,0,0,2,-2,0,0,147,0,147,-147
Edwin Figueroa,Jason Reinhardt,Edwin Figueroa,2011-08-14,1,0,-14,14,1.8,6.666667,2.539993,-2.539993,0,0,5.259995,-5.259995,116,70,14,23,-9,9,-4.86666655540466,4.86666655540466,0,0,0,0,0,0,0,0,141,1366,-1225,1225
Paul Felder,Jason Saggo,Paul Felder,2014-10-04,1,0,2,-2,2.833333,3,0,0,0,0,-2.539993,2.539993,221,439,23,16,7,-7,-0.166666746139526,0.166666746139526,0,0,0,0,0,0,0,0,0,0,0,0
Rustam Khabilov,Jason Saggo,Rustam Khabilov,2016-12-10,1,0,-1,1,6,3,-7.619995,7.619995,0,0,5.080002,-5.080002,348,0,28,16,12,-12,3,-3,3,0,0,0,3,-3,0,0,98,798,-700,700
Gilbert Burns,Jason Saggo,Gilbert Burns,2017-09-16,1,0,0,0,3.666667,3,-2.539993,2.539993,15,-15,0,0,93,63,28,16,12,-12,0.666666746139526,-0.666666746139526,0,0,0,0,0,0,0,0,357,280,77,-77
Marcus Davis,Jason Tan,Marcus Davis,2007-06-16,1,0,8,-8,2,1.666667,0,0,0,0,-2.199997,2.199997,3,0,33,8,25,-25,0.333333373069763,-0.333333373069763,2,0,1,0,2,-2,1,-1,70,0,70,-70
Dong Hyun Kim,Jason Tan,Dong Hyun Kim,2008-05-24,1,0,0,0,5.5,1.666667,10.16,-10.16,0,0,13.03999,-13.03999,450,109,26,8,18,-18,3.83333337306976,-3.83333337306976,0,0,0,1,0,0,-1,1,0,343,-343,343
Chris Leben,Jason Thacker,Chris Leben,2005-04-09,1,0,-5,5,2,0,2.539993,-2.539993,0,0,5.419998,-5.419998,86,0,33,1,32,-32,2,-2,0,0,0,0,0,0,0,0,0,0,0,0
Alex Karalexis,Jason Von Flue,Jason Von Flue,2006-01-16,0,1,-2,2,1.666667,1.166667,-10.16,10.16,-15,15,-17.36,17.36,134,199,16,26,-10,10,0.5,-0.5,1,0,0,0,1,-1,0,0,282,0,282,-282
Luke Cummo,Jason Von Flue,Luke Cummo,2006-04-06,1,0,-5,5,1,1.166667,0,0,0,0,2.960007,-2.960007,245,247,12,26,-14,14,-0.166666626930237,0.166666626930237,0,1,0,0,-1,1,0,0,152,80,72,-72
Joe Riggs,Jason Von Flue,Joe Riggs,2006-08-17,1,0,-8,8,2.588235,1.166667,0,0,15,-15,-7.199997,7.199997,37,40,61,26,35,-35,1.42156875133514,-1.42156875133514,0,0,0,0,0,0,0,0,82,133,-51,51
Takashi Sato,Jason Witt,Takashi Sato,2020-06-27,1,0,-3,3,2.285714,2.111111,0,0,0,0,7.619995,-7.619995,11,0,23,28,-5,5,0.174603223800659,-0.174603223800659,1,0,0,0,1,-1,0,0,427,0,427,-427
Cole Williams,Jason Witt,Jason Witt,2020-10-31,0,1,3,-3,3.666667,2.111111,5.080002,-5.080002,0,0,7.619995,-7.619995,0,379,14,28,-14,14,1.55555558204651,-1.55555558204651,0,0,0,1,0,0,-1,1,0,126,-126,126
Matthew Semelsberger,Jason Witt,Matthew Semelsberger,2021-03-13,1,0,-6,6,1.833333,2.111111,7.619995,-7.619995,0,0,12.7,-12.7,2,0,17,28,-11,11,-0.277777791023254,0.277777791023254,0,1,0,1,-1,1,-1,1,0,133,-133,133
Bryan Barberena,Jason Witt,Jason Witt,2021-07-31,0,1,-2,2,1.636364,2.111111,5.080002,-5.080002,0,0,5.080002,-5.080002,47,338,29,28,1,-1,-0.474747538566589,0.474747538566589,1,0,2,2,1,-1,0,0,322,140,182,-182
Phil Rowe,Jason Witt,Phil Rowe,2022-02-05,1,0,-4,4,2.5,2.111111,12.7,-12.7,0,0,25.39999,-25.39999,1,311,14,28,-14,14,0.388888835906982,-0.388888835906982,0,1,0,2,-1,1,-2,2,0,189,-189,189
Josh Quinlan,Jason Witt,Josh Quinlan,2022-08-13,1,0,-6,6,6,2.111111,5.080002,-5.080002,0,0,5.080002,-5.080002,0,27,7,28,-21,21,3.88888883590698,-3.88888883590698,0,0,0,3,0,0,-3,3,0,189,-189,189
Dustin Poirier,Jason Young,Dustin Poirier,2011-06-11,1,0,-2,2,3.625,1.5,0,0,10,-10,-2.539993,2.539993,280,51,37,15,22,-22,2.125,-2.125,0,0,0,0,0,0,0,0,0,0,0,0
Michihiro Omigawa,Jason Young,Michihiro Omigawa,2011-11-05,1,0,10,-10,1.214286,1.5,-7.619995,7.619995,0,0,-12.7,12.7,488,50,31,15,16,-16,-0.285714268684387,0.285714268684387,0,0,0,0,0,0,0,0,1382,147,1235,-1235
Eric Wisely,Jason Young,Jason Young,2012-04-14,0,1,2,-2,2.888889,1.5,-2.539993,2.539993,0,0,-10.42,10.42,9,511,35,15,20,-20,1.38888883590698,-1.38888883590698,0,0,0,0,0,0,0,0,0,161,-161,161
Robert Peralta,Jason Young,Robert Peralta,2012-09-29,1,0,0,0,2.25,1.5,-2.539993,2.539993,0,0,-5.080002,5.080002,3,0,26,15,11,-11,0.75,-0.75,0,1,0,0,-1,1,0,0,0,168,-168,168
Joe Stevenson,Javier Vazquez,Javier Vazquez,2011-06-26,0,1,-4,4,2.0625,3.2,0,0,0,0,2.540009,-2.540009,81,254,49,21,28,-28,-1.13750004768372,1.13750004768372,1,0,0,0,1,-1,0,0,1086,0,1086,-1086
Jonathan Goulet,Jay Hieron,Jonathan Goulet,2005-10-03,1,0,-3,3,1.916667,3.285714,0,0,0,0,-5.080002,5.080002,39,440,35,30,5,-5,-1.36904776096344,1.36904776096344,0,0,0,0,0,0,0,0,0,0,0,0
Jake Ellenberger,Jay Hieron,Jake Ellenberger,2012-10-05,1,0,-9,9,2.066667,3.285714,-7.62001,7.62001,0,0,-10.16,10.16,65,0,46,30,16,-16,-1.2190477848053,1.2190477848053,0,0,1,1,0,0,0,0,126,2559,-2433,2433
Mario Bautista,Jay Perrin,Mario Bautista,2022-02-19,1,0,0,0,6.5,1.428571,5.080002,-5.080002,0,0,5.080002,-5.080002,390,105,15,17,-2,2,5.07142853736877,-5.07142853736877,0,0,1,0,0,0,1,-1,350,0,350,-350
CB Dollaway,Jay Silva,CB Dollaway,2009-09-16,1,0,,,1.888889,0.9090909,0,0,0,0,2.039993,-2.039993,619,79,26,21,5,-5,0.979797899723053,-0.979797899723053,0,0,0,0,0,0,0,0,67,0,67,-67
Chris Leben,Jay Silva,Chris Leben,2010-01-11,1,0,,,2,0.9090909,-7.62001,7.62001,0,0,-5.580002,5.580002,636,47,33,21,12,-12,1.09090906381607,-1.09090906381607,0,0,1,0,0,0,1,-1,135,117,18,-18
Maurice Greene,Jeff Hughes,Maurice Greene,2019-03-09,1,0,2,-2,1.285714,2.5,12.7,-12.7,8,-8,7.619995,-7.619995,19,45,16,14,2,-2,-1.21428573131561,1.21428573131561,0,0,0,0,0,0,0,0,0,0,0,0
Juan Espino,Jeff Hughes,Juan Espino,2020-09-26,1,0,7,-7,5.5,2.5,2.539993,-2.539993,5,-5,7.619995,-7.619995,156,0,13,14,-1,1,3,-3,1,0,0,0,1,-1,0,0,666,567,99,-99
Daniel Lacerda,Jeff Molina,Jeff Molina,2021-10-23,0,1,1,-1,2.2,5.5,0,0,0,0,2.540009,-2.540009,55,206,16,13,3,-3,-3.29999995231628,3.29999995231628,0,0,0,0,0,0,0,0,0,0,0,0
Tim Lajcik,Jeff Monson,Jeff Monson,2000-09-22,0,1,6,-6,1.166667,2.307692,10.16,-10.16,-22,22,-1.960007,1.960007,97,423,13,86,-73,73,-1.14102566242218,1.14102566242218,0,0,0,0,0,0,0,0,0,0,0,0
Chuck Liddell,Jeff Monson,Chuck Liddell,2000-12-16,1,0,1,-1,2.625,2.307692,12.70001,-12.70001,-42,42,5.079987,-5.079987,99,63,29,86,-57,57,0.317307710647583,-0.317307710647583,0,1,0,0,-1,1,0,0,0,85,-85,85
Branden Lee Hinkle,Jeff Monson,Jeff Monson,2006-02-04,0,1,-3,3,1.545455,2.307692,15.24001,-15.24001,-12,12,5.039993,-5.039993,73,181,28,86,-58,58,-0.762237787246704,0.762237787246704,0,0,0,0,0,0,0,0,0,1876,-1876,1876
Marcio Cruz,Jeff Monson,Jeff Monson,2006-04-15,0,1,-8,8,2.666667,2.307692,17.78,-17.78,-15,15,8.039993,-8.039993,69,369,11,86,-75,75,0.358974456787109,-0.358974456787109,2,1,0,0,1,-1,0,0,70,70,0,0
Sam Hoger,Jeff Newton,Sam Hoger,2005-11-19,1,0,-13,13,2.5,2,0,0,0,0,-1,1,284,9,14,6,8,-8,0.5,-0.5,1,0,0,0,1,-1,0,0,224,0,224,-224
Anshul Jubli,Jeka Saragih,Anshul Jubli,2023-02-04,1,0,0,0,7,4.333333,10.16,-10.16,0,0,0,0,427,9,7,16,-9,9,2.66666650772095,-2.66666650772095,0,0,0,0,0,0,0,0,0,0,0,0
Liz Carmouche,Jennifer Maia,Liz Carmouche,2018-07-14,1,0,5,-5,1.857143,2.333333,5.080002,-5.080002,0,0,5.080002,-5.080002,321,149,20,30,-10,10,-0.476190447807312,0.476190447807312,0,0,0,0,0,0,0,0,217,0,217,-217
Alexis Davis,Jennifer Maia,Jennifer Maia,2019-03-23,0,1,4,-4,1.909091,2.333333,5.080002,-5.080002,10,-10,10.16,-10.16,315,78,32,30,2,-2,-0.424242377281189,0.424242377281189,0,0,1,0,0,0,1,-1,840,252,588,-588
Katlyn Chookagian,Jennifer Maia,Katlyn Chookagian,2019-11-02,1,0,-1,1,3.6,2.333333,12.7,-12.7,0,0,10.16,-10.16,0,151,23,30,-7,7,1.26666665077209,-1.26666665077209,1,1,0,0,0,0,0,0,147,224,-77,77
Jessica Eye,Jennifer Maia,Jennifer Maia,2021-07-10,0,1,2,-2,1.363636,2.333333,5.080002,-5.080002,0,0,5.080002,-5.080002,56,4,26,30,-4,4,-0.969696879386902,0.969696879386902,0,0,1,0,0,0,1,-1,168,616,-448,448
Katlyn Chookagian,Jennifer Maia,Katlyn Chookagian,2022-01-15,1,0,0,0,3.6,2.333333,12.7,-12.7,0,0,10.16,-10.16,214,41,23,30,-7,7,1.26666665077209,-1.26666665077209,1,1,1,0,0,0,1,-1,595,189,406,-406
Manon Fiorot,Jennifer Maia,Manon Fiorot,2022-03-26,1,0,-1,1,11,2.333333,7.619995,-7.619995,0,0,2.540009,-2.540009,157,76,12,30,-18,18,8.66666674613953,-8.66666674613953,2,0,0,0,2,-2,0,0,294,70,224,-224
John Lewis,Jens Pulver,Jens Pulver,2000-11-17,0,1,,,0.75,1.421053,12.70001,-12.70001,10,-10,0.1999969,-0.1999969,0,0,7,46,-39,39,-0.671052575111389,0.671052575111389,0,0,0,0,0,0,0,0,0,0,0,0
Dennis Hallman,Jens Pulver,Jens Pulver,2001-09-28,0,1,-1,1,2.65,1.421053,5.080002,-5.080002,10,-10,5.080002,-5.080002,112,961,73,46,27,-27,1.22894752025604,-1.22894752025604,1,1,0,0,0,0,0,0,286,315,-29,29
BJ Penn,Jens Pulver,Jens Pulver,2002-01-11,0,1,-4,4,1.142857,1.421053,5.080002,-5.080002,10,-10,0,0,384,501,30,46,-16,16,-0.278195381164551,0.278195381164551,2,2,0,0,0,0,0,0,70,105,-35,35
Joe Lauzon,Jens Pulver,Joe Lauzon,2006-09-23,1,0,-9,9,1.75,1.421053,7.62001,-7.62001,10,-10,2.539993,-2.539993,0,31,44,46,-2,2,0.328947424888611,-0.328947424888611,0,3,0,0,-3,3,0,0,0,1716,-1716,1716
BJ Penn,Jens Pulver,BJ Penn,2007-06-23,1,0,-4,4,1.142857,1.421053,5.080002,-5.080002,10,-10,0,0,296,117,30,46,-16,16,-0.278195381164551,0.278195381164551,0,0,0,1,0,0,-1,1,476,273,203,-203
Warlley Alves,Jeremiah Wells,Jeremiah Wells,2021-06-26,0,1,-4,4,2.5,4,5.080002,-5.080002,0,0,-5.080002,5.080002,22,212,21,15,6,-6,-1.5,1.5,1,0,1,0,1,-1,1,-1,157,0,157,-157
Blood Diamond,Jeremiah Wells,Jeremiah Wells,2022-02-12,0,1,-2,2,1,4,5.080002,-5.080002,0,0,5.079987,-5.079987,3,265,6,15,-9,9,-3,3,0,1,0,0,-1,1,0,0,0,231,-231,231
Court McGee,Jeremiah Wells,Jeremiah Wells,2022-06-18,0,1,2,-2,1.833333,4,5.080002,-5.080002,0,0,2.539993,-2.539993,0,2,34,15,19,-19,-2.16666662693024,2.16666662693024,1,2,1,0,-1,1,1,-1,392,126,266,-266
Matthew Semelsberger,Jeremiah Wells,Jeremiah Wells,2023-04-22,0,1,-6,6,1.833333,4,10.16,-10.16,0,0,2.539993,-2.539993,89,672,17,15,2,-2,-2.16666662693024,2.16666662693024,0,3,0,0,-3,3,0,0,672,308,364,-364
Carlston Harris,Jeremiah Wells,Carlston Harris,2023-08-05,1,0,0,0,3.8,4,7.62001,-7.62001,0,0,5.079987,-5.079987,13,566,24,15,9,-9,-0.200000047683716,0.200000047683716,0,4,1,0,-4,4,1,-1,546,105,441,-441
Ebenezer Fontes Braga,Jeremy Horn,Ebenezer Fontes Braga,1998-10-16,1,0,6,-6,1.857143,4.136364,-2.539993,2.539993,14,-14,-1.960007,1.960007,0,0,20,113,-93,93,-2.27922070026398,2.27922070026398,0,0,0,0,0,0,0,0,0,0,0,0
Jason Godsey,Jeremy Horn,Jeremy Horn,1999-09-24,0,1,,,1,4.136364,2.540009,-2.540009,45,-45,3.039993,-3.039993,79,2,32,113,-81,81,-3.13636350631714,3.13636350631714,0,0,0,0,0,0,0,0,203,343,-140,140
Nick Diaz,Jeremy Jackson,Nick Diaz,2003-09-26,1,0,-1,1,2.6,1.8,7.619995,-7.619995,0,0,13.03999,-13.03999,403,208,36,14,22,-22,0.799999952316284,-0.799999952316284,0,0,0,0,0,0,0,0,0,0,0,0
Rony Jason,Jeremy Kennedy,Jeremy Kennedy,2017-03-11,0,1,8,-8,2,11,-10.16,10.16,0,0,5.080002,-5.080002,233,397,21,12,9,-9,-9,9,0,0,1,0,0,0,1,-1,1015,0,1015,-1015
Kyle Bochniak,Jeremy Kennedy,Jeremy Kennedy,2017-07-22,0,1,6,-6,1.6,11,-10.16,10.16,0,0,-2.539993,2.539993,0,697,13,12,1,-1,-9.39999997615814,9.39999997615814,0,1,0,0,-1,1,0,0,552,133,419,-419
Andre Fili,Jeremy Larsen,Andre Fili,2013-10-19,1,0,-6,6,2.2,1.6,2.539993,-2.539993,0,0,10.16,-10.16,40,104,32,13,19,-19,0.600000023841858,-0.600000023841858,0,0,0,0,0,0,0,0,0,0,0,0
Diego Saraiva,Jeremy Stephens,Jeremy Stephens,2007-09-22,0,1,4,-4,1.1,1.473684,-7.619995,7.619995,10,-10,-10.34,10.34,131,591,42,47,-5,5,-0.373684167861938,0.373684167861938,0,0,0,0,0,0,0,0,0,0,0,0
Cole Miller,Jeremy Stephens,Jeremy Stephens,2008-01-23,0,1,2,-2,1.909091,1.473684,10.16,-10.16,0,0,5.080002,-5.080002,174,259,32,47,-15,15,0.435406684875488,-0.435406684875488,1,1,0,0,0,0,0,0,214,123,91,-91
Spencer Fisher,Jeremy Stephens,Spencer Fisher,2008-06-21,1,0,10,-10,2.666667,1.473684,-5.080002,5.080002,10,-10,-7.619995,7.619995,522,154,33,47,-14,14,1.19298255443573,-1.19298255443573,1,2,1,0,-1,1,1,-1,375,150,225,-225
Rafael Dos Anjos,Jeremy Stephens,Jeremy Stephens,2008-11-15,0,1,2,-2,2.133333,1.473684,-2.539993,2.539993,25,-25,-2.539993,2.539993,309,142,47,47,0,0,0.659649252891541,-0.659649252891541,0,0,0,0,0,0,0,0,0,147,-147,147
Joe Lauzon,Jeremy Stephens,Joe Lauzon,2009-02-07,1,0,2,-2,1.75,1.473684,2.540009,-2.540009,10,-10,0,0,311,224,44,47,-3,3,0.276315808296204,-0.276315808296204,3,1,0,0,2,-2,0,0,448,84,364,-364
Justin Buchholz,Jeremy Stephens,Jeremy Stephens,2009-09-16,0,1,3,-3,1.5,1.473684,7.62001,-7.62001,10,-10,5.080002,-5.080002,0,26,25,47,-22,22,2.63158082962036e-02,-2.63158082962036e-02,0,0,0,0,0,0,0,0,95,221,-126,126
Melvin Guillard,Jeremy Stephens,Melvin Guillard,2010-09-25,1,0,3,-3,1.777778,1.473684,0,0,10,-10,0,0,0,2,50,47,3,-3,0.304093599319458,-0.304093599319458,4,1,0,0,3,-3,0,0,119,374,-255,255
Marcus Davis,Jeremy Stephens,Jeremy Stephens,2011-01-01,0,1,13,-13,2,1.473684,2.540009,-2.540009,25,-25,-2.539993,2.539993,263,62,33,47,-14,14,0.526315808296204,-0.526315808296204,0,0,2,0,0,0,2,-2,126,98,28,-28
Danny Downes,Jeremy Stephens,Jeremy Stephens,2011-06-04,0,1,0,0,2.666667,1.473684,7.62001,-7.62001,10,-10,2.540009,-2.540009,28,496,11,47,-36,36,1.19298255443573,-1.19298255443573,0,1,0,0,-1,1,0,0,0,154,-154,154
Anthony Pettis,Jeremy Stephens,Anthony Pettis,2011-10-08,1,0,-1,1,2.4,1.473684,2.540009,-2.540009,10,-10,2.540009,-2.540009,411,209,34,47,-13,13,0.926315903663635,-0.926315903663635,0,2,0,0,-2,2,0,0,0,126,-126,126
Donald Cerrone,Jeremy Stephens,Donald Cerrone,2012-05-15,1,0,4,-4,2.117647,1.473684,10.16,-10.16,10,-10,5.080002,-5.080002,31,1,53,47,6,-6,0.643962979316711,-0.643962979316711,0,0,0,0,0,0,0,0,137,220,-83,83
Yves Edwards,Jeremy Stephens,Yves Edwards,2012-12-08,1,0,10,-10,1.909091,1.473684,0,0,10,-10,5.080002,-5.080002,6,2,64,47,17,-17,0.435406684875488,-0.435406684875488,0,0,2,0,0,0,2,-2,371,207,164,-164
Estevan Payan,Jeremy Stephens,Jeremy Stephens,2013-05-25,0,1,4,-4,1.333333,1.473684,2.540009,-2.540009,0,0,-2.339996,2.339996,17,546,28,47,-19,19,-0.140350818634033,0.140350818634033,0,0,0,1,0,0,-1,1,0,168,-168,168
Rony Jason,Jeremy Stephens,Jeremy Stephens,2013-11-09,0,1,2,-2,2,1.473684,-5.080002,5.080002,0,0,5.080002,-5.080002,0,2,21,47,-26,26,0.526315808296204,-0.526315808296204,3,1,0,1,2,-2,-1,1,154,168,-14,14
Darren Elkins,Jeremy Stephens,Jeremy Stephens,2014-01-25,0,1,2,-2,2.454545,1.473684,2.540009,-2.540009,0,0,0,0,74,68,38,47,-9,9,0.980861306190491,-0.980861306190491,1,2,1,1,-1,1,0,0,150,77,73,-73
Charles Oliveira,Jeremy Stephens,Charles Oliveira,2014-12-12,1,0,-3,3,3.777778,1.473684,2.540009,-2.540009,10,-10,7.62001,-7.62001,322,379,43,47,-4,4,2.30409348011017,-2.30409348011017,0,3,1,1,-3,3,0,0,811,321,490,-490
Dennis Bermudez,Jeremy Stephens,Jeremy Stephens,2015-07-11,0,1,-1,1,1.888889,1.473684,-7.619995,7.619995,10,-10,-12.7,12.7,297,20,26,47,-21,21,0.415204644203186,-0.415204644203186,0,0,0,1,0,0,-1,1,238,211,27,-27
Max Holloway,Jeremy Stephens,Max Holloway,2015-12-12,1,0,-5,5,3.571429,1.473684,5.080002,-5.080002,0,0,-5.080002,5.080002,207,129,32,47,-15,15,2.09774434566498,-2.09774434566498,3,1,0,1,2,-2,-1,1,111,154,-43,43
Renan Barao,Jeremy Stephens,Jeremy Stephens,2016-05-29,0,1,-1,1,3.777778,1.473684,-7.619995,7.619995,0,0,-2.539993,2.539993,149,143,43,47,-4,4,2.30409348011017,-2.30409348011017,0,0,2,1,0,0,1,-1,309,169,140,-140
Frankie Edgar,Jeremy Stephens,Frankie Edgar,2016-11-12,1,0,5,-5,2.090909,1.473684,-7.619995,7.619995,-10,10,-7.619995,7.619995,289,3,34,47,-13,13,0.617224812507629,-0.617224812507629,5,1,0,1,4,-4,-1,1,337,167,170,-170
Renato Moicano,Jeremy Stephens,Renato Moicano,2017-04-15,1,0,-3,3,3.4,1.473684,5.080002,-5.080002,10,-10,2.540009,-2.540009,136,0,22,47,-25,25,1.92631590366364,-1.92631590366364,2,0,0,1,2,-2,-1,1,336,154,182,-182
Gilbert Melendez,Jeremy Stephens,Jeremy Stephens,2017-09-09,0,1,4,-4,2.75,1.473684,0,0,0,0,5.080002,-5.080002,0,80,30,47,-17,17,1.2763158082962,-1.2763158082962,0,0,0,1,0,0,-1,1,1008,147,861,-861
Dooho Choi,Jeremy Stephens,Jeremy Stephens,2018-01-14,0,1,-5,5,3.5,1.473684,2.540009,-2.540009,0,0,-2.539993,2.539993,4,11,18,47,-29,29,2.0263158082962,-2.0263158082962,0,1,0,1,-1,1,-1,1,400,127,273,-273
Josh Emmett,Jeremy Stephens,Jeremy Stephens,2018-02-24,0,1,1,-1,4.5,1.473684,-7.619995,7.619995,0,0,-2.539993,2.539993,21,9,22,47,-25,25,3.0263158082962,-3.0263158082962,1,2,0,1,-1,1,-1,1,70,41,29,-29
Jose Aldo,Jeremy Stephens,Jose Aldo,2018-07-28,1,0,-1,1,3.875,1.473684,-5.080002,5.080002,-10,10,-2.539993,2.539993,24,0,39,47,-8,8,2.4013158082962,-2.4013158082962,0,3,3,1,-3,3,2,-2,238,154,84,-84
Zabit Magomedsharipov,Jeremy Stephens,Zabit Magomedsharipov,2019-03-02,1,0,-4,4,18,1.473684,10.16,-10.16,0,0,5.080002,-5.080002,157,1,19,47,-28,28,16.5263158082962,-16.5263158082962,2,0,0,2,2,-2,-2,2,462,217,245,-245
Yair Rodriguez,Jeremy Stephens,Yair Rodriguez,2019-10-18,1,0,-6,6,4,1.473684,5.080002,-5.080002,0,0,0,0,190,334,20,47,-27,27,2.5263158082962,-2.5263158082962,2,0,0,2,2,-2,-2,2,342,230,112,-112
Calvin Kattar,Jeremy Stephens,Calvin Kattar,2020-05-09,1,0,-1,1,3.285714,1.473684,5.080002,-5.080002,0,0,2.540009,-2.540009,6,6,30,47,-17,17,1.81203019618988,-1.81203019618988,0,0,0,2,0,0,-2,2,182,204,-22,22
Mateusz Gamrot,Jeremy Stephens,Mateusz Gamrot,2021-07-17,1,0,-5,5,11.5,1.473684,2.540009,-2.540009,10,-10,-2.539993,2.539993,46,3,25,47,-22,22,10.0263158082962,-10.0263158082962,1,0,0,3,1,-1,-3,3,98,434,-336,336
Tyson Nam,Jerome Rivera,Tyson Nam,2020-09-19,1,0,11,-11,1.5,1.666667,-7.62001,7.62001,0,0,-10.16,10.16,23,0,35,16,19,-19,-0.166666626930237,0.166666626930237,0,0,0,0,0,0,0,0,364,0,364,-364
Francisco Figueiredo,Jerome Rivera,Francisco Figueiredo,2021-01-20,1,0,6,-6,2.6,1.666667,-10.16,10.16,0,0,-10.16,10.16,427,67,18,16,2,-2,0.933333277702332,-0.933333277702332,0,0,0,1,0,0,-1,1,0,123,-123,123
Ode Osbourne,Jerome Rivera,Ode Osbourne,2021-02-06,1,0,4,-4,2,1.666667,-7.62001,7.62001,0,0,2.539993,-2.539993,2,0,18,16,2,-2,0.333333373069763,-0.333333373069763,0,0,0,1,0,0,-1,1,0,17,-17,17
Yosdenis Cedeno,Jerrod Sanders,Yosdenis Cedeno,2014-07-16,1,0,-5,5,1.666667,5.333333,0,0,20,-20,-7.62001,7.62001,182,55,16,19,-3,3,-3.66666686534882,3.66666686534882,0,0,0,0,0,0,0,0,144,0,144,-144
Russell Doane,Jerrod Sanders,Jerrod Sanders,2015-07-12,0,1,-7,7,1.875,5.333333,-2.540009,2.540009,0,0,-5.080002,5.080002,385,402,23,19,4,-4,-3.45833349227905,3.45833349227905,1,0,0,1,1,-1,-1,1,554,361,193,-193
Felipe Arantes,Jerrod Sanders,Felipe Arantes,2016-07-07,1,0,-8,8,1.8,5.333333,0,0,0,0,2.539993,-2.539993,37,298,28,19,9,-9,-3.53333353996277,3.53333353996277,1,1,0,1,0,0,-1,1,319,361,-42,42
Marcus Davis,Jess Liaudin,Marcus Davis,2008-01-19,1,0,,,2,1.818182,2.540009,-2.540009,0,0,-5.080002,5.080002,2,0,33,31,2,-2,0.181818127632141,-0.181818127632141,4,0,1,0,4,-4,1,-1,133,0,133,-133
David Bielkheden,Jess Liaudin,David Bielkheden,2008-10-18,1,0,,,2,1.818182,2.540009,-2.540009,-15,15,-2.540009,2.540009,594,194,36,31,5,-5,0.181818127632141,-0.181818127632141,0,0,1,1,0,0,0,0,231,273,-42,42
Bethe Correia,Jessamyn Duke,Bethe Correia,2014-04-26,1,0,3,-3,1.833333,0.6,-15.23999,15.23999,0,0,-22.86,22.86,209,12,17,8,9,-9,1.23333334922791,-1.23333334922791,1,0,0,0,1,-1,0,0,141,0,141,-141
Nick Catone,Jesse Forbes,Nick Catone,2010-01-11,1,0,3,-3,2.5,3,-5.080002,5.080002,0,0,-7.619995,7.619995,98,68,14,20,-6,6,-0.5,0.5,0,0,0,0,0,0,0,0,135,0,135,-135
Michel Prazeres,Jesse Ronson,Michel Prazeres,2013-09-21,1,0,5,-5,6.5,1.75,-10.16,10.16,15,-15,-7.62001,7.62001,516,46,30,33,-3,3,4.75,-4.75,0,0,0,0,0,0,0,0,126,0,126,-126
Kevin Lee,Jesse Ronson,Kevin Lee,2014-07-06,1,0,-7,7,2.25,1.75,-2.540009,2.540009,15,-15,17.78,-17.78,427,40,26,33,-7,7,0.5,-0.5,0,0,0,0,0,0,0,0,0,288,-288,288
Rafa Garcia,Jesse Ronson,Rafa Garcia,2022-04-16,1,0,-9,9,5.333333,1.75,-7.62001,7.62001,0,0,0,0,277,2,19,33,-14,14,3.58333349227905,-3.58333349227905,1,0,0,0,1,-1,0,0,147,2841,-2694,2694
Brock Larson,Jesse Sanders,Brock Larson,2009-04-01,1,0,,,4.2,3.285714,-2.540009,2.540009,0,0,-4.660004,4.660004,87,0,52,30,22,-22,0.91428542137146,-0.91428542137146,1,0,0,0,1,-1,0,0,840,0,840,-840
Montel Jackson,Jesse Strader,Montel Jackson,2021-03-20,1,0,-1,1,6.5,1.666667,7.62001,-7.62001,0,0,12.7,-12.7,16,1,15,8,7,-7,4.83333337306976,-4.83333337306976,0,0,0,0,0,0,0,0,245,0,245,-245
Chad Anheliger,Jesse Strader,Chad Anheliger,2022-02-19,1,0,5,-5,2,1.666667,-2.539993,2.539993,0,0,-15.24001,15.24001,80,200,18,8,10,-10,0.333333373069763,-0.333333373069763,0,0,0,1,0,0,-1,1,0,336,-336,336
CB Dollaway,Jesse Taylor,CB Dollaway,2008-07-19,1,0,-1,1,1.888889,2.066667,5.080002,-5.080002,15,-15,7.619995,-7.619995,79,139,26,46,-20,20,-0.177777767181396,0.177777767181396,0,0,0,0,0,0,0,0,28,0,28,-28
Dhiego Lima,Jesse Taylor,Jesse Taylor,2017-07-07,0,1,-6,6,1.888889,2.066667,5.080002,-5.080002,0,0,5.080002,-5.080002,0,330,26,46,-20,20,-0.177777767181396,0.177777767181396,0,0,1,0,0,0,1,-1,860,3275,-2415,2415
Alexis Davis,Jessica Eye,Alexis Davis,2014-02-22,1,0,2,-2,1.909091,1.363636,0,0,10,-10,5.080002,-5.080002,292,69,32,26,6,-6,0.545454502105713,-0.545454502105713,1,0,0,0,1,-1,0,0,252,0,252,-252
Bethe Correia,Jessica Eye,Bethe Correia,2016-09-10,1,0,3,-3,1.833333,1.363636,-2.539993,2.539993,10,-10,-5.080002,5.080002,60,3,17,26,-9,9,0.469696998596191,-0.469696998596191,0,0,1,0,0,0,1,-1,147,931,-784,784
Jessica-Rose Clark,Jessica Eye,Jessica Eye,2018-06-23,0,1,-1,1,1.222222,1.363636,-2.539993,2.539993,10,-10,-5.080002,5.080002,2,125,20,26,-6,6,-0.141414165496826,0.141414165496826,2,0,0,0,2,-2,0,0,160,651,-491,491
Katlyn Chookagian,Jessica Eye,Jessica Eye,2018-12-08,0,1,-3,3,3.6,1.363636,7.619995,-7.619995,0,0,5.080002,-5.080002,50,20,23,26,-3,3,2.236363530159,-2.236363530159,3,1,0,0,2,-2,0,0,133,168,-35,35
Viviane Araujo,Jessica Eye,Jessica Eye,2019-12-14,0,1,0,0,2.2,1.363636,-5.080002,5.080002,0,0,5.080002,-5.080002,103,13,16,26,-10,10,0.836363673210144,-0.836363673210144,2,2,0,0,0,0,0,0,140,371,-231,231
Cynthia Calvillo,Jessica Eye,Cynthia Calvillo,2020-06-13,1,0,-1,1,1.5,1.363636,-5.080002,5.080002,-10,10,-5.080002,5.080002,466,0,15,26,-11,11,0.136363625526428,-0.136363625526428,1,3,0,0,-2,2,0,0,482,182,300,-300
Maycee Barber,Jessica Eye,Maycee Barber,2022-07-02,1,0,-11,11,6.5,1.363636,-2.539993,2.539993,0,0,-2.539993,2.539993,112,489,15,26,-11,11,5.13636362552643,-5.13636362552643,2,0,0,0,2,-2,0,0,70,749,-679,679
Randa Markos,Jessica Penne,Jessica Penne,2014-12-12,0,1,-2,2,0.9166667,1.75,-2.540009,2.540009,0,0,-10.15999,10.15999,136,401,23,22,1,-1,-0.833333313465118,0.833333313465118,0,0,0,0,0,0,0,0,0,0,0,0
Joanna Jedrzejczyk,Jessica Penne,Joanna Jedrzejczyk,2015-06-20,1,0,-5,5,3.2,1.75,2.539993,-2.539993,0,0,-5.079987,5.079987,108,154,21,22,-1,1,1.45000004768372,-1.45000004768372,1,1,0,0,0,0,0,0,329,190,139,-139
Jessica Andrade,Jessica Penne,Jessica Andrade,2016-06-04,1,0,-9,9,2,1.75,-10.16,10.16,0,0,-12.7,12.7,32,0,36,22,14,-14,0.25,-0.25,0,0,1,1,0,0,0,0,273,350,-77,77
Loopy Godinez,Jessica Penne,Jessica Penne,2021-04-17,0,1,-11,11,3.666667,1.75,-7.62001,7.62001,0,0,-15.23999,15.23999,250,270,14,22,-8,8,1.91666674613953,-1.91666674613953,0,0,0,2,0,0,-2,2,0,1778,-1778,1778
Karolina Kowalkiewicz,Jessica Penne,Jessica Penne,2021-08-07,0,1,-3,3,2.142857,1.75,-5.080002,5.080002,0,0,-7.619995,7.619995,26,193,22,22,0,0,0.392857074737549,-0.392857074737549,0,1,0,2,-1,1,-2,2,532,112,420,-420
Emily Ducote,Jessica Penne,Emily Ducote,2022-07-16,1,0,-11,11,1.5,1.75,-7.62001,7.62001,0,0,-10.15999,10.15999,0,0,20,22,-2,2,-0.25,0.25,0,2,0,2,-2,2,-2,2,0,343,-343,343
Julianna Pena,Jessica Rakoczy,Julianna Pena,2013-11-30,1,0,-12,12,2.4,0.2,-2.539993,2.539993,20,-20,2.259995,-2.259995,267,2,17,6,11,-11,2.2000000923872,-2.2000000923872,0,0,0,0,0,0,0,0,0,0,0,0
Valerie Letourneau,Jessica Rakoczy,Valerie Letourneau,2015-04-25,1,0,-7,7,1.333333,0.2,0,0,0,0,-0.2799988,0.2799988,55,378,14,6,8,-8,1.13333337008953,-1.13333337008953,1,0,0,1,1,-1,-1,1,315,511,-196,196
Sarah Alpar,Jessica-Rose Clark,Jessica-Rose Clark,2020-09-19,0,1,-3,3,1.5,1.222222,-2.540009,2.540009,0,0,3.25,-3.25,208,498,15,20,-5,5,0.277777791023254,-0.277777791023254,0,0,0,0,0,0,0,0,0,0,0,0
John Makdessi,Jesus Pinedo,John Makdessi,2019-03-23,1,0,11,-11,2,3.2,-5.080002,5.080002,0,0,-7.279999,7.279999,2,0,27,21,6,-6,-1.20000004768372,1.20000004768372,2,0,1,0,2,-2,1,-1,238,0,238,-238
Lucie Pudilova,Ji Yeon Kim,Lucie Pudilova,2017-06-17,1,0,-4,4,1.75,1.285714,2.540009,-2.540009,10,-10,-12.70001,12.70001,307,75,22,16,6,-6,0.464285731315613,-0.464285731315613,0,0,0,0,0,0,0,0,0,0,0,0
Justine Kish,Ji Yeon Kim,Ji Yeon Kim,2018-01-27,0,1,1,-1,1.75,1.285714,-5.079987,5.079987,0,0,-20.32001,20.32001,0,0,11,16,-5,5,0.464285731315613,-0.464285731315613,2,0,0,0,2,-2,0,0,414,224,190,-190
Melinda Fabian,Ji Yeon Kim,Ji Yeon Kim,2018-06-23,0,1,2,-2,1,1.285714,-2.539993,2.539993,0,0,-15.24001,15.24001,2,146,8,16,-8,8,-0.285714268684387,0.285714268684387,0,1,0,0,-1,1,0,0,0,147,-147,147
Antonina Shevchenko,Ji Yeon Kim,Antonina Shevchenko,2018-11-30,1,0,5,-5,2.5,1.285714,2.540009,-2.540009,0,0,-12.70001,12.70001,294,97,14,16,-2,2,1.21428573131561,-1.21428573131561,0,2,0,0,-2,2,0,0,0,160,-160,160
Nadia Kassem,Ji Yeon Kim,Ji Yeon Kim,2019-10-05,0,1,-6,6,2.5,1.285714,-5.079987,5.079987,0,0,-15.24001,15.24001,63,10,7,16,-9,9,1.21428573131561,-1.21428573131561,0,0,0,0,0,0,0,0,0,309,-309,309
Alexa Grasso,Ji Yeon Kim,Alexa Grasso,2020-08-29,1,0,-3,3,5.333333,1.285714,-5.079987,5.079987,0,0,-15.24001,15.24001,127,46,19,16,3,-3,4.04761922359467,-4.04761922359467,1,1,0,0,0,0,0,0,448,329,119,-119
Molly McCann,Ji Yeon Kim,Molly McCann,2021-09-04,1,0,0,0,2.166667,1.285714,-7.619995,7.619995,0,0,-25.40001,25.40001,47,155,19,16,3,-3,0.880952477455139,-0.880952477455139,0,0,0,0,0,0,0,0,210,371,-161,161
Priscila Cachoeira,Ji Yeon Kim,Priscila Cachoeira,2022-02-26,1,0,1,-1,2.4,1.285714,0,0,0,0,-17.78,17.78,27,5,17,16,1,-1,1.11428582668304,-1.11428582668304,0,0,0,0,0,0,0,0,77,175,-98,98
Joselyne Edwards,Ji Yeon Kim,Joselyne Edwards,2022-07-30,1,0,-6,6,2.6,1.285714,2.540009,-2.540009,10,-10,-5.080002,5.080002,121,19,18,16,2,-2,1.31428563594818,-1.31428563594818,1,0,0,0,1,-1,0,0,49,154,-105,105
Mandy Bohm,Ji Yeon Kim,Mandy Bohm,2023-05-13,1,0,0,0,4,1.285714,0,0,0,0,-2.540009,2.540009,245,344,10,16,-6,6,2.71428573131561,-2.71428573131561,0,0,0,0,0,0,0,0,294,287,7,-7
Guangyou Ning,Jianping Yang,Guangyou Ning,2014-08-23,1,0,7,-7,1.25,2.75,-7.619995,7.619995,0,0,-10.44,10.44,123,31,9,15,-6,6,-1.5,1.5,0,0,0,0,0,0,0,0,0,0,0,0
David Baron,Jim Miller,Jim Miller,2008-10-18,0,1,10,-10,4.25,2.117647,-5.080002,5.080002,0,0,1.020004,-1.020004,55,645,21,53,-32,32,2.13235282897949,-2.13235282897949,0,0,0,0,0,0,0,0,0,0,0,0
Gray Maynard,Jim Miller,Gray Maynard,2009-03-07,1,0,4,-4,1.857143,2.117647,2.539993,-2.539993,0,0,-2.539993,2.539993,125,86,20,53,-33,33,-0.260504364967346,0.260504364967346,2,1,0,0,1,-1,0,0,409,140,269,-269
Mac Danzig,Jim Miller,Jim Miller,2009-07-11,0,1,4,-4,1.75,2.117647,0,0,0,0,-2.539993,2.539993,28,628,33,53,-20,20,-0.367647171020508,0.367647171020508,0,0,0,0,0,0,0,0,154,126,28,-28
Steve Lopez,Jim Miller,Jim Miller,2009-09-19,0,1,-1,1,2.166667,2.117647,7.619995,-7.619995,0,0,2.660004,-2.660004,0,138,19,53,-34,34,4.90195751190186e-02,-4.90195751190186e-02,0,1,0,0,-1,1,0,0,0,70,-70,70
Duane Ludwig,Jim Miller,Jim Miller,2010-01-02,0,1,5,-5,1.5,2.117647,5.080002,-5.080002,15,-15,-2.539993,2.539993,21,15,35,53,-18,18,-0.617647171020508,0.617647171020508,1,2,0,0,-1,1,0,0,2444,105,2339,-2339
Mark Bocek,Jim Miller,Jim Miller,2010-03-27,0,1,2,-2,2.4,2.117647,0,0,0,0,10.16,-10.16,591,97,17,53,-36,36,0.282352924346924,-0.282352924346924,2,3,1,0,-1,1,1,-1,112,84,28,-28
Benson Henderson,Jim Miller,Benson Henderson,2011-08-14,1,0,0,0,3.428571,2.117647,2.539993,-2.539993,15,-15,-2.539993,2.539993,622,3,31,53,-22,22,1.31092429161072,-1.31092429161072,0,4,0,0,-4,4,0,0,0,505,-505,505
Melvin Guillard,Jim Miller,Jim Miller,2012-01-20,0,1,0,0,1.777778,2.117647,2.539993,-2.539993,0,0,0,0,1,59,50,53,-3,3,-0.339869379997253,0.339869379997253,0,0,0,0,0,0,0,0,104,159,-55,55
Nate Diaz,Jim Miller,Nate Diaz,2012-05-05,1,0,-1,1,1.692308,2.117647,10.16,-10.16,15,-15,12.7,-12.7,157,75,35,53,-18,18,-0.425339460372925,0.425339460372925,1,1,0,0,0,0,0,0,224,106,118,-118
Joe Lauzon,Jim Miller,Jim Miller,2012-12-29,0,1,-1,1,1.75,2.117647,5.080002,-5.080002,0,0,0,0,127,191,44,53,-9,9,-0.367647171020508,0.367647171020508,1,0,1,0,1,-1,1,-1,147,238,-91,91
Fabricio Camoes,Jim Miller,Jim Miller,2013-12-28,0,1,5,-5,1.555556,2.117647,5.080002,-5.080002,0,0,0,0,78,12,23,53,-30,30,-0.562091588973999,0.562091588973999,0,1,0,0,-1,1,0,0,539,364,175,-175
Yancy Medeiros,Jim Miller,Jim Miller,2014-04-26,0,1,-4,4,1.875,2.117647,5.080002,-5.080002,0,0,10.16,-10.16,24,29,23,53,-30,30,-0.242647171020508,0.242647171020508,0,2,0,0,-2,2,0,0,0,119,-119,119
Donald Cerrone,Jim Miller,Donald Cerrone,2014-07-16,1,0,1,-1,2.117647,2.117647,12.7,-12.7,0,0,5.080002,-5.080002,21,34,53,53,0,0,0,0,2,3,1,0,-1,1,1,-1,172,81,91,-91
Beneil Dariush,Jim Miller,Beneil Dariush,2015-04-18,1,0,-6,6,4.4,2.117647,5.080002,-5.080002,0,0,2.540009,-2.540009,719,16,27,53,-26,26,2.28235292434692,-2.28235292434692,2,0,1,1,2,-2,0,0,175,276,-101,101
Danny Castillo,Jim Miller,Jim Miller,2015-07-25,0,1,4,-4,1.7,2.117647,2.539993,-2.539993,0,0,0,0,140,130,27,53,-26,26,-0.417647123336792,0.417647123336792,0,0,2,1,0,0,1,-1,203,98,105,-105
Michael Chiesa,Jim Miller,Michael Chiesa,2015-12-10,1,0,-4,4,2.571429,2.117647,12.7,-12.7,15,-15,10.16,-10.16,253,147,25,53,-28,28,0.453781366348267,-0.453781366348267,1,1,1,1,0,0,0,0,250,138,112,-112
Takanori Gomi,Jim Miller,Jim Miller,2016-07-09,0,1,5,-5,2.5,2.117647,-2.540009,2.540009,0,0,-2.539993,2.539993,0,93,49,53,-4,4,0.382352828979492,-0.382352828979492,0,0,2,1,0,0,1,-1,350,212,138,-138
Joe Lauzon,Jim Miller,Jim Miller,2016-08-27,0,1,0,0,1.75,2.117647,5.080002,-5.080002,0,0,0,0,372,8,44,53,-9,9,-0.367647171020508,0.367647171020508,1,1,1,1,0,0,0,0,49,49,0,0
Thiago Alves,Jim Miller,Jim Miller,2016-11-12,0,1,0,0,1.533333,2.117647,2.539993,-2.539993,15,-15,-2.539993,2.539993,33,384,38,53,-15,15,-0.584313869476318,0.584313869476318,0,2,2,1,-2,2,1,-1,532,77,455,-455
Dan Hooker,Jim Miller,Dan Hooker,2018-04-21,1,0,-6,6,1.916667,2.117647,10.16,-10.16,0,0,10.16,-10.16,13,27,35,53,-18,18,-0.200980544090271,0.200980544090271,1,3,0,1,-2,2,-1,1,315,525,-210,210
Jason Gonzalez,Jim Miller,Jim Miller,2019-04-27,0,1,-6,6,2.2,2.117647,15.24001,-15.24001,0,0,7.62001,-7.62001,0,52,16,53,-37,37,8.2352876663208e-02,-8.2352876663208e-02,0,0,0,2,0,0,-2,2,0,371,-371,371
Clay Guida,Jim Miller,Jim Miller,2019-08-03,0,1,2,-2,1.9,2.117647,-2.540009,2.540009,0,0,-2.539993,2.539993,11,0,58,53,5,-5,-0.217647194862366,0.217647194862366,1,1,2,2,0,0,0,0,84,98,-14,14
Scott Holtzman,Jim Miller,Scott Holtzman,2020-02-15,1,0,0,0,2.333333,2.117647,2.539993,-2.539993,0,0,-5.080002,5.080002,297,27,20,53,-33,33,0.215686082839966,-0.215686082839966,1,2,0,2,-1,1,-2,2,196,196,0,0
Erick Gonzalez,Jim Miller,Jim Miller,2021-10-16,0,1,-9,9,1.75,2.117647,7.619995,-7.619995,0,0,10.16,-10.16,62,115,22,53,-31,31,-0.367647171020508,0.367647171020508,0,0,0,2,0,0,-2,2,0,609,-609,609
Donald Cerrone,Jim Miller,Jim Miller,2022-07-02,0,1,1,-1,2.117647,2.117647,12.7,-12.7,0,0,5.080002,-5.080002,84,63,53,53,0,0,0,0,0,1,8,2,-1,1,6,-6,420,259,161,-161
Alexander Hernandez,Jim Miller,Alexander Hernandez,2023-02-18,1,0,-9,9,2.333333,2.117647,2.539993,-2.539993,-10,10,2.540009,-2.540009,23,40,20,53,-33,33,0.215686082839966,-0.215686082839966,0,2,1,2,-2,2,-1,1,70,231,-161,161
Jesse Butler,Jim Miller,Jim Miller,2023-06-03,0,1,-8,8,2.4,2.117647,5.080002,-5.080002,-10,10,5.080002,-5.080002,0,0,17,53,-36,36,0.282352924346924,-0.282352924346924,0,0,0,2,0,0,-2,2,0,105,-105,105
Scott Ferrozzo,Jim Mullen,Scott Ferrozzo,1997-02-07,1,0,,,2,0,-5.080002,5.080002,108,-108,-10,10,0,0,6,2,4,-4,2,-2,1,0,0,0,1,-1,0,0,140,0,140,-140
Jessin Ayari,Jim Wallhead,Jessin Ayari,2016-09-03,1,0,-8,8,2.666667,2.636364,5.080002,-5.080002,-15,15,5.419998,-5.419998,11,34,22,40,-18,18,3.03030014038086e-02,-3.03030014038086e-02,0,0,0,0,0,0,0,0,0,0,0,0
Luan Chagas,Jim Wallhead,Luan Chagas,2017-06-03,1,0,-10,10,5,2.636364,5.080002,-5.080002,0,0,10.5,-10.5,19,7,18,40,-22,22,2.36363625526428,-2.36363625526428,0,0,0,0,0,0,0,0,252,273,-21,21
Kyle Kingsbury,Jimi Manuwa,Jimi Manuwa,2012-09-29,0,1,-2,2,1.833333,2.833333,7.619995,-7.619995,0,0,0,0,310,51,17,23,-6,6,-0.99999988079071,0.99999988079071,0,0,0,0,0,0,0,0,126,0,126,-126
Cyrille Diabate,Jimi Manuwa,Jimi Manuwa,2013-02-16,0,1,7,-7,1.9,2.833333,12.7,-12.7,0,0,5.080002,-5.080002,19,142,29,23,6,-6,-0.933333277702332,0.933333277702332,1,1,0,0,0,0,0,0,91,140,-49,49
Ryan Jimmo,Jimi Manuwa,Jimi Manuwa,2013-10-26,0,1,-2,2,3.8,2.833333,0,0,0,0,-15.24001,15.24001,182,95,24,23,1,-1,0.966666698455811,-0.966666698455811,1,2,0,0,-1,1,0,0,133,252,-119,119
Alexander Gustafsson,Jimi Manuwa,Alexander Gustafsson,2014-03-08,1,0,-7,7,2.25,2.833333,10.16,-10.16,0,0,0,0,203,0,26,23,3,-3,-0.583333253860474,0.583333253860474,0,3,0,0,-3,3,0,0,168,133,35,-35
Jan Blachowicz,Jimi Manuwa,Jimi Manuwa,2015-04-11,0,1,-3,3,2.9,2.833333,2.540009,-2.540009,0,0,-2.540009,2.540009,29,343,39,23,16,-16,6.6666841506958e-02,-6.6666841506958e-02,1,0,0,1,1,-1,-1,1,189,399,-210,210
Anthony Johnson,Jimi Manuwa,Anthony Johnson,2015-09-05,1,0,-4,4,3.666667,2.833333,2.540009,-2.540009,0,0,-2.540009,2.540009,202,51,28,23,5,-5,0.833333492279053,-0.833333492279053,1,1,0,1,0,0,-1,1,406,147,259,-259
Corey Anderson,Jimi Manuwa,Jimi Manuwa,2017-03-18,0,1,-10,10,2.8,2.833333,5.080002,-5.080002,0,0,0,0,0,1,19,23,-4,4,-3.33333015441895e-02,3.33333015441895e-02,1,0,1,2,1,-1,-1,1,99,560,-461,461
Jan Blachowicz,Jimi Manuwa,Jan Blachowicz,2018-03-17,1,0,-3,3,2.9,2.833333,2.540009,-2.540009,0,0,-2.540009,2.540009,172,2,39,23,16,-16,6.6666841506958e-02,-6.6666841506958e-02,2,1,0,2,1,-1,-2,2,91,364,-273,273
Marcus Brimage,Jimmie Rivera,Jimmie Rivera,2015-07-18,0,1,4,-4,1,4.6,0,0,0,0,7.619995,-7.619995,0,1,14,28,-14,14,-3.59999990463257,3.59999990463257,0,0,2,0,0,0,2,-2,196,0,196,-196
Pedro Munhoz,Jimmie Rivera,Jimmie Rivera,2015-11-07,0,1,3,-3,2.5,4.6,5.080002,-5.080002,0,0,-7.619995,7.619995,9,9,28,28,0,0,-2.09999990463257,2.09999990463257,0,1,0,0,-1,1,0,0,0,112,-112,112
Iuri Alcantara,Jimmie Rivera,Jimmie Rivera,2016-01-30,0,1,9,-9,3.5,4.6,12.7,-12.7,0,0,7.619995,-7.619995,1,132,45,28,17,-17,-1.09999990463257,1.09999990463257,1,2,0,0,-1,1,0,0,182,84,98,-98
Urijah Faber,Jimmie Rivera,Jimmie Rivera,2016-09-10,0,1,10,-10,3.181818,4.6,5.080002,-5.080002,0,0,-2.540009,2.540009,0,0,46,28,18,-18,-1.41818165779114,1.41818165779114,6,3,0,0,3,-3,0,0,273,224,49,-49
Thomas Almeida,Jimmie Rivera,Jimmie Rivera,2017-07-22,0,1,-3,3,4.4,4.6,7.619995,-7.619995,10,-10,5.080002,-5.080002,16,106,27,28,-1,1,-0.199999809265137,0.199999809265137,1,4,1,0,-3,3,1,-1,245,315,-70,70
Marlon Moraes,Jimmie Rivera,Marlon Moraes,2018-06-01,1,0,2,-2,2.3,4.6,5.080002,-5.080002,0,0,-2.540009,2.540009,0,0,33,28,5,-5,-2.29999995231628,2.29999995231628,1,5,0,0,-4,4,0,0,174,314,-140,140
John Dodson,Jimmie Rivera,Jimmie Rivera,2018-09-08,0,1,4,-4,1.833333,4.6,-2.539993,2.539993,0,0,-5.080002,5.080002,2,4,34,28,6,-6,-2.76666653156281,2.76666653156281,1,0,0,1,1,-1,-1,1,189,99,90,-90
Pedro Munhoz,Jimmie Rivera,Pedro Munhoz,2021-02-27,1,0,3,-3,2.5,4.6,5.080002,-5.080002,0,0,-7.619995,7.619995,3,4,28,28,0,0,-2.09999990463257,2.09999990463257,0,1,0,1,-1,1,-1,1,630,903,-273,273
Paul Craig,Jimmy Crute,Jimmy Crute,2018-12-01,0,1,9,-9,2.833333,3,2.539993,-2.539993,-20,20,5.079987,-5.079987,258,505,23,16,7,-7,-0.166666746139526,0.166666746139526,0,0,2,0,0,0,2,-2,503,0,503,-503
Sam Alvey,Jimmy Crute,Jimmy Crute,2019-02-09,0,1,10,-10,1.833333,3,0,0,-20,20,2.539993,-2.539993,0,8,51,16,35,-35,-1.16666662693024,1.16666662693024,0,1,2,0,-1,1,2,-2,140,70,70,-70
Misha Cirkunov,Jimmy Crute,Misha Cirkunov,2019-09-14,1,0,9,-9,1.666667,3,2.539993,-2.539993,0,0,7.619995,-7.619995,150,44,24,16,8,-8,-1.33333337306976,1.33333337306976,0,2,3,0,-2,2,3,-3,196,217,-21,21
Modestas Bukauskas,Jimmy Crute,Jimmy Crute,2020-10-17,0,1,2,-2,3,3,2.539993,-2.539993,0,0,10.15999,-10.15999,0,25,20,16,4,-4,0,0,1,0,0,0,1,-1,0,0,94,399,-305,305
Cody Durden,Jimmy Flick,Jimmy Flick,2020-12-19,0,1,-1,1,4,2.285714,0,0,0,0,-2.540009,2.540009,81,0,20,23,-3,3,1.71428561210632,-1.71428561210632,0,0,0,0,0,0,0,0,0,0,0,0
Alessandro Costa,Jimmy Flick,Alessandro Costa,2023-06-17,1,0,-5,5,4.333333,2.285714,-7.619995,7.619995,0,0,-2.540009,2.540009,50,14,16,23,-7,7,2.04761910438538,-2.04761910438538,0,1,0,0,-1,1,0,0,0,910,-910,910
Dylan Andrews,Jimmy Quinlan,Dylan Andrews,2013-04-13,1,0,7,-7,2.571429,3,2.539993,-2.539993,0,0,2.960007,-2.960007,8,167,25,4,21,-21,-0.428571462631226,0.428571462631226,0,0,0,0,0,0,0,0,0,0,0,0
Alex Caceres,Jimy Hettes,Jimy Hettes,2011-08-14,0,1,-1,1,1.5,3.666667,2.540009,-2.540009,0,0,5.080002,-5.080002,131,271,35,14,21,-21,-2.16666674613953,2.16666674613953,0,0,0,0,0,0,0,0,141,0,141,-141
Marcus Brimage,Jimy Hettes,Marcus Brimage,2012-09-22,1,0,2,-2,1,3.666667,-12.7,12.7,-10,10,0,0,15,155,14,14,0,0,-2.66666674613953,2.66666674613953,0,1,0,0,-1,1,0,0,0,405,-405,405
Dennis Bermudez,Jimy Hettes,Dennis Bermudez,2014-03-15,1,0,1,-1,1.888889,3.666667,-7.619995,7.619995,10,-10,-12.7,12.7,467,87,26,14,12,-12,-1.77777791023254,1.77777791023254,5,0,0,0,5,-5,0,0,129,539,-410,410
Diego Brandao,Jimy Hettes,Diego Brandao,2015-04-18,1,0,0,0,2,3.666667,-5.080002,5.080002,0,0,-17.78,17.78,145,59,33,14,19,-19,-1.66666674613953,1.66666674613953,0,0,2,1,0,0,1,-1,273,399,-126,126
Mario Bautista,Jin Soo Son,Mario Bautista,2019-07-20,1,0,0,0,6.5,2.25,7.619995,-7.619995,0,0,0,0,55,98,15,13,2,-2,4.25,-4.25,0,0,0,0,0,0,0,0,182,0,182,-182
Kay Hansen,Jinh Yu Frey,Kay Hansen,2020-06-27,1,0,-15,15,1.166667,1.222222,-2.540009,2.540009,0,0,-5.080002,5.080002,271,7,13,20,-7,7,-5.55555820465088e-02,5.55555820465088e-02,0,0,0,0,0,0,0,0,0,0,0,0
Loma Lookboonmee,Jinh Yu Frey,Loma Lookboonmee,2020-10-03,1,0,-11,11,2.666667,1.222222,-5.080002,5.080002,0,0,-10.16,10.16,83,154,11,20,-9,9,1.44444453716278,-1.44444453716278,0,0,0,0,0,0,0,0,0,98,-98,98
Gloria de Paula,Jinh Yu Frey,Jinh Yu Frey,2021-03-13,0,1,-10,10,1.2,1.222222,5.080002,-5.080002,0,0,5.079987,-5.079987,5,573,11,20,-9,9,-2.22221612930298e-02,2.22221612930298e-02,0,0,0,0,0,0,0,0,0,161,-161,161
Ashley Yoder,Jinh Yu Frey,Jinh Yu Frey,2021-07-31,0,1,-3,3,1,1.222222,10.15999,-10.15999,0,0,10.15999,-10.15999,41,2,16,20,-4,4,-0.222222208976746,0.222222208976746,0,1,0,0,-1,1,0,0,0,140,-140,140
Vanessa Demopoulos,Jinh Yu Frey,Vanessa Demopoulos,2022-06-25,1,0,-4,4,1.8,1.222222,-2.540009,2.540009,0,0,-15.24001,15.24001,254,11,14,20,-6,6,0.577777743339539,-0.577777743339539,1,2,0,0,-1,1,0,0,154,329,-175,175
Polyana Viana,Jinh Yu Frey,Polyana Viana,2022-11-05,1,0,-7,7,2.166667,1.222222,5.080002,-5.080002,0,0,5.079987,-5.079987,0,0,19,20,-1,1,0.944444537162781,-0.944444537162781,1,0,0,0,1,-1,0,0,798,133,665,-665
Elise Reed,Jinh Yu Frey,Elise Reed,2023-06-03,1,0,-8,8,1.75,1.222222,0,0,0,0,-5.080002,5.080002,89,249,11,20,-9,9,0.527777791023254,-0.527777791023254,0,0,0,1,0,0,-1,1,0,210,-210,210
Volkan Oezdemir,Jiri Prochazka,Jiri Prochazka,2020-07-11,0,1,3,-3,2.714286,9.666667,-2.539993,2.539993,0,0,-12.7,12.7,17,2,26,32,-6,6,-6.95238137245178,6.95238137245178,1,0,0,0,1,-1,0,0,203,0,203,-203
Gadzhimurad Antigulov,Joachim Christensen,Gadzhimurad Antigulov,2017-05-13,1,0,-8,8,2.5,2.333333,-10.16,10.16,0,0,-15.23999,15.23999,119,0,28,20,8,-8,0.166666746139526,-0.166666746139526,1,0,0,0,1,-1,0,0,175,0,175,-175
Bill Algeo,Joanderson Brito,Bill Algeo,2022-01-15,1,0,6,-6,2.428571,5,10.16,-10.16,0,0,2.539993,-2.539993,302,294,24,18,6,-6,-2.57142853736877,2.57142853736877,0,0,0,0,0,0,0,0,238,0,238,-238
Lucas Alexander,Joanderson Brito,Joanderson Brito,2022-10-15,0,1,0,0,2.666667,5,7.619995,-7.619995,0,0,2.539993,-2.539993,0,85,11,18,-7,7,-2.33333325386047,2.33333325386047,0,0,0,0,0,0,0,0,0,273,-273,273
Claudia Gadelha,Joanna Jedrzejczyk,Joanna Jedrzejczyk,2014-12-13,0,1,-1,1,3.6,3.2,-5.080002,5.080002,0,0,-5.080002,5.080002,526,67,23,21,2,-2,0.399999856948853,-0.399999856948853,1,0,0,0,1,-1,0,0,150,0,150,-150
Carla Esparza,Joanna Jedrzejczyk,Joanna Jedrzejczyk,2015-03-14,0,1,0,0,2.857143,3.2,-12.7,12.7,0,0,-5.080002,5.080002,67,28,27,21,6,-6,-0.342857122421265,0.342857122421265,1,1,0,0,0,0,0,0,92,91,1,-1
Claudia Gadelha,Joanna Jedrzejczyk,Joanna Jedrzejczyk,2016-07-08,0,1,-1,1,3.6,3.2,-5.080002,5.080002,0,0,-5.080002,5.080002,571,91,23,21,2,-2,0.399999856948853,-0.399999856948853,0,2,0,0,-2,2,0,0,573,482,91,-91
Jessica Andrade,Joanna Jedrzejczyk,Joanna Jedrzejczyk,2017-05-13,0,1,-4,4,2,3.2,-12.7,12.7,0,0,-7.62001,7.62001,211,16,36,21,15,-15,-1.20000004768372,1.20000004768372,3,3,1,0,0,0,1,-1,98,309,-211,211
Seo Hee Ham,Joanne Wood,Joanne Wood,2014-12-12,0,1,-1,1,2.125,2,-10.16,10.16,-10,10,-7.62001,7.62001,42,340,25,24,1,-1,0.125,-0.125,0,0,0,0,0,0,0,0,0,0,0,0
Maryna Moroz,Joanne Wood,Maryna Moroz,2015-04-11,1,0,-6,6,2.2,2,2.539993,-2.539993,0,0,5.079987,-5.079987,11,16,16,24,-8,8,0.200000047683716,-0.200000047683716,0,1,0,0,-1,1,0,0,0,120,-120,120
Cortney Casey,Joanne Wood,Joanne Wood,2015-07-18,0,1,-1,1,1,2,2.539993,-2.539993,0,0,5.079987,-5.079987,0,647,20,24,-4,4,-1,1,0,0,0,0,0,0,0,0,0,98,-98,98
Valerie Letourneau,Joanne Wood,Joanne Wood,2016-06-18,0,1,3,-3,1.333333,2,2.539993,-2.539993,-10,10,7.619995,-7.619995,35,256,14,24,-10,10,-0.666666626930237,0.666666626930237,3,1,0,0,2,-2,0,0,300,336,-36,36
Jessica Andrade,Joanne Wood,Jessica Andrade,2016-09-10,1,0,-6,6,2,2,-12.7,12.7,-10,10,-7.62001,7.62001,209,12,36,24,12,-12,0,0,1,2,1,0,-1,1,1,-1,98,84,14,-14
Cynthia Calvillo,Joanne Wood,Cynthia Calvillo,2017-07-16,1,0,-1,1,1.5,2,-5.080002,5.080002,-10,10,-2.540009,2.540009,63,17,15,24,-9,9,-0.5,0.5,2,0,0,0,2,-2,0,0,99,309,-210,210
Kalindra Faria,Joanne Wood,Joanne Wood,2018-08-25,0,1,0,0,2.25,2,2.539993,-2.539993,0,0,7.899994,-7.899994,284,0,26,24,2,-2,0.25,-0.25,0,0,0,0,0,0,0,0,322,405,-83,83
Ariane Lipski,Joanne Wood,Joanne Wood,2019-01-19,0,1,-9,9,2,2,0,0,0,0,5.079987,-5.079987,198,276,24,24,0,0,0,0,0,1,0,0,-1,1,0,0,0,147,-147,147
Katlyn Chookagian,Joanne Wood,Katlyn Chookagian,2019-06-08,1,0,-3,3,3.6,2,7.619995,-7.619995,0,0,7.619995,-7.619995,0,129,23,24,-1,1,1.59999990463257,-1.59999990463257,0,2,0,0,-2,2,0,0,182,140,42,-42
Andrea Lee,Joanne Wood,Joanne Wood,2019-09-07,0,1,-3,3,1.625,2,0,0,0,0,10.15999,-10.15999,259,133,21,24,-3,3,-0.375,0.375,0,0,0,0,0,0,0,0,0,91,-91,91
Jennifer Maia,Joanne Wood,Jennifer Maia,2020-08-01,1,0,-3,3,2.333333,2,-5.080002,5.080002,0,0,-2.540009,2.540009,0,131,30,24,6,-6,0.333333253860474,-0.333333253860474,1,1,0,0,0,0,0,0,378,329,49,-49
Jessica Eye,Joanne Wood,Joanne Wood,2021-01-23,0,1,-1,1,1.363636,2,0,0,0,0,2.539993,-2.539993,303,19,26,24,2,-2,-0.636363625526428,0.636363625526428,0,0,1,0,0,0,1,-1,595,175,420,-420
Lauren Murphy,Joanne Wood,Lauren Murphy,2021-06-12,1,0,2,-2,2.666667,2,-2.539993,2.539993,0,0,5.079987,-5.079987,294,6,22,24,-2,2,0.666666746139526,-0.666666746139526,2,1,0,0,1,-1,0,0,231,140,91,-91
Taila Santos,Joanne Wood,Taila Santos,2021-11-20,1,0,-7,7,6.333333,2,0,0,0,0,7.619995,-7.619995,77,0,22,24,-2,2,4.33333349227905,-4.33333349227905,0,0,0,0,0,0,0,0,0,161,-161,161
Alexa Grasso,Joanne Wood,Alexa Grasso,2022-03-26,1,0,-8,8,5.333333,2,-2.539993,2.539993,0,0,2.539993,-2.539993,135,0,19,24,-5,5,3.33333349227905,-3.33333349227905,2,0,0,0,2,-2,0,0,574,126,448,-448
Luana Carolina,Joanne Wood,Joanne Wood,2023-03-18,0,1,-8,8,2.25,2,0,0,0,0,10.15999,-10.15999,42,110,13,24,-11,11,0.25,-0.25,0,0,1,0,0,0,1,-1,364,357,7,-7
Yves Edwards,Joao Pierini,Yves Edwards,2002-06-22,1,0,-5,5,1.909091,4,-10.16,10.16,0,0,-2.580002,2.580002,9,0,64,5,59,-59,-2.09090912342072,2.09090912342072,0,0,0,0,0,0,0,0,43,0,43,-43
Jens Pulver,Joao Roque,Jens Pulver,2000-06-09,1,0,-3,3,1.421053,3.5,2.539993,-2.539993,-10,10,7.800003,-7.800003,133,16,46,9,37,-37,-2.07894742488861,2.07894742488861,1,0,0,0,1,-1,0,0,91,0,91,-91
Rafael Natal,Joao Zeferino,Rafael Natal,2013-05-18,1,0,3,-3,2.333333,2.333333,2.540009,-2.540009,15,-15,12.58,-12.58,292,21,30,30,0,0,0,0,1,0,0,0,1,-1,0,0,112,0,112,-112
Elias Silverio,Joao Zeferino,Elias Silverio,2013-09-04,1,0,-1,1,4.333333,2.333333,0,0,-15,15,2.419998,-2.419998,280,367,16,30,-14,14,2.00000023841858,-2.00000023841858,0,0,0,0,0,0,0,0,0,109,-109,109
Nazareno Malegarie,Joaquim Silva,Joaquim Silva,2015-09-05,0,1,3,-3,7,2.4,0,0,0,0,2.740005,-2.740005,48,9,32,17,15,-15,4.59999990463257,-4.59999990463257,0,0,0,0,0,0,0,0,0,0,0,0
Andrew Holbrook,Joaquim Silva,Joaquim Silva,2016-07-08,0,1,3,-3,4,2.4,7.619995,-7.619995,0,0,2.540009,-2.540009,0,3,15,17,-2,2,1.59999990463257,-1.59999990463257,1,1,0,0,0,0,0,0,349,307,42,-42
Reza Madadi,Joaquim Silva,Joaquim Silva,2017-05-28,0,1,10,-10,2.333333,2.4,7.619995,-7.619995,0,0,10.16,-10.16,338,121,20,17,3,-3,-6.6666841506958e-02,6.6666841506958e-02,0,2,0,0,-2,2,0,0,582,324,258,-258
Vinc Pichel,Joaquim Silva,Vinc Pichel,2018-01-27,1,0,7,-7,4.666667,2.4,5.080002,-5.080002,0,0,7.62001,-7.62001,49,0,17,17,0,0,2.26666641235352,-2.26666641235352,1,3,0,0,-2,2,0,0,1473,244,1229,-1229
Jared Gordon,Joaquim Silva,Joaquim Silva,2018-12-15,0,1,1,-1,3.166667,2.4,2.539993,-2.539993,0,0,-2.539993,2.539993,265,39,25,17,8,-8,0.766666650772095,-0.766666650772095,1,0,0,0,1,-1,0,0,538,322,216,-216
Nasrat Haqparast,Joaquim Silva,Nasrat Haqparast,2019-08-03,1,0,-7,7,3,2.4,5.080002,-5.080002,0,0,7.62001,-7.62001,3,0,20,17,3,-3,0.599999904632568,-0.599999904632568,0,1,0,0,-1,1,0,0,651,231,420,-420
Ricky Glenn,Joaquim Silva,Ricky Glenn,2021-06-19,1,0,0,0,3.142857,2.4,10.16,-10.16,0,0,2.540009,-2.540009,8,0,29,17,12,-12,0.742856979370117,-0.742856979370117,0,0,0,1,0,0,-1,1,1267,686,581,-581
Jesse Ronson,Joaquim Silva,Joaquim Silva,2022-10-01,0,1,3,-3,1.75,2.4,5.080002,-5.080002,0,0,2.540009,-2.540009,0,11,33,17,16,-16,-0.650000095367432,0.650000095367432,0,0,0,2,0,0,-2,2,3150,469,2681,-2681
Antonio Arroyo,Joaquin Buckley,Joaquin Buckley,2021-09-18,0,1,5,-5,1.8,2.666667,12.7,-12.7,15,-15,-7.619995,7.619995,24,78,14,22,-8,8,-0.866666793823242,0.866666793823242,0,0,0,0,0,0,0,0,273,0,273,-273
Wilson Reis,Joby Sanchez,Wilson Reis,2014-08-23,1,0,6,-6,2.3,2.75,-5.080002,5.080002,-10,10,-7.619995,7.619995,395,16,33,15,18,-18,-0.450000047683716,0.450000047683716,0,0,0,0,0,0,0,0,0,0,0,0
Tateki Matsuda,Joby Sanchez,Joby Sanchez,2015-01-18,0,1,5,-5,1.625,2.75,2.539993,-2.539993,-10,10,-6.720001,6.720001,4,147,21,15,6,-6,-1.125,1.125,0,0,0,0,0,0,0,0,0,148,-148,148
Geane Herrera,Joby Sanchez,Geane Herrera,2015-12-11,1,0,1,-1,3,2.75,-2.539993,2.539993,-10,10,-5.080002,5.080002,8,0,12,15,-3,3,0.25,-0.25,0,1,0,0,-1,1,0,0,0,327,-327,327
Robert Sanchez,Joby Sanchez,Robert Sanchez,2018-02-18,1,0,5,-5,4,2.75,0,0,-10,10,-5.080002,5.080002,90,0,10,15,-5,5,1.25,-1.25,0,0,0,1,0,0,-1,1,0,800,-800,800
Mark De La Rosa,Joby Sanchez,Mark De La Rosa,2018-11-10,1,0,-3,3,2.2,2.75,0,0,0,0,-7.619995,7.619995,113,80,16,15,1,-1,-0.549999952316284,0.549999952316284,1,0,0,1,1,-1,-1,1,119,265,-146,146
Jessica Aguilar,Jodie Esquibel,Jessica Aguilar,2018-07-14,1,0,4,-4,2.5,1,5.080002,-5.080002,0,0,-2.539993,2.539993,94,87,28,12,16,-16,1.5,-1.5,0,0,0,0,0,0,0,0,427,0,427,-427
Hannah Cifers,Jodie Esquibel,Hannah Cifers,2019-08-17,1,0,-6,6,1.428571,1,0,0,0,0,-5.080002,5.080002,11,195,17,12,5,-5,0.428571462631226,-0.428571462631226,1,0,0,0,1,-1,0,0,168,399,-231,231
Mark Bocek,Joe Brammer,Mark Bocek,2009-12-05,1,0,2,-2,2.4,2.333333,0,0,0,0,15.5,-15.5,133,5,17,10,7,-7,6.6666841506958e-02,-6.6666841506958e-02,1,0,1,0,1,-1,1,-1,385,0,385,-385
Scott Bessac,Joe Charles,Joe Charles,1995-12-16,0,1,,,0.6666667,0.4615385,7.619995,-7.619995,-15,15,15,-15,0,0,10,19,-9,9,0.205128222703934,-0.205128222703934,1,0,0,0,1,-1,0,0,99,0,99,-99
Vitor Belfort,Joe Charles,Vitor Belfort,1997-12-21,1,0,,,1.857143,0.4615385,-2.539993,2.539993,-75,75,6.960007,-6.960007,0,0,40,19,21,-21,1.39560434222221,-1.39560434222221,0,1,1,0,-1,1,1,-1,65,736,-671,671
Patrick Cote,Joe Doerksen,Joe Doerksen,2005-04-16,0,1,-2,2,2.090909,3.1875,-2.540009,2.540009,-15,15,0,0,281,327,34,67,-33,33,-1.09659099578857,1.09659099578857,0,0,0,0,0,0,0,0,176,0,176,-176
Mitch Clarke,Joe Duffy,Joe Duffy,2016-07-07,0,1,2,-2,2.2,3.2,0,0,0,0,0,0,0,15,16,21,-5,5,-1,1,2,0,0,0,2,-2,0,0,775,0,775,-775
Marc Diakiese,Joe Duffy,Marc Diakiese,2019-03-16,1,0,-5,5,2.285714,3.2,0,0,0,0,0,0,267,35,23,21,2,-2,-0.914285659790039,0.914285659790039,0,1,0,0,-1,1,0,0,237,982,-745,745
Joel Alvarez,Joe Duffy,Joel Alvarez,2020-07-18,1,0,-5,5,6.666667,3.2,12.7,-12.7,0,0,10.16,-10.16,0,9,23,21,2,-2,3.46666646003723,-3.46666646003723,1,0,0,0,1,-1,0,0,413,490,-77,77
Bryan Barberena,Joe Ellenberger,Bryan Barberena,2014-12-13,1,0,-4,4,1.636364,7.5,7.62001,-7.62001,15,-15,0,0,144,138,29,17,12,-12,-5.86363637447357,5.86363637447357,0,0,0,0,0,0,0,0,0,0,0,0
Hermes Franca,Joe Jordan,Hermes Franca,2006-07-08,1,0,4,-4,1.411765,3.5,0,0,0,0,10.34,-10.34,82,67,41,63,-22,22,-2.08823525905609,2.08823525905609,0,0,0,0,0,0,0,0,889,0,889,-889
Kenny Florian,Joe Lauzon,Kenny Florian,2008-04-02,1,0,8,-8,2.333333,1.75,0,0,-10,10,7.62001,-7.62001,224,111,20,44,-24,24,0.583333253860474,-0.583333253860474,3,0,1,0,3,-3,1,-1,196,0,196,-196
Kyle Bradley,Joe Lauzon,Joe Lauzon,2008-09-17,0,1,2,-2,1.583333,1.75,-2.540009,2.540009,0,0,0,0,2,37,31,44,-13,13,-0.166666626930237,0.166666626930237,0,0,1,1,0,0,0,0,228,168,60,-60
Melvin Guillard,Joe Lauzon,Joe Lauzon,2011-10-08,0,1,1,-1,1.777778,1.75,-2.540009,2.540009,0,0,0,0,0,19,50,44,6,-6,2.77777910232544e-02,-2.77777910232544e-02,6,1,0,1,5,-5,-1,1,98,1116,-1018,1018
Michael Johnson,Joe Lauzon,Michael Johnson,2013-08-17,1,0,-2,2,1.157895,1.75,0,0,0,0,5.080002,-5.080002,61,28,41,44,-3,3,-0.592105269432068,0.592105269432068,0,2,0,1,-2,2,-1,1,133,679,-546,546
Mac Danzig,Joe Lauzon,Joe Lauzon,2013-12-14,0,1,4,-4,1.75,1.75,-5.080002,5.080002,0,0,-2.539993,2.539993,154,416,33,44,-11,11,0,0,0,0,1,1,0,0,0,0,140,119,21,-21
Michael Chiesa,Joe Lauzon,Joe Lauzon,2014-09-05,0,1,-4,4,2.571429,1.75,7.619995,-7.619995,15,-15,10.16,-10.16,82,164,25,44,-19,19,0.821428537368774,-0.821428537368774,2,1,0,1,1,-1,-1,1,104,265,-161,161
Al Iaquinta,Joe Lauzon,Al Iaquinta,2015-01-31,1,0,-3,3,2,1.75,0,0,0,0,-2.539993,2.539993,22,7,21,44,-23,23,0.25,-0.25,2,2,0,1,0,0,-1,1,85,148,-63,63
Takanori Gomi,Joe Lauzon,Joe Lauzon,2015-07-25,0,1,5,-5,2.5,1.75,-7.62001,7.62001,0,0,-2.539993,2.539993,0,67,49,44,5,-5,0.75,-0.75,0,0,1,2,0,0,-1,1,308,175,133,-133
Evan Dunham,Joe Lauzon,Evan Dunham,2015-12-11,1,0,2,-2,2,1.75,0,0,0,0,-2.539993,2.539993,110,15,27,44,-17,17,0.25,-0.25,2,1,1,2,1,-1,-1,1,146,139,7,-7
Marcin Held,Joe Lauzon,Joe Lauzon,2017-01-15,0,1,-8,8,3.285714,1.75,-2.540009,2.540009,0,0,0,0,491,97,30,44,-14,14,1.53571438789368,-1.53571438789368,0,0,0,2,0,0,-2,2,71,401,-330,330
Clay Guida,Joe Lauzon,Clay Guida,2017-11-11,1,0,2,-2,1.9,1.75,-7.62001,7.62001,0,0,-2.539993,2.539993,33,0,58,44,14,-14,0.149999976158142,-0.149999976158142,1,1,2,2,0,0,0,0,139,300,-161,161
Chris Gruetzemacher,Joe Lauzon,Chris Gruetzemacher,2018-04-07,1,0,-2,2,3,1.75,-5.080002,5.080002,0,0,-7.619995,7.619995,98,0,20,44,-24,24,1.25,-1.25,0,0,0,3,0,0,-3,3,119,147,-28,28
Jeremy Larsen,Joe Proctor,Joe Proctor,2012-06-01,0,1,2,-2,1.6,2.2,0,0,-10,10,-5.080002,5.080002,0,5,13,16,-3,3,-0.600000023841858,0.600000023841858,0,0,0,0,0,0,0,0,0,0,0,0
Ramsey Nijem,Joe Proctor,Ramsey Nijem,2012-12-08,1,0,-3,3,1.5,2.2,2.539993,-2.539993,0,0,7.619995,-7.619995,473,147,15,16,-1,1,-0.700000047683716,0.700000047683716,0,1,0,0,-1,1,0,0,0,190,-190,190
Cristiano Marcello,Joe Proctor,Joe Proctor,2014-02-15,0,1,8,-8,2.166667,2.2,-2.540009,2.540009,0,0,0,0,202,41,19,16,3,-3,-3.33333015441895e-02,3.33333015441895e-02,0,0,1,0,0,0,1,-1,350,434,-84,84
Yancy Medeiros,Joe Proctor,Yancy Medeiros,2014-12-12,1,0,-2,2,1.875,2.2,0,0,0,0,7.619995,-7.619995,28,0,23,16,7,-7,-0.325000047683716,0.325000047683716,0,1,0,0,-1,1,0,0,230,300,-70,70
Justin Edwards,Joe Proctor,Joe Proctor,2015-06-06,0,1,3,-3,1.8,2.2,0,0,0,0,-5.080002,5.080002,130,28,14,16,-2,2,-0.400000095367432,0.400000095367432,0,0,1,0,0,0,1,-1,507,176,331,-331
Magomed Mustafaev,Joe Proctor,Magomed Mustafaev,2015-12-12,1,0,-3,3,3.5,2.2,-5.080002,5.080002,0,0,-2.540009,2.540009,6,0,18,16,2,-2,1.29999995231628,-1.29999995231628,0,1,0,0,-1,1,0,0,0,189,-189,189
Bryan Barberena,Joe Proctor,Bryan Barberena,2017-04-22,1,0,-4,4,1.636364,2.2,5.080002,-5.080002,15,-15,0,0,6,0,29,16,13,-13,-0.563636422157288,0.563636422157288,0,0,0,1,0,0,-1,1,126,497,-371,371
Alen Amedovski,Joe Pyfer,Joe Pyfer,2022-09-17,0,1,8,-8,2,5.5,-10.16,10.16,0,0,-2.539993,2.539993,0,3,12,13,-1,1,-3.5,3.5,0,0,1,0,0,0,1,-1,119,0,119,-119
Gerald Meerschaert,Joe Pyfer,Joe Pyfer,2023-04-08,0,1,9,-9,2.058824,5.5,-2.540009,2.540009,0,0,5.080002,-5.080002,0,16,52,13,39,-39,-3.44117641448975,3.44117641448975,6,1,1,0,5,-5,1,-1,238,203,35,-35
Joe Doerksen,Joe Riggs,Joe Riggs,2004-08-21,0,1,5,-5,3.1875,2.588235,0,0,0,0,12.7,-12.7,44,364,67,61,6,-6,0.599264621734619,-0.599264621734619,0,0,0,0,0,0,0,0,0,0,0,0
Chris Lytle,Joe Riggs,Joe Riggs,2005-10-07,0,1,8,-8,1.722222,2.588235,-2.540009,2.540009,-15,15,-5.080002,5.080002,184,176,49,61,-12,12,-0.866013169288635,0.866013169288635,0,1,0,0,-1,1,0,0,244,412,-168,168
Matt Hughes,Joe Riggs,Matt Hughes,2005-11-19,1,0,9,-9,5,2.588235,-7.62001,7.62001,-15,15,7.619995,-7.619995,123,0,54,61,-7,7,2.41176462173462,-2.41176462173462,3,2,0,0,1,-1,0,0,217,43,174,-174
Nick Diaz,Joe Riggs,Joe Riggs,2006-02-04,0,1,-1,1,2.6,2.588235,2.539993,-2.539993,-15,15,15.23999,-15.23999,202,125,36,61,-25,25,1.17645263671875e-02,-1.17645263671875e-02,0,0,0,0,0,0,0,0,91,77,14,-14
Patrick Cote,Joe Riggs,Patrick Cote,2015-04-25,1,0,3,-3,2.090909,2.588235,-2.540009,2.540009,-15,15,12.7,-12.7,382,260,34,61,-27,27,-0.497326374053955,0.497326374053955,0,1,1,0,-1,1,1,-1,210,3367,-3157,3157
Chris Camozzi,Joe Riggs,Chris Camozzi,2016-02-21,1,0,-4,4,1.846154,2.588235,5.080002,-5.080002,0,0,12.7,-12.7,1,0,37,61,-24,24,-0.742081522941589,0.742081522941589,1,0,0,0,1,-1,0,0,197,302,-105,105
Jason DeLucia,Joe Slick,Joe Slick,1999-11-19,0,1,8,-8,1.571429,3.2,-2.540009,2.540009,-9,9,-2,2,9,33,54,21,33,-33,-1.62857151031494,1.62857151031494,0,0,0,0,0,0,0,0,2079,0,2079,-2079
Ikuhisa Minowa,Joe Slick,Ikuhisa Minowa,2000-04-14,1,0,2,-2,1.428571,3.2,-7.62001,7.62001,-18,18,-5,5,447,135,102,21,81,-81,-1.77142858505249,1.77142858505249,0,1,0,0,-1,1,0,0,0,147,-147,147
Austin Hubbard,Joe Solecki,Joe Solecki,2020-08-22,0,1,2,-2,2.285714,4.333333,2.540009,-2.540009,0,0,2.539993,-2.539993,0,157,23,16,7,-7,-2.04761910438538,2.04761910438538,1,0,0,0,1,-1,0,0,63,0,63,-63
Jim Miller,Joe Solecki,Joe Solecki,2021-04-10,0,1,10,-10,2.117647,4.333333,-2.539993,2.539993,0,0,2.539993,-2.539993,123,563,53,16,37,-37,-2.21568632125854,2.21568632125854,0,1,0,0,-1,1,0,0,238,231,7,-7
Jared Gordon,Joe Solecki,Jared Gordon,2021-10-02,1,0,5,-5,3.166667,4.333333,0,0,0,0,-5.080002,5.080002,247,363,25,16,9,-9,-1.16666674613953,1.16666674613953,0,2,2,0,-2,2,2,-2,686,175,511,-511
Alex Da Silva,Joe Solecki,Joe Solecki,2022-06-04,0,1,-2,2,5.25,4.333333,-2.539993,2.539993,0,0,7.619995,-7.619995,355,291,25,16,9,-9,0.916666507720947,-0.916666507720947,0,0,0,0,0,0,0,0,616,245,371,-371
Carl Deaton,Joe Solecki,Joe Solecki,2023-02-25,0,1,4,-4,2.428571,4.333333,-5.080002,5.080002,0,0,-2.540009,2.540009,0,531,24,16,8,-8,-1.90476202964783,1.90476202964783,0,1,0,0,-1,1,0,0,0,266,-266,266
Keith Hackney,Joe Son,Keith Hackney,1994-12-16,1,0,,,1,0,17.78,-17.78,-36,36,20,-20,0,0,4,4,0,0,1,-1,1,0,0,0,1,-1,0,0,98,0,98,-98
TJ Dillashaw,Joe Soto,TJ Dillashaw,2014-08-30,1,0,1,-1,3.6,2.571429,0,0,0,0,5.079987,-5.079987,112,0,23,25,-2,2,1.02857136726379,-1.02857136726379,5,0,1,0,5,-5,1,-1,227,0,227,-227
Anthony Birchak,Joe Soto,Anthony Birchak,2015-06-06,1,0,1,-1,2,2.571429,5.080002,-5.080002,0,0,10.15999,-10.15999,8,0,24,25,-1,1,-0.571428537368774,0.571428537368774,0,0,0,1,0,0,-1,1,175,280,-105,105
Chris Beal,Joe Soto,Joe Soto,2016-06-18,0,1,1,-1,2,2.571429,2.539993,-2.539993,-10,10,10.15999,-10.15999,11,128,15,25,-10,10,-0.571428537368774,0.571428537368774,0,0,0,2,0,0,-2,2,300,378,-78,78
Marco Beltran,Joe Soto,Joe Soto,2016-11-05,0,1,1,-1,1.333333,2.571429,5.080002,-5.080002,-10,10,10.15999,-10.15999,0,26,14,25,-11,11,-1.23809516429901,1.23809516429901,3,1,0,2,2,-2,-2,2,121,140,-19,19
Brett Johns,Joe Soto,Brett Johns,2017-12-01,1,0,-5,5,8.5,2.571429,2.539993,-2.539993,0,0,15.23999,-15.23999,0,0,19,25,-6,6,5.92857146263123,-5.92857146263123,1,2,0,2,-1,1,-2,2,138,391,-253,253
Iuri Alcantara,Joe Soto,Iuri Alcantara,2018-02-03,1,0,7,-7,3.5,2.571429,7.619995,-7.619995,0,0,15.23999,-15.23999,6,0,45,25,20,-20,0.928571462631226,-0.928571462631226,0,0,0,2,0,0,-2,2,56,64,-8,8
Luke Cummo,Joe Stevenson,Joe Stevenson,2005-11-05,0,1,2,-2,1,2.0625,12.70001,-12.70001,25,-25,10.16,-10.16,122,583,12,49,-37,37,-1.0625,1.0625,0,0,0,0,0,0,0,0,0,0,0,0
Josh Neer,Joe Stevenson,Josh Neer,2006-04-06,1,0,0,0,2.25,2.0625,10.16,-10.16,25,-25,5.080002,-5.080002,476,164,52,49,3,-3,0.1875,-0.1875,0,1,0,0,-1,1,0,0,0,152,-152,152
Yves Edwards,Joe Stevenson,Joe Stevenson,2006-07-08,0,1,5,-5,1.909091,2.0625,5.080002,-5.080002,10,-10,7.619995,-7.619995,40,340,64,49,15,-15,-0.153409123420715,0.153409123420715,0,0,0,0,0,0,0,0,126,93,33,-33
Dokonjonosuke Mishima,Joe Stevenson,Joe Stevenson,2006-11-18,0,1,10,-10,3,2.0625,0,0,10,-10,-4.800003,4.800003,111,0,28,49,-21,21,0.9375,-0.9375,0,1,0,0,-1,1,0,0,0,133,-133,133
Melvin Guillard,Joe Stevenson,Joe Stevenson,2007-04-05,0,1,0,0,1.777778,2.0625,5.080002,-5.080002,10,-10,2.539993,-2.539993,3,11,50,49,1,-1,-0.284722208976746,0.284722208976746,1,2,0,0,-1,1,0,0,194,138,56,-56
Kurt Pellegrino,Joe Stevenson,Joe Stevenson,2007-08-25,0,1,3,-3,2.285714,2.0625,2.540009,-2.540009,10,-10,0,0,369,247,23,49,-26,26,0.223214387893677,-0.223214387893677,0,3,0,0,-3,3,0,0,0,142,-142,142
BJ Penn,Joe Stevenson,BJ Penn,2008-01-19,1,0,4,-4,1.142857,2.0625,5.080002,-5.080002,10,-10,0,0,393,0,30,49,-19,19,-0.919642806053162,0.919642806053162,1,4,0,0,-3,3,0,0,210,147,63,-63
Kenny Florian,Joe Stevenson,Kenny Florian,2008-11-15,1,0,6,-6,2.333333,2.0625,7.62001,-7.62001,0,0,10.16,-10.16,66,77,20,49,-29,29,0.270833253860474,-0.270833253860474,5,0,1,0,5,-5,1,-1,98,301,-203,203
Diego Sanchez,Joe Stevenson,Diego Sanchez,2009-02-21,1,0,1,-1,2.384615,2.0625,7.62001,-7.62001,25,-25,5.080002,-5.080002,46,24,44,49,-5,5,0.322115421295166,-0.322115421295166,0,0,0,0,0,0,0,0,0,98,-98,98
Nate Diaz,Joe Stevenson,Joe Stevenson,2009-06-20,0,1,-3,3,1.692308,2.0625,12.70001,-12.70001,25,-25,15.23999,-15.23999,136,637,35,49,-14,14,-0.370192289352417,0.370192289352417,0,0,0,0,0,0,0,0,140,119,21,-21
Spencer Fisher,Joe Stevenson,Joe Stevenson,2009-10-24,0,1,6,-6,2.666667,2.0625,0,0,10,-10,-5.080002,5.080002,0,279,33,49,-16,16,0.604166746139526,-0.604166746139526,4,1,1,0,3,-3,1,-1,133,126,7,-7
George Sotiropoulos,Joe Stevenson,George Sotiropoulos,2010-02-20,1,0,5,-5,2,2.0625,7.62001,-7.62001,10,-10,2.539993,-2.539993,319,289,21,49,-28,28,-0.0625,0.0625,0,2,0,0,-2,2,0,0,0,119,-119,119
Mac Danzig,Joe Stevenson,Mac Danzig,2010-12-11,1,0,2,-2,1.75,2.0625,2.540009,-2.540009,10,-10,0,0,1,0,33,49,-16,16,-0.3125,0.3125,0,0,0,0,0,0,0,0,182,294,-112,112
Danny Castillo,Joe Stevenson,Danny Castillo,2011-03-03,1,0,3,-3,1.7,2.0625,5.080002,-5.080002,10,-10,2.539993,-2.539993,313,223,27,49,-22,22,-0.362499952316284,0.362499952316284,0,0,0,1,0,0,-1,1,0,82,-82,82
Alessio Sakara,Joe Vedepo,Alessio Sakara,2008-09-17,1,0,,,1.727273,2,0,0,0,0,-2.119995,2.119995,0,23,30,27,3,-3,-0.272727251052856,0.272727251052856,2,0,0,0,2,-2,0,0,515,0,515,-515
Rob Kimmons,Joe Vedepo,Rob Kimmons,2009-04-01,1,0,,,2.777778,2,-5.080002,5.080002,0,0,0.4199982,-0.4199982,10,63,34,27,7,-7,0.777777671813965,-0.777777671813965,0,0,0,1,0,0,-1,1,196,196,0,0
Gray Maynard,Joe Veres,Gray Maynard,2007-09-19,1,0,-1,1,1.857143,1.333333,5.080002,-5.080002,0,0,4.800003,-4.800003,2,0,20,7,13,-13,0.523809432983398,-0.523809432983398,0,0,0,0,0,0,0,0,0,0,0,0
Corey Hill,Joe Veres,Corey Hill,2008-01-23,1,0,-1,1,0.6666667,1.333333,22.86,-22.86,0,0,30.2,-30.2,205,19,15,7,8,-8,-0.666666686534882,0.666666686534882,0,0,0,1,0,0,-1,1,0,126,-126,126
Jack McGlaughlin,Joel Sutton,Joel Sutton,1995-07-14,0,1,,,0.25,0.5,,,,,-10,10,0,0,5,6,-1,1,-0.25,0.25,0,0,0,0,0,0,0,0,0,0,0,0
Geza Kalman,Joel Sutton,Joel Sutton,1995-09-08,0,1,,,0.4444444,0.5,5.080002,-5.080002,-5,5,5,-5,0,0,13,6,7,-7,-5.55555522441864e-02,5.55555522441864e-02,0,1,0,0,-1,1,0,0,0,56,-56,56
Pat Barry,Joey Beltran,Pat Barry,2011-01-22,1,0,2,-2,1.142857,1.214286,-5.080002,5.080002,50,-50,-2.539993,2.539993,53,262,15,31,-16,16,-7.14285373687744e-02,7.14285373687744e-02,0,0,0,0,0,0,0,0,224,0,224,-224
Diego Brandao,Joey Gambino,Diego Brandao,2012-10-13,1,0,2,-2,2,4.5,0,0,0,0,-10.44,10.44,333,37,33,11,22,-22,-2.5,2.5,0,0,0,0,0,0,0,0,140,0,140,-140
Rob Font,Joey Gomez,Rob Font,2016-01-17,1,0,2,-2,2.857143,7,-5.080002,5.080002,-20,20,0,0,66,24,27,8,19,-19,-4.14285707473755,4.14285707473755,1,0,0,0,1,-1,0,0,561,0,561,-561
Sione Latu,Joey Roberts,Sione Latu,1999-03-05,1,0,,,1,1.333333,-5.080002,5.080002,15,-15,-8,8,0,0,1,7,-6,6,-0.333333373069763,0.333333373069763,0,0,0,0,0,0,0,0,0,0,0,0
Danny Castillo,John Cholish,Danny Castillo,2012-05-05,1,0,4,-4,1.7,2.666667,-5.080002,5.080002,0,0,-7.62001,7.62001,175,51,27,11,16,-16,-0.966666698455811,0.966666698455811,1,0,0,0,1,-1,0,0,127,0,127,-127
TJ Dillashaw,John Dodson,John Dodson,2011-12-03,0,1,-2,2,3.6,1.833333,7.619995,-7.619995,0,0,2.539993,-2.539993,0,3,23,34,-11,11,1.76666653156281,-1.76666653156281,0,0,0,0,0,0,0,0,0,0,0,0
Yves Edwards,John Gunderson,Yves Edwards,2010-09-15,1,0,2,-2,1.909091,2.1875,0,0,0,0,10.16,-10.16,483,49,64,51,13,-13,-0.278409123420715,0.278409123420715,0,0,1,0,0,0,1,-1,1530,0,1530,-1530
Jorge Gurgel,John Halverson,Jorge Gurgel,2008-03-01,1,0,-4,4,1.4,2,-5.080002,5.080002,0,0,-4.740005,4.740005,521,61,24,24,0,0,-0.600000023841858,0.600000023841858,0,0,0,0,0,0,0,0,133,0,133,-133
Tom Egan,John Hathaway,John Hathaway,2009-01-17,0,1,,,1.4,8.5,-5.080002,5.080002,0,0,-7.5,7.5,0,249,12,19,-7,7,-7.10000002384186,7.10000002384186,0,0,0,0,0,0,0,0,0,0,0,0
Dennis Hallman,John Howard,John Howard,2009-12-05,0,1,8,-8,2.65,1.846154,5.080002,-5.080002,-15,15,0,0,550,214,73,37,36,-36,0.80384624004364,-0.80384624004364,0,0,1,0,0,0,1,-1,1520,0,1520,-1520
Jake Ellenberger,John Howard,Jake Ellenberger,2010-08-01,1,0,-2,2,2.066667,1.846154,5.080002,-5.080002,0,0,-2.540009,2.540009,544,10,46,37,9,-9,0.220512747764587,-0.220512747764587,1,1,0,0,0,0,0,0,211,239,-28,28
Thiago Alves,John Howard,Thiago Alves,2010-12-11,1,0,0,0,1.533333,1.846154,5.080002,-5.080002,0,0,-5.080002,5.080002,177,53,38,37,1,-1,-0.312820553779602,0.312820553779602,0,0,1,1,0,0,0,0,126,132,-6,6
Matt Brown,John Howard,Matt Brown,2011-06-26,1,0,2,-2,1.368421,1.846154,12.70001,-12.70001,0,0,7.619995,-7.619995,214,400,45,37,8,-8,-0.47773277759552,0.47773277759552,0,0,0,1,0,0,-1,1,218,197,21,-21
Uriah Hall,John Howard,John Howard,2013-08-17,0,1,-1,1,1.636364,1.846154,12.70001,-12.70001,15,-15,17.78,-17.78,293,227,29,37,-8,8,-0.209790229797363,0.209790229797363,0,0,0,1,0,0,-1,1,0,783,-783,783
Siyar Bahadurzada,John Howard,John Howard,2013-12-28,0,1,-1,1,3,1.846154,10.16,-10.16,0,0,2.539993,-2.539993,114,351,32,37,-5,5,1.15384614467621,-1.15384614467621,0,1,0,1,-1,1,-1,1,301,133,168,-168
Brian Ebersole,John Howard,Brian Ebersole,2014-09-27,1,0,2,-2,2.833333,1.846154,12.70001,-12.70001,0,0,2.539993,-2.539993,197,246,69,37,32,-32,0.987179398536682,-0.987179398536682,0,2,0,1,-2,2,-1,1,315,273,42,-42
Matt Arroyo,John Kolosci,Matt Arroyo,2007-12-08,1,0,-8,8,1,1.666667,-2.539993,2.539993,-15,15,-0.1199951,0.1199951,60,202,6,24,-18,18,-0.666666626930237,0.666666626930237,0,0,0,0,0,0,0,0,0,0,0,0
Lowell Anderson,John Lewis,John Lewis,1999-09-24,0,1,,,0,0.75,-15.24001,15.24001,5,-5,-7,7,3,200,1,7,-6,6,-0.75,0.75,0,0,0,0,0,0,0,0,0,0,0,0
Louis Gaudinot,John Lineker,Louis Gaudinot,2012-05-05,1,0,6,-6,2,3.444444,0,0,-10,10,-10.15999,10.15999,224,14,12,40,-28,28,-1.44444441795349,1.44444441795349,0,0,0,0,0,0,0,0,0,0,0,0
Azamat Gashimov,John Lineker,John Lineker,2013-05-18,0,1,1,-1,2.666667,3.444444,7.619995,-7.619995,-10,10,-0.1799927,0.1799927,1,106,11,40,-29,29,-0.777777671813965,0.777777671813965,0,0,0,0,0,0,0,0,182,378,-196,196
Phil Harris,John Lineker,John Lineker,2013-10-26,0,1,7,-7,1.833333,3.444444,2.539993,-2.539993,-10,10,-5.079987,5.079987,0,4,34,40,-6,6,-1.61111104488373,1.61111104488373,0,1,0,0,-1,1,0,0,386,161,225,-225
Ali Bagautinov,John Lineker,Ali Bagautinov,2014-02-01,1,0,5,-5,2.5,3.444444,2.539993,-2.539993,-10,10,-5.079987,5.079987,441,21,21,40,-19,19,-0.944444417953491,0.944444417953491,2,2,0,0,0,0,0,0,77,98,-21,21
Rob Font,John Lineker,John Lineker,2016-05-14,0,1,3,-3,2.857143,3.444444,12.7,-12.7,0,0,10.16,-10.16,1,156,27,40,-13,13,-0.58730149269104,0.58730149269104,2,0,0,0,2,-2,0,0,118,833,-715,715
John Dodson,John Lineker,John Lineker,2016-10-01,0,1,6,-6,1.833333,3.444444,0,0,0,0,-2.539993,2.539993,23,0,34,40,-6,6,-1.61111104488373,1.61111104488373,1,1,0,0,0,0,0,0,168,140,28,-28
TJ Dillashaw,John Lineker,TJ Dillashaw,2016-12-30,1,0,4,-4,3.6,3.444444,7.619995,-7.619995,0,0,0,0,413,18,23,40,-17,17,0.155555486679077,-0.155555486679077,6,2,1,0,4,-4,1,-1,853,90,763,-763
Brian Kelleher,John Lineker,John Lineker,2018-05-12,0,1,4,-4,1.714286,3.444444,7.619995,-7.619995,0,0,-2.539993,2.539993,43,67,38,40,-2,2,-1.73015868663788,1.73015868663788,1,0,0,0,1,-1,0,0,203,498,-295,295
Justin Edwards,John Maguire,John Maguire,2011-11-05,0,1,0,0,1.8,2.666667,2.540009,-2.540009,0,0,2.540009,-2.540009,116,556,14,33,-19,19,-0.866666793823242,0.866666793823242,1,0,0,0,1,-1,0,0,49,0,49,-49
DaMarques Johnson,John Maguire,John Maguire,2012-04-14,0,1,1,-1,1,2.666667,10.16,-10.16,15,-15,15.24001,-15.24001,105,366,30,33,-3,3,-1.66666674613953,1.66666674613953,0,1,2,0,-1,1,2,-2,385,161,224,-224
John Hathaway,John Maguire,John Hathaway,2012-09-29,1,0,-4,4,8.5,2.666667,10.16,-10.16,15,-15,15.24001,-15.24001,249,103,19,33,-14,14,5.83333325386047,-5.83333325386047,2,2,0,0,0,0,0,0,147,168,-21,21
Mitch Clarke,John Maguire,Mitch Clarke,2013-06-15,1,0,-3,3,2.2,2.666667,2.540009,-2.540009,0,0,10.16,-10.16,147,411,16,33,-17,17,-0.466666698455811,0.466666698455811,0,0,0,0,0,0,0,0,329,259,70,-70
Pat Audinwood,John Makdessi,John Makdessi,2010-12-11,0,1,-1,1,5.5,2,10.16,-10.16,0,0,13.81999,-13.81999,4,19,13,27,-14,14,3.5,-3.5,0,0,0,0,0,0,0,0,77,0,77,-77
Dennis Hallman,John Makdessi,Dennis Hallman,2011-12-10,1,0,10,-10,2.65,2,2.539993,-2.539993,0,0,10.16,-10.16,166,0,73,27,46,-46,0.650000095367432,-0.650000095367432,2,1,2,0,1,-1,2,-2,385,364,21,-21
Daron Cruickshank,John Makdessi,John Makdessi,2013-03-16,0,1,0,0,1.8,2,0,0,0,0,10.16,-10.16,2,11,28,27,1,-1,-0.200000047683716,0.200000047683716,2,0,0,0,2,-2,0,0,98,462,-364,364
Renee Forte,John Makdessi,John Makdessi,2013-09-21,0,1,-2,2,2,2,-2.540009,2.540009,0,0,7.619995,-7.619995,0,8,12,27,-15,15,0,0,0,1,0,0,-1,1,0,0,343,189,154,-154
Shane Campbell,John Makdessi,John Makdessi,2015-04-25,0,1,-1,1,2.333333,2,10.16,-10.16,0,0,7.619995,-7.619995,34,69,20,27,-7,7,0.333333253860474,-0.333333253860474,0,2,0,0,-2,2,0,0,0,581,-581,581
Donald Cerrone,John Makdessi,Donald Cerrone,2015-05-23,1,0,2,-2,2.117647,2,12.7,-12.7,0,0,12.7,-12.7,0,0,53,27,26,-26,0.117647171020508,-0.117647171020508,5,3,1,0,2,-2,1,-1,125,28,97,-97
Mehdi Baghdad,John Makdessi,John Makdessi,2016-07-07,0,1,0,0,2.2,2,12.7,-12.7,0,0,16.41,-16.41,7,105,16,27,-11,11,0.200000047683716,-0.200000047683716,0,0,0,1,0,0,-1,1,172,411,-239,239
Ignacio Bahamondes,John Makdessi,John Makdessi,2021-04-10,0,1,-12,12,2.8,2,17.78,-17.78,0,0,17.78,-17.78,74,13,19,27,-8,8,0.799999952316284,-0.799999952316284,0,1,0,1,-1,1,-1,1,0,1738,-1738,1738
Nasrat Haqparast,John Makdessi,Nasrat Haqparast,2022-09-03,1,0,-10,10,3,2,5.080002,-5.080002,0,0,10.16,-10.16,35,0,20,27,-7,7,1,-1,0,2,0,1,-2,2,-1,1,343,511,-168,168
David Abbott,John Matua,David Abbott,1995-07-14,1,0,,,0.6666667,0.25,-5.080002,5.080002,-135,135,-17.5,17.5,0,0,25,5,20,-20,0.416666686534882,-0.416666686534882,0,0,0,0,0,0,0,0,0,0,0,0
Ulysses Gomez,John Moraga,John Moraga,2012-08-04,0,1,1,-1,1.8,2.714286,0,0,0,0,2.360001,-2.360001,23,21,14,26,-12,12,-0.914285659790039,0.914285659790039,0,0,0,0,0,0,0,0,0,0,0,0
Chris Cariaso,John Moraga,John Moraga,2012-12-29,0,1,3,-3,2.125,2.714286,-7.619995,7.619995,0,0,-5.080002,5.080002,36,88,25,26,-1,1,-0.589285612106323,0.589285612106323,3,1,0,0,2,-2,0,0,171,147,24,-24
Demetrious Johnson,John Moraga,Demetrious Johnson,2013-07-27,1,0,-3,3,9,2.714286,-7.619995,7.619995,0,0,0,0,816,117,30,26,4,-4,6.28571438789368,-6.28571438789368,3,2,0,0,1,-1,0,0,414,210,204,-204
John Dodson,John Moraga,John Dodson,2014-06-07,1,0,-1,1,1.833333,2.714286,-7.619995,7.619995,10,-10,0,0,53,2,34,26,8,-8,-0.88095223903656,0.88095223903656,1,0,0,0,1,-1,0,0,231,315,-84,84
Willie Gates,John Moraga,John Moraga,2014-12-13,0,1,-3,3,1.714286,2.714286,5.080002,-5.080002,0,0,15.24001,-15.24001,25,419,19,26,-7,7,-0.99999988079071,0.99999988079071,0,0,0,1,0,0,-1,1,0,189,-189,189
Joseph Benavidez,John Moraga,Joseph Benavidez,2015-05-23,1,0,-1,1,3.5,2.714286,-5.080002,5.080002,0,0,-2.539993,2.539993,550,41,36,26,10,-10,0.785714387893677,-0.785714387893677,2,1,1,1,1,-1,0,0,182,161,21,-21
Ashkan Mokhtarian,John Moraga,John Moraga,2017-06-10,0,1,-2,2,4.333333,2.714286,0,0,0,0,2.539993,-2.539993,129,467,16,26,-10,10,1.61904788017273,-1.61904788017273,0,0,0,1,0,0,-1,1,0,749,-749,749
Bibulatov Magomed,John Moraga,John Moraga,2017-10-07,0,1,-4,4,7,2.714286,-2.539993,2.539993,0,0,-2.539993,2.539993,3,2,16,26,-10,10,4.28571438789368,-4.28571438789368,0,1,0,1,-1,1,-1,1,0,119,-119,119
Deiveson Figueiredo,John Moraga,Deiveson Figueiredo,2018-08-25,1,0,-4,4,7,2.714286,-2.539993,2.539993,0,0,5.080002,-5.080002,296,0,24,26,-2,2,4.28571438789368,-4.28571438789368,1,2,0,1,-1,1,-1,1,203,322,-119,119
Charles Byrd,John Phillips,Charles Byrd,2018-03-17,1,0,2,-2,1.428571,2,-2.539993,2.539993,0,0,-5.080002,5.080002,233,0,17,33,-16,16,-0.571428537368774,0.571428537368774,0,0,0,0,0,0,0,0,0,0,0,0
Kevin Holland,John Phillips,Kevin Holland,2018-11-24,1,0,-7,7,2.5,2,10.16,-10.16,-15,15,15.24001,-15.24001,202,49,35,33,2,-2,0.5,-0.5,0,0,0,0,0,0,0,0,112,252,-140,140
Jack Marshman,John Phillips,Jack Marshman,2019-03-16,1,0,-4,4,2.3,2,2.540009,-2.540009,0,0,-5.080002,5.080002,0,36,33,33,0,0,0.299999952316284,-0.299999952316284,0,0,1,0,0,0,1,-1,133,112,21,-21
Alen Amedovski,John Phillips,John Phillips,2019-09-28,0,1,-3,3,2,2,-2.539993,2.539993,0,0,-2.539993,2.539993,0,2,12,33,-21,21,0,0,0,0,0,0,0,0,0,0,161,196,-35,35
Khamzat Chimaev,John Phillips,Khamzat Chimaev,2020-07-15,1,0,-9,9,12,2,7.62001,-7.62001,0,0,0,0,354,0,12,33,-21,21,10,-10,0,1,0,0,-1,1,0,0,0,291,-291,291
JunYong Park,John Phillips,JunYong Park,2020-10-17,1,0,-6,6,3.4,2,-2.539993,2.539993,0,0,-5.080002,5.080002,791,0,22,33,-11,11,1.40000009536743,-1.40000009536743,0,0,0,0,0,0,0,0,0,94,-94,94
Rolando Delgado,John Polakowski,Rolando Delgado,2008-12-13,1,0,0,0,1.833333,1,12.7,-12.7,0,0,15.58,-15.58,246,21,17,4,13,-13,0.833333373069763,-0.833333373069763,0,0,0,0,0,0,0,0,0,0,0,0
Gerald Harris,John Salter,Gerald Harris,2010-01-11,1,0,6,-6,4.6,4.666667,-5.080002,5.080002,0,0,7.619995,-7.619995,132,88,28,17,11,-11,-6.66666030883789e-02,6.66666030883789e-02,0,0,0,0,0,0,0,0,0,0,0,0
Jason MacDonald,John Salter,John Salter,2010-05-08,0,1,9,-9,1.5625,4.666667,5.080002,-5.080002,0,0,15.23999,-15.23999,0,72,41,17,24,-24,-3.10416650772095,3.10416650772095,0,0,1,1,0,0,0,0,385,117,268,-268
Dan Miller,John Salter,Dan Miller,2010-08-28,1,0,4,-4,1.75,4.666667,0,0,0,0,0,0,8,99,22,17,5,-5,-2.91666650772095,2.91666650772095,0,1,0,1,-1,1,-1,1,462,112,350,-350
Yan Cabral,Johnny Case,Johnny Case,2015-11-07,0,1,6,-6,4.333333,3.666667,2.539993,-2.539993,0,0,2.539993,-2.539993,312,140,16,28,-12,12,0.666666746139526,-0.666666746139526,1,0,0,0,1,-1,0,0,378,0,378,-378
Raphael Assuncao,Johnny Eduardo,Raphael Assuncao,2011-08-27,1,0,-4,4,2.8,2.153846,-5.079987,5.079987,0,0,-12.7,12.7,295,4,38,41,-3,3,0.646153688430786,-0.646153688430786,0,0,1,0,0,0,1,-1,161,0,161,-161
Jeff Curran,Johnny Eduardo,Johnny Eduardo,2012-05-15,0,1,1,-1,2,2.153846,-2.539993,2.539993,0,0,-5.080002,5.080002,0,0,54,41,13,-13,-0.153846263885498,0.153846263885498,0,0,0,0,0,0,0,0,199,262,-63,63
Nate Maness,Johnny Munoz,Nate Maness,2020-08-01,1,0,2,-2,4.666667,4,2.540009,-2.540009,-10,10,2.540009,-2.540009,89,582,17,15,2,-2,0.666666507720947,-0.666666507720947,0,0,0,0,0,0,0,0,0,0,0,0
Tony Gravely,Johnny Munoz,Tony Gravely,2022-06-04,1,0,1,-1,2.555556,4,-10.15999,10.15999,0,0,-5.080002,5.080002,3,0,32,15,17,-17,-1.44444441795349,1.44444441795349,1,0,1,0,1,-1,1,-1,133,672,-539,539
Nate Loughran,Johnny Rees,Nate Loughran,2008-07-19,1,0,2,-2,5.5,2.6,5.080002,-5.080002,15,-15,3,-3,0,246,13,18,-5,5,2.90000009536743,-2.90000009536743,0,0,0,0,0,0,0,0,0,0,0,0
Steve Bruno,Johnny Rees,Steve Bruno,2008-12-10,1,0,1,-1,2.5,2.6,-5.080002,5.080002,0,0,-5,5,301,150,21,18,3,-3,-9.99999046325684e-02,9.99999046325684e-02,0,0,0,0,0,0,0,0,123,144,-21,21
David Levicki,Johnny Rhodes,Johnny Rhodes,1994-03-11,0,1,,,0.3333333,2,12.7,-12.7,65,-65,13,-13,0,0,4,3,1,-1,-1.66666665673256,1.66666665673256,0,0,0,0,0,0,0,0,0,0,0,0
Fred Ettish,Johnny Rhodes,Johnny Rhodes,1994-03-11,0,1,,,1,2,0,0,-30,30,1,-1,0,0,2,3,-1,1,-1,1,0,1,0,0,-1,1,0,0,0,0,0,0
Khalil Rountree Jr.,Johnny Walker,Johnny Walker,2018-11-17,0,1,2,-2,2.6,3,-12.7,12.7,0,0,-15.24001,15.24001,5,4,18,28,-10,10,-0.400000095367432,0.400000095367432,1,0,0,0,1,-1,0,0,133,0,133,-133
Justin Ledet,Johnny Walker,Johnny Walker,2019-02-02,0,1,4,-4,2.25,3,-5.080002,5.080002,0,0,-5.080002,5.080002,0,4,13,28,-15,15,-0.75,0.75,0,1,0,0,-1,1,0,0,195,77,118,-118
Misha Cirkunov,Johnny Walker,Johnny Walker,2019-03-02,0,1,6,-6,1.666667,3,-7.619995,7.619995,0,0,-12.7,12.7,0,4,24,28,-4,4,-1.33333337306976,1.33333337306976,1,2,2,0,-1,1,2,-2,126,28,98,-98
Corey Anderson,Johnny Walker,Corey Anderson,2019-11-02,1,0,3,-3,2.8,3,-7.619995,7.619995,0,0,-7.619995,7.619995,22,19,19,28,-9,9,-0.200000047683716,0.200000047683716,3,3,3,0,0,0,3,-3,308,245,63,-63
Nikita Krylov,Johnny Walker,Nikita Krylov,2020-03-14,1,0,1,-1,3.333333,3,-7.619995,7.619995,0,0,-12.7,12.7,680,145,39,28,11,-11,0.333333253860474,-0.333333253860474,0,0,1,1,0,0,0,0,182,133,49,-49
Ryan Spann,Johnny Walker,Johnny Walker,2020-09-19,0,1,1,-1,2.333333,3,-2.539993,2.539993,0,0,-7.619995,7.619995,106,40,30,28,2,-2,-0.666666746139526,0.666666746139526,0,0,0,1,0,0,-1,1,0,189,-189,189
Thiago Santos,Johnny Walker,Thiago Santos,2021-10-02,1,0,8,-8,2,3,-10.15999,10.15999,0,0,-15.24001,15.24001,0,0,33,28,5,-5,-1,1,0,1,0,1,-1,1,-1,1,329,378,-49,49
Jamahal Hill,Johnny Walker,Jamahal Hill,2022-02-19,1,0,1,-1,12,3,-5.080002,5.080002,0,0,-7.619995,7.619995,3,22,13,28,-15,15,9,-9,2,0,0,1,2,-2,-1,1,441,140,301,-301
Ion Cutelaba,Johnny Walker,Johnny Walker,2022-09-10,0,1,-2,2,1.888889,3,-12.7,12.7,0,0,-17.78,17.78,122,130,26,28,-2,2,-1.11111116409302,1.11111116409302,0,0,0,2,0,0,-2,2,119,203,-84,84
Paul Craig,Johnny Walker,Johnny Walker,2023-01-21,0,1,5,-5,2.833333,3,-7.619995,7.619995,-20,20,-15.24001,15.24001,0,4,23,28,-5,5,-0.166666746139526,0.166666746139526,0,1,3,2,-1,1,1,-1,182,133,49,-49
Anthony Smith,Johnny Walker,Johnny Walker,2023-05-13,0,1,3,-3,2.055556,3,-5.080002,5.080002,0,0,-15.24001,15.24001,82,32,55,28,27,-27,-0.944444417953491,0.944444417953491,1,2,1,2,-1,1,-1,1,602,112,490,-490
Ricardo Funch,Johny Hendricks,Johny Hendricks,2009-12-12,0,1,3,-3,1.5,2.25,2.540009,-2.540009,-15,15,12.70001,-12.70001,130,598,15,26,-11,11,-0.75,0.75,0,0,0,0,0,0,0,0,0,0,0,0
TJ Grant,Johny Hendricks,Johny Hendricks,2010-05-08,0,1,0,0,4.2,2.25,2.540009,-2.540009,-30,30,7.62001,-7.62001,9,396,26,26,0,0,1.94999980926514,-1.94999980926514,0,1,0,0,-1,1,0,0,301,147,154,-154
Charlie Brenneman,Johny Hendricks,Johny Hendricks,2010-08-07,0,1,3,-3,2.375,2.25,2.540009,-2.540009,-30,30,2.540009,-2.540009,126,51,27,26,1,-1,0.125,-0.125,1,2,0,0,-1,1,0,0,129,91,38,-38
Jon Fitch,Johny Hendricks,Johny Hendricks,2011-12-30,0,1,5,-5,4.285714,2.25,7.62001,-7.62001,-15,15,12.70001,-12.70001,0,2,37,26,11,-11,2.0357141494751,-2.0357141494751,4,3,0,0,1,-1,0,0,643,510,133,-133
Carlos Condit,Johny Hendricks,Johny Hendricks,2013-03-16,0,1,-1,1,2.285714,2.25,12.70001,-12.70001,-15,15,15.24001,-15.24001,24,481,46,26,20,-20,3.57143878936768e-02,-3.57143878936768e-02,0,4,0,0,-4,4,0,0,119,442,-323,323
Matt Brown,Johny Hendricks,Johny Hendricks,2015-03-14,0,1,3,-3,1.368421,2.25,7.62001,-7.62001,-15,15,15.24001,-15.24001,21,666,45,26,19,-19,-0.881578922271729,0.881578922271729,0,5,0,0,-5,5,0,0,231,728,-497,497
Kelvin Gastelum,Johny Hendricks,Kelvin Gastelum,2016-07-09,1,0,-8,8,2.25,2.25,0,0,-15,15,5.080002,-5.080002,21,129,26,26,0,0,0,0,0,6,0,0,-6,6,0,0,231,483,-252,252
Tim Boetsch,Johny Hendricks,Tim Boetsch,2017-06-25,1,0,3,-3,1.615385,2.25,7.62001,-7.62001,0,0,12.70001,-12.70001,1,0,34,26,8,-8,-0.634615421295166,0.634615421295166,0,0,4,0,0,0,4,-4,134,351,-217,217
Paulo Costa,Johny Hendricks,Paulo Costa,2017-11-04,1,0,-8,8,7,2.25,10.16,-10.16,0,0,7.62001,-7.62001,1,0,16,26,-10,10,4.75,-4.75,1,0,0,1,1,-1,-1,1,238,132,106,-106
Joshua Burkman,Jon Fitch,Jon Fitch,2006-04-06,0,1,-3,3,1.75,4.285714,-5.080002,5.080002,0,0,-5.080002,5.080002,174,312,44,37,7,-7,-2.5357141494751,2.5357141494751,2,0,0,0,2,-2,0,0,80,0,80,-80
Thiago Alves,Jon Fitch,Jon Fitch,2006-06-28,0,1,-6,6,1.533333,4.285714,-7.62001,7.62001,0,0,-10.16,10.16,27,526,38,37,1,-1,-2.75238084793091,2.75238084793091,2,1,0,0,1,-1,0,0,74,83,-9,9
Luigi Fioravanti,Jon Fitch,Jon Fitch,2007-03-03,0,1,-3,3,1.733333,4.285714,-10.16,10.16,0,0,-10.16,10.16,37,261,41,37,4,-4,-2.55238080024719,2.55238080024719,2,2,0,0,0,0,0,0,80,248,-168,168
Roan Carneiro,Jon Fitch,Jon Fitch,2007-06-12,0,1,0,0,1.909091,4.285714,-2.540009,2.540009,0,0,5.079987,-5.079987,217,74,32,37,-5,5,-2.37662327289581,2.37662327289581,1,3,0,0,-2,2,0,0,68,101,-33,33
Thiago Alves,Jon Fitch,Jon Fitch,2010-08-07,0,1,-6,6,1.533333,4.285714,-7.62001,7.62001,0,0,-10.16,10.16,121,487,38,37,1,-1,-2.75238084793091,2.75238084793091,0,4,1,0,-4,4,1,-1,392,1152,-760,760
Andy Anderson,Jon Hess,Jon Hess,1995-04-07,0,1,,,0,1,-33.02,33.02,-55,55,-32,32,0,0,1,2,-1,1,-1,1,0,0,0,0,0,0,0,0,0,0,0,0
Andre Gusmao,Jon Jones,Jon Jones,2008-08-09,0,1,10,-10,2,27,-10.15999,10.15999,-43,43,-27.36,27.36,107,256,9,28,-19,19,-25,25,0,0,0,0,0,0,0,0,0,0,0,0
Stephan Bonnar,Jon Jones,Jon Jones,2009-01-31,0,1,10,-10,1.666667,27,0,0,-43,43,-12.7,12.7,131,249,24,28,-4,4,-25.3333333730698,25.3333333730698,2,1,0,0,1,-1,0,0,469,175,294,-294
Matt Hamill,Jon Jones,Matt Hamill,2009-12-05,1,0,11,-11,1.5,27,-7.619995,7.619995,-43,43,-20.32001,20.32001,0,84,20,28,-8,8,-25.5,25.5,3,2,0,0,1,-1,0,0,273,308,-35,35
Ryan Bader,Jon Jones,Jon Jones,2011-02-05,0,1,4,-4,4.6,27,-5.079987,5.079987,-43,43,-25.39999,25.39999,0,262,28,28,0,0,-22.4000000953674,22.4000000953674,5,0,0,0,5,-5,0,0,133,427,-294,294
Quinton Jackson,Jon Jones,Jon Jones,2011-09-24,0,1,9,-9,3.083333,27,-7.619995,7.619995,-43,43,-27.94,27.94,16,212,49,28,21,-21,-23.9166667461395,23.9166667461395,4,1,0,0,3,-3,0,0,308,231,77,-77
Rashad Evans,Jon Jones,Jon Jones,2012-04-21,0,1,8,-8,2.375,27,-10.15999,10.15999,-43,43,-22.86,22.86,9,60,27,28,-1,1,-24.625,24.625,3,2,1,0,1,-1,1,-1,259,210,49,-49
Vitor Belfort,Jon Jones,Jon Jones,2012-09-22,0,1,10,-10,1.857143,27,-10.15999,10.15999,-63,63,-25.39999,25.39999,6,565,40,28,12,-12,-25.1428571939468,25.1428571939468,1,3,3,0,-2,2,3,-3,252,154,98,-98
Alexander Gustafsson,Jon Jones,Jon Jones,2013-09-21,0,1,0,0,2.25,27,2.540009,-2.540009,-43,43,-12.7,12.7,19,59,26,28,-2,2,-24.75,24.75,6,4,0,0,2,-2,0,0,287,364,-77,77
Daniel Cormier,Jon Jones,Jon Jones,2015-01-03,0,1,8,-8,7.333333,27,-12.7,12.7,-13,13,-30.48,30.48,94,410,25,28,-3,3,-19.6666665077209,19.6666665077209,4,5,0,0,-1,1,0,0,224,469,-245,245
Alexander Gustafsson,Jon Jones,Jon Jones,2018-12-29,0,1,0,0,2.25,27,2.540009,-2.540009,-43,43,-12.7,12.7,0,89,26,28,-2,2,-24.75,24.75,1,6,1,0,-5,5,1,-1,580,1456,-876,876
Ciryl Gane,Jon Jones,Jon Jones,2023-03-04,0,1,-3,3,6,27,0,0,-3,3,-7.619995,7.619995,0,57,14,28,-14,14,-21,21,1,7,0,0,-6,6,0,0,182,1526,-1344,1344
Mostapha Al-Turk,Jon Madsen,Jon Madsen,2010-04-10,0,1,6,-6,1,4,5.080002,-5.080002,5,-5,12.7,-12.7,0,6,12,10,2,-2,-3,3,0,0,2,0,0,0,2,-2,301,0,301,-301
Neil Magny,Jon Manley,Neil Magny,2013-02-23,1,0,-1,1,2.333333,2.25,5.080002,-5.080002,0,0,25.2,-25.2,308,327,40,13,27,-27,8.33332538604736e-02,-8.33332538604736e-02,0,0,0,0,0,0,0,0,0,0,0,0
Dave Herman,Jon Olav Einemo,Dave Herman,2011-06-11,1,0,-9,9,3.666667,2,-5.080002,5.080002,-11,11,-5.419998,5.419998,44,114,28,9,19,-19,1.66666674613953,-1.66666674613953,0,0,0,0,0,0,0,0,0,0,0,0
Zhang Tiequan,Jon Tuck,Jon Tuck,2012-11-10,0,1,6,-6,3.75,2,-7.619995,7.619995,0,0,-10.16,10.16,76,403,19,15,4,-4,1.75,-1.75,0,0,0,0,0,0,0,0,0,0,0,0
Norman Parke,Jon Tuck,Norman Parke,2013-10-26,1,0,-3,3,3.833333,2,0,0,0,0,-7.619995,7.619995,8,0,29,15,14,-14,1.83333325386047,-1.83333325386047,1,1,0,0,0,0,0,0,112,350,-238,238
Jake Lindsey,Jon Tuck,Jon Tuck,2014-06-07,0,1,-2,2,1.714286,2,0,0,0,0,-2.419998,2.419998,148,384,19,15,4,-4,-0.285714268684387,0.285714268684387,0,0,0,0,0,0,0,0,0,224,-224,224
Kevin Lee,Jon Tuck,Kevin Lee,2014-09-27,1,0,-8,8,2.25,2,-5.080002,5.080002,15,-15,10.16,-10.16,525,7,26,15,11,-11,0.25,-0.25,1,1,0,0,0,0,0,0,83,112,-29,29
Tae Hyun Bang,Jon Tuck,Jon Tuck,2015-05-16,0,1,2,-2,1.8,2,-5.080002,5.080002,0,0,-5.080002,5.080002,0,62,28,15,13,-13,-0.200000047683716,0.200000047683716,1,0,0,0,1,-1,0,0,336,231,105,-105
Josh Emmett,Jon Tuck,Josh Emmett,2016-05-08,1,0,0,0,4.5,2,-12.7,12.7,-10,10,-7.619995,7.619995,1,7,22,15,7,-7,2.5,-2.5,0,1,0,0,-1,1,0,0,0,358,-358,358
Damien Brown,Jon Tuck,Damien Brown,2016-11-26,1,0,-1,1,1.416667,2,-2.539993,2.539993,0,0,-12.7,12.7,0,227,29,15,14,-14,-0.583333373069763,0.583333373069763,0,0,0,0,0,0,0,0,252,202,50,-50
Takanori Gomi,Jon Tuck,Jon Tuck,2017-06-17,0,1,6,-6,2.5,2,-10.16,10.16,0,0,-7.619995,7.619995,0,38,49,15,34,-34,0.5,-0.5,0,0,3,0,0,0,3,-3,343,203,140,-140
Drew Dober,Jon Tuck,Drew Dober,2018-08-25,1,0,-4,4,2.166667,2,-7.619995,7.619995,0,0,-7.619995,7.619995,467,0,38,15,23,-23,0.166666746139526,-0.166666746139526,2,1,0,0,1,-1,0,0,714,434,280,-280
Luke Cummo,Jonathan Goulet,Jonathan Goulet,2006-06-28,0,1,0,0,1,1.916667,0,0,0,0,2.540009,-2.540009,115,693,12,35,-23,23,-0.916666626930237,0.916666626930237,1,0,0,0,1,-1,0,0,83,0,83,-83
Paul Georgieff,Jonathan Goulet,Jonathan Goulet,2007-12-08,0,1,-3,3,3,1.916667,5.080002,-5.080002,0,0,5.580002,-5.580002,0,212,8,35,-27,27,1.08333337306976,-1.08333337306976,0,1,0,0,-1,1,0,0,0,528,-528,528
Marcus Davis,Jonathan Goulet,Marcus Davis,2010-05-08,1,0,6,-6,2,1.916667,-5.080002,5.080002,0,0,-7.619995,7.619995,46,211,33,35,-2,2,8.33333730697632e-02,-8.33333730697632e-02,0,2,2,0,-2,2,2,-2,168,882,-714,714
Pingyuan Liu,Jonathan Martinez,Jonathan Martinez,2019-07-13,0,1,1,-1,1.857143,4.5,-5.080002,5.080002,0,0,5.080002,-5.080002,0,2,20,22,-2,2,-2.64285719394684,2.64285719394684,1,0,0,0,1,-1,0,0,356,0,356,-356
Andre Ewell,Jonathan Martinez,Andre Ewell,2020-02-08,1,0,7,-7,1.888889,4.5,0,0,10,-10,12.7,-12.7,2,90,26,22,4,-4,-2.61111116409302,2.61111116409302,0,1,1,0,-1,1,1,-1,119,210,-91,91
Thomas Almeida,Jonathan Martinez,Jonathan Martinez,2020-10-17,0,1,3,-3,4.4,4.5,-2.540009,2.540009,10,-10,0,0,2,0,27,22,5,-5,-9.99999046325684e-02,9.99999046325684e-02,0,0,2,0,0,0,2,-2,1001,252,749,-749
Davey Grant,Jonathan Martinez,Davey Grant,2021-03-13,1,0,9,-9,2.142857,4.5,0,0,0,0,-2.540009,2.540009,3,25,22,22,0,0,-2.35714292526245,2.35714292526245,1,1,0,0,0,0,0,0,490,147,343,-343
Zviad Lazishvili,Jonathan Martinez,Jonathan Martinez,2021-10-23,0,1,2,-2,13,4.5,-5.080002,5.080002,0,0,-2.540009,2.540009,90,0,14,22,-8,8,8.5,-8.5,0,0,0,1,0,0,-1,1,0,224,-224,224
Colby Covington,Jonathan Meunier,Colby Covington,2016-06-18,1,0,0,0,5.666667,8,-10.16,10.16,0,0,-0.1199951,0.1199951,549,0,20,9,11,-11,-2.33333349227905,2.33333349227905,3,0,0,0,3,-3,0,0,392,0,392,-392
Joe Lauzon,Jonathan Pearce,Joe Lauzon,2019-10-18,1,0,8,-8,1.75,3.5,-5.080002,5.080002,10,-10,0,0,42,0,44,18,26,-26,-1.75,1.75,0,0,1,0,0,0,1,-1,909,0,909,-909
Kai Kamaka,Jonathan Pearce,Jonathan Pearce,2020-11-28,0,1,-3,3,2,3.5,-12.70001,12.70001,0,0,-5.080002,5.080002,33,206,12,18,-6,6,-1.5,1.5,1,0,0,1,1,-1,-1,1,105,407,-302,302
Omar Morales,Jonathan Pearce,Jonathan Pearce,2021-09-25,0,1,6,-6,2.75,3.5,-2.540009,2.540009,10,-10,5.080002,-5.080002,19,333,15,18,-3,3,-0.75,0.75,1,1,0,1,0,0,-1,1,182,301,-119,119
Makwan Amirkhani,Jonathan Pearce,Jonathan Pearce,2022-07-23,0,1,3,-3,1.888889,3.5,-5.080002,5.080002,0,0,2.540009,-2.540009,85,286,26,18,8,-8,-1.61111116409302,1.61111116409302,1,2,2,1,-1,1,1,-1,126,301,-175,175
Darren Elkins,Jonathan Pearce,Jonathan Pearce,2022-12-03,0,1,8,-8,2.454545,3.5,-5.080002,5.080002,0,0,0,0,48,213,38,18,20,-20,-1.04545450210571,1.04545450210571,0,3,3,1,-3,3,2,-2,350,133,217,-217
Wade Shipp,Jonathan Wiezorek,Jonathan Wiezorek,2004-04-02,0,1,3,-3,2.2,5.5,0,0,-5,5,0,0,44,111,16,13,3,-3,-3.29999995231628,3.29999995231628,0,0,0,0,0,0,0,0,0,0,0,0
Chris Dempsey,Jonathan Wilson,Jonathan Wilson,2015-08-08,0,1,-1,1,2.2,2.333333,-10.16,10.16,-20,20,-7.619995,7.619995,0,13,16,10,6,-6,-0.133333206176758,0.133333206176758,1,0,1,0,1,-1,1,-1,112,0,112,-112
Henrique da Silva,Jonathan Wilson,Henrique da Silva,2016-06-04,1,0,-2,2,2.8,2.333333,2.539993,-2.539993,0,0,2.539993,-2.539993,91,82,19,10,9,-9,0.466666698455811,-0.466666698455811,0,1,0,0,-1,1,0,0,0,301,-301,301
Ion Cutelaba,Jonathan Wilson,Ion Cutelaba,2016-10-01,1,0,-7,7,1.888889,2.333333,-2.540009,2.540009,0,0,0,0,8,24,26,10,16,-16,-0.444444417953491,0.444444417953491,0,0,0,1,0,0,-1,1,0,119,-119,119
Oskar Piechota,Jonathan Wilson,Oskar Piechota,2017-10-21,1,0,-3,3,3.666667,2.333333,-5.080002,5.080002,-20,20,2.539993,-2.539993,259,22,14,10,4,-4,1.33333349227905,-1.33333349227905,0,0,0,1,0,0,-1,1,0,385,-385,385
Kyle Noke,Jonavin Webb,Kyle Noke,2015-05-09,1,0,9,-9,2.2,4.5,7.619995,-7.619995,0,0,13.03999,-13.03999,125,180,32,11,21,-21,-2.29999995231628,2.29999995231628,0,0,0,0,0,0,0,0,0,0,0,0
Nathan Coy,Jonavin Webb,Nathan Coy,2016-02-21,1,0,11,-11,2.142857,4.5,0,0,0,0,-4.740005,4.740005,440,34,22,11,11,-11,-2.35714292526245,2.35714292526245,0,0,0,0,0,0,0,0,73,288,-215,215
Mark De La Rosa,Jordan Espinosa,Jordan Espinosa,2020-06-13,0,1,-5,5,2.2,1.666667,0,0,10,-10,-10.15999,10.15999,229,142,16,24,-8,8,0.533333420753479,-0.533333420753479,0,0,1,0,0,0,1,-1,119,0,119,-119
David Dvorak,Jordan Espinosa,David Dvorak,2020-09-19,1,0,-2,2,3.333333,1.666667,-2.539993,2.539993,0,0,-2.539993,2.539993,4,0,26,24,2,-2,1.66666662693024,-1.66666662693024,1,1,0,0,0,0,0,0,189,98,91,-91
Tim Elliott,Jordan Espinosa,Tim Elliott,2021-03-06,1,0,3,-3,1.666667,1.666667,2.539993,-2.539993,0,0,-7.619995,7.619995,799,0,32,24,8,-8,0,0,0,0,0,0,0,0,0,0,280,168,112,-112
TJ Brown,Jordan Griffin,Jordan Griffin,2020-02-29,0,1,-1,1,1.7,2,-2.540009,2.540009,0,0,-2.539993,2.539993,452,5,27,27,0,0,-0.299999952316284,0.299999952316284,0,0,0,0,0,0,0,0,0,0,0,0
Henrique da Silva,Jordan Johnson,Jordan Johnson,2017-01-28,0,1,-1,1,2.8,10,2.539993,-2.539993,0,0,-7.62001,7.62001,20,581,19,10,9,-9,-7.20000004768372,7.20000004768372,1,0,0,0,1,-1,0,0,238,0,238,-238
Marcel Fortuna,Jordan Johnson,Jordan Johnson,2017-07-07,0,1,3,-3,3,10,-2.540009,2.540009,0,0,-12.7,12.7,0,110,12,10,2,-2,-7,7,1,1,0,0,0,0,0,0,153,160,-7,7
Matt Brown,Jordan Mein,Matt Brown,2013-04-20,1,0,9,-9,1.368421,2.583333,0,0,0,0,5.080002,-5.080002,35,87,45,43,2,-2,-1.2149121761322,1.2149121761322,5,0,0,0,5,-5,0,0,133,0,133,-133
Thiago Alves,Jordan Mein,Thiago Alves,2015-01-31,1,0,6,-6,1.533333,2.583333,-7.62001,7.62001,0,0,-7.619995,7.619995,5,0,38,43,-5,5,-1.04999995231628,1.04999995231628,1,0,1,1,1,-1,0,0,287,651,-364,364
Emil Meek,Jordan Mein,Emil Meek,2016-12-10,1,0,1,-1,1.8,2.583333,-2.540009,2.540009,0,0,2.540009,-2.540009,504,98,14,43,-29,29,-0.783333301544189,0.783333301544189,0,0,0,2,0,0,-2,2,0,679,-679,679
Drew McFedries,Jordan Radev,Drew McFedries,2007-06-12,1,0,-2,2,1.714286,4.6,12.70001,-12.70001,0,0,9.880005,-9.880005,3,0,19,28,-9,9,-2.88571417331696,2.88571417331696,1,0,0,0,1,-1,0,0,206,0,206,-206
Dean Lister,Jordan Radev,Dean Lister,2007-12-29,1,0,0,0,1.857143,4.6,15.24001,-15.24001,0,0,17.5,-17.5,157,46,20,28,-8,8,-2.74285709857941,2.74285709857941,0,0,0,1,0,0,-1,1,338,200,138,-138
Alvaro Herrera Mendoza,Jordan Rinaldi,Jordan Rinaldi,2017-08-05,0,1,-2,2,1.5,2,5.080002,-5.080002,10,-10,5.080002,-5.080002,0,23,15,21,-6,6,-0.5,0.5,0,0,0,0,0,0,0,0,394,0,394,-394
Gregor Gillespie,Jordan Rinaldi,Gregor Gillespie,2018-01-27,1,0,1,-1,14,2,-7.62001,7.62001,10,-10,-2.540009,2.540009,223,0,15,21,-6,6,12,-12,2,1,0,0,1,-1,0,0,133,175,-42,42
Jason Knight,Jordan Rinaldi,Jordan Rinaldi,2018-11-03,0,1,-5,5,4,2,0,0,0,0,-2.540009,2.540009,12,705,25,21,4,-4,2,-2,0,0,1,1,0,0,0,0,462,280,182,-182
Arnold Allen,Jordan Rinaldi,Arnold Allen,2019-03-16,1,0,-6,6,9.5,2,-5.080002,5.080002,0,0,-5.080002,5.080002,59,0,21,21,0,0,7.5,-7.5,4,1,0,1,3,-3,-1,1,293,133,160,-160
Nassourdine Imavov,Jordan Williams,Nassourdine Imavov,2020-10-03,1,0,-4,4,3,1.5,5.080002,-5.080002,0,0,0,0,291,144,16,15,1,-1,1.5,-1.5,0,0,0,0,0,0,0,0,0,0,0,0
Mickey Gall,Jordan Williams,Mickey Gall,2021-07-24,1,0,-1,1,1.4,1.5,2.540009,-2.540009,-15,15,-2.539993,2.539993,58,4,12,15,-3,3,-0.100000023841858,0.100000023841858,0,0,1,0,0,0,1,-1,392,294,98,-98
Ian Garry,Jordan Williams,Ian Garry,2021-11-06,1,0,-8,8,13,1.5,5.080002,-5.080002,-15,15,-2.539993,2.539993,37,47,13,15,-2,2,11.5,-11.5,0,0,0,0,0,0,0,0,0,105,-105,105
Ike Villanueva,Jordan Wright,Jordan Wright,2020-08-22,0,1,8,-8,1.285714,2.4,-2.540009,2.540009,0,0,-10.16,10.16,58,13,32,17,15,-15,-1.11428582668304,1.11428582668304,0,0,0,0,0,0,0,0,0,0,0,0
Joaquin Buckley,Jordan Wright,Joaquin Buckley,2020-11-21,1,0,-3,3,2.666667,2.4,-10.16,10.16,-35,35,-2.540009,2.540009,109,2,22,17,5,-5,0.266666650772095,-0.266666650772095,1,1,1,0,0,0,1,-1,42,91,-49,49
Jamie Pickett,Jordan Wright,Jordan Wright,2021-05-15,0,1,3,-3,1.3,2.4,0,0,-20,20,7.619995,-7.619995,12,11,23,17,6,-6,-1.10000014305115,1.10000014305115,0,0,0,1,0,0,-1,1,0,175,-175,175
Bruno Silva,Jordan Wright,Bruno Silva,2021-12-11,1,0,2,-2,2.555556,2.4,-5.080002,5.080002,-20,20,-7.619995,7.619995,10,23,32,17,15,-15,0.155555486679077,-0.155555486679077,1,1,0,1,0,0,-1,1,175,210,-35,35
Marc-Andre Barriault,Jordan Wright,Marc-Andre Barriault,2022-04-23,1,0,2,-2,2.666667,2.4,-2.540009,2.540009,-20,20,-7.619995,7.619995,3,92,22,17,5,-5,0.266666650772095,-0.266666650772095,0,0,1,2,0,0,-1,1,77,133,-56,56
Dusko Todorovic,Jordan Wright,Dusko Todorovic,2022-10-15,1,0,-3,3,3,2.4,-2.540009,2.540009,-20,20,-7.619995,7.619995,71,303,16,17,-1,1,0.599999904632568,-0.599999904632568,1,0,0,2,1,-1,-2,2,742,175,567,-567
Zac Pauga,Jordan Wright,Zac Pauga,2023-02-18,1,0,3,-3,3.5,2.4,0,0,0,0,-2.540009,2.540009,520,13,9,17,-8,8,1.09999990463257,-1.09999990463257,0,0,1,3,0,0,-2,2,196,126,70,-70
Danny Abbadi,Jorge Gurgel,Jorge Gurgel,2006-09-23,0,1,-6,6,0.6666667,1.4,10.16,-10.16,0,0,7.240005,-7.240005,110,123,10,24,-14,14,-0.73333328962326,0.73333328962326,0,0,0,0,0,0,0,0,91,0,91,-91
Justin Edwards,Jorge Lopez,Justin Edwards,2011-09-17,1,0,6,-6,1.8,2.2,0,0,-15,15,-2.199997,2.199997,262,405,14,16,-2,2,-0.400000095367432,0.400000095367432,0,0,0,0,0,0,0,0,105,0,105,-105
Michael Chiesa,Jorge Masvidal,Jorge Masvidal,2013-07-27,0,1,-3,3,2.571429,2.058824,5.080002,-5.080002,0,0,2.539993,-2.539993,162,192,25,52,-27,27,0.512604951858521,-0.512604951858521,2,0,0,0,2,-2,0,0,154,0,154,-154
Rustam Khabilov,Jorge Masvidal,Rustam Khabilov,2013-11-06,1,0,-1,1,6,2.058824,-7.619995,7.619995,-15,15,-2.540009,2.540009,168,86,28,52,-24,24,3.94117641448975,-3.94117641448975,2,1,0,0,1,-1,0,0,193,102,91,-91
Pat Healy,Jorge Masvidal,Jorge Masvidal,2014-04-19,0,1,1,-1,1.478261,2.058824,2.540009,-2.540009,-15,15,-5.080002,5.080002,335,197,57,52,5,-5,-0.580562710762024,0.580562710762024,0,0,0,0,0,0,0,0,210,164,46,-46
Daron Cruickshank,Jorge Masvidal,Jorge Masvidal,2014-07-26,0,1,0,0,1.8,2.058824,-7.619995,7.619995,-15,15,-5.080002,5.080002,24,450,28,52,-24,24,-0.25882363319397,0.25882363319397,2,1,0,0,1,-1,0,0,77,98,-21,21
James Krause,Jorge Masvidal,Jorge Masvidal,2014-09-27,0,1,-1,1,3.111111,2.058824,7.62001,-7.62001,0,0,-2.540009,2.540009,102,180,37,52,-15,15,1.05228757858276,-1.05228757858276,2,2,0,0,0,0,0,0,126,63,63,-63
Al Iaquinta,Jorge Masvidal,Al Iaquinta,2015-04-04,1,0,-3,3,2,2.058824,-2.539993,2.539993,-15,15,-10.16,10.16,7,25,21,52,-31,31,-5.88235855102539e-02,5.88235855102539e-02,3,3,0,0,0,0,0,0,63,189,-126,126
Cezar Ferreira,Jorge Masvidal,Jorge Masvidal,2015-07-12,0,1,0,0,1.625,2.058824,5.080002,-5.080002,15,-15,10.15999,-10.15999,91,2,21,52,-31,31,-0.433823585510254,0.433823585510254,3,0,0,0,3,-3,0,0,610,99,511,-511
Benson Henderson,Jorge Masvidal,Benson Henderson,2015-11-28,1,0,1,-1,3.428571,2.058824,-5.080002,5.080002,0,0,-10.16,10.16,412,229,31,52,-21,21,1.36974787712097,-1.36974787712097,3,1,0,0,2,-2,0,0,287,139,148,-148
Lorenz Larkin,Jorge Masvidal,Lorenz Larkin,2016-05-29,1,0,-2,2,3,2.058824,0,0,0,0,-5.080002,5.080002,127,165,24,52,-28,28,0.941176414489746,-0.941176414489746,0,0,1,0,0,0,1,-1,148,183,-35,35
Jake Ellenberger,Jorge Masvidal,Jorge Masvidal,2016-12-03,0,1,-1,1,2.066667,2.058824,-5.080002,5.080002,0,0,-7.62001,7.62001,3,38,46,52,-6,6,7.843017578125e-03,-7.843017578125e-03,0,0,3,0,0,0,3,-3,308,188,120,-120
Donald Cerrone,Jorge Masvidal,Jorge Masvidal,2017-01-28,0,1,1,-1,2.117647,2.058824,5.080002,-5.080002,-15,15,-2.540009,2.540009,0,6,53,52,1,-1,5.88235855102539e-02,-5.88235855102539e-02,3,1,2,0,2,-2,2,-2,161,56,105,-105
Demian Maia,Jorge Masvidal,Demian Maia,2017-05-13,1,0,7,-7,2.545455,2.058824,5.080002,-5.080002,0,0,-5.080002,5.080002,533,53,39,52,-13,13,0.486630916595459,-0.486630916595459,2,2,1,0,0,0,1,-1,518,105,413,-413
Ben Askren,Jorge Masvidal,Jorge Masvidal,2019-07-06,0,1,0,0,9.5,2.058824,0,0,0,0,-2.540009,2.540009,0,2,21,52,-31,31,7.44117641448975,-7.44117641448975,1,0,0,0,1,-1,0,0,126,784,-658,658
Nate Diaz,Jorge Masvidal,Jorge Masvidal,2019-11-02,0,1,0,0,1.692308,2.058824,2.540009,-2.540009,0,0,5.079987,-5.079987,44,416,35,52,-17,17,-0.366515874862671,0.366515874862671,1,1,1,0,0,0,1,-1,77,119,-42,42
Colby Covington,Jorge Masvidal,Colby Covington,2022-03-05,1,0,-3,3,5.666667,2.058824,0,0,0,0,-5.080002,5.080002,974,21,20,52,-32,32,3.60784292221069,-3.60784292221069,0,2,1,0,-2,2,1,-1,119,854,-735,735
Gilbert Burns,Jorge Masvidal,Gilbert Burns,2023-04-08,1,0,-2,2,3.666667,2.058824,-2.539993,2.539993,0,0,-7.62001,7.62001,341,5,28,52,-24,24,1.60784316062927,-1.60784316062927,1,0,2,0,1,-1,2,-2,77,399,-322,322
Pat Miletich,Jorge Patino,Pat Miletich,1999-01-08,1,0,5,-5,4.142857,2,5.080002,-5.080002,0,0,2,-2,0,0,36,57,-21,21,2.14285707473755,-2.14285707473755,1,0,0,0,1,-1,0,0,301,0,301,-301
David Loiseau,Jorge Rivera,Jorge Rivera,2003-09-26,0,1,-8,8,2.090909,2.222222,-2.539993,2.539993,0,0,7.619995,-7.619995,29,328,34,29,5,-5,-0.131313323974609,0.131313323974609,1,0,0,0,1,-1,0,0,154,0,154,-154
Lee Murray,Jorge Rivera,Lee Murray,2004-01-31,1,0,-5,5,4,2.222222,5.080002,-5.080002,0,0,10.58,-10.58,0,87,10,29,-19,19,1.77777767181396,-1.77777767181396,0,1,0,0,-1,1,0,0,0,127,-127,127
Rich Franklin,Jorge Rivera,Rich Franklin,2004-10-22,1,0,-2,2,4.142857,2.222222,0,0,0,0,7.619995,-7.619995,575,50,36,29,7,-7,1.92063474655151,-1.92063474655151,1,0,0,0,1,-1,0,0,546,265,281,-281
Dennis Hallman,Jorge Rivera,Jorge Rivera,2005-10-07,0,1,-4,4,2.65,2.222222,-10.16,10.16,-30,30,-2.539993,2.539993,169,441,73,29,44,-44,0.427777767181396,-0.427777767181396,0,0,1,0,0,0,1,-1,475,350,125,-125
Chris Leben,Jorge Rivera,Chris Leben,2006-01-16,1,0,-8,8,2,2.222222,-5.080002,5.080002,0,0,0,0,43,27,33,29,4,-4,-0.222222328186035,0.222222328186035,1,1,0,0,0,0,0,0,282,101,181,-181
Edwin DeWees,Jorge Rivera,Jorge Rivera,2006-11-11,0,1,-10,10,2.235294,2.222222,0,0,0,0,2.580002,-2.580002,15,15,55,29,26,-26,1.30717754364014e-02,-1.30717754364014e-02,0,0,1,1,0,0,0,0,404,299,105,-105
Terry Martin,Jorge Rivera,Terry Martin,2007-02-03,1,0,-8,8,2.090909,2.222222,-12.7,12.7,0,0,-5.080002,5.080002,5,0,34,29,5,-5,-0.131313323974609,0.131313323974609,0,1,0,1,-1,1,-1,1,0,84,-84,84
Kendall Grove,Jorge Rivera,Jorge Rivera,2008-01-19,0,1,-10,10,1.352941,2.222222,12.7,-12.7,0,0,15.24001,-15.24001,0,65,40,29,11,-11,-0.86928117275238,0.86928117275238,2,0,0,2,2,-2,-2,2,466,350,116,-116
Martin Kampmann,Jorge Rivera,Martin Kampmann,2008-06-07,1,0,-10,10,2.857143,2.222222,-2.539993,2.539993,-15,15,-2.539993,2.539993,127,3,27,29,-2,2,0.634920597076416,-0.634920597076416,3,1,0,2,2,-2,-2,2,462,140,322,-322
Nissen Osterneck,Jorge Rivera,Jorge Rivera,2009-04-01,0,1,-10,10,3,2.222222,2.540009,-2.540009,0,0,2.580002,-2.580002,291,424,16,29,-13,13,0.777777671813965,-0.777777671813965,0,0,0,2,0,0,-2,2,0,298,-298,298
Rob Kimmons,Jorge Rivera,Jorge Rivera,2009-10-24,0,1,-9,9,2.777778,2.222222,-7.619995,7.619995,0,0,0,0,179,439,34,29,5,-5,0.55555534362793,-0.55555534362793,1,1,0,2,0,0,-2,2,206,206,0,0
Nate Quarry,Jorge Rivera,Jorge Rivera,2010-03-31,0,1,0,0,3,2.222222,-2.539993,2.539993,0,0,-2.539993,2.539993,0,89,16,29,-13,13,0.777777671813965,-0.777777671813965,4,2,0,2,2,-2,-2,2,711,158,553,-553
Michael Bisping,Jorge Rivera,Michael Bisping,2011-02-26,1,0,-7,7,3.333333,2.222222,0,0,0,0,5.080002,-5.080002,77,0,39,29,10,-10,1.11111092567444,-1.11111092567444,1,3,1,2,-2,2,-1,1,273,332,-59,59
Constantinos Philippou,Jorge Rivera,Constantinos Philippou,2011-08-06,1,0,-8,8,2.6,2.222222,-5.080002,5.080002,0,0,0,0,335,306,18,29,-11,11,0.377777576446533,-0.377777576446533,0,0,0,3,0,0,-3,3,0,161,-161,161
Justin Levens,Jorge Santiago,Jorge Santiago,2006-06-28,0,1,1,-1,1.428571,2.083333,-5.080002,5.080002,15,-15,-7.5,7.5,10,70,17,37,-20,20,-0.654761791229248,0.654761791229248,0,0,0,0,0,0,0,0,74,0,74,-74
Chris Leben,Jorge Santiago,Chris Leben,2006-08-17,1,0,1,-1,2,2.083333,-5.080002,5.080002,15,-15,-5.080002,5.080002,136,70,33,37,-4,4,-8.33332538604736e-02,8.33332538604736e-02,0,1,1,0,-1,1,1,-1,50,50,0,0
Alan Belcher,Jorge Santiago,Alan Belcher,2006-12-13,1,0,-4,4,2.25,2.083333,2.540009,-2.540009,15,-15,0,0,259,145,26,37,-11,11,0.166666746139526,-0.166666746139526,0,0,0,1,0,0,-1,1,109,118,-9,9
Demian Maia,Jorge Santiago,Demian Maia,2011-10-08,1,0,3,-3,2.545455,2.083333,0,0,0,0,-7.619995,7.619995,553,29,39,37,2,-2,0.462121248245239,-0.462121248245239,0,0,1,2,0,0,-1,1,119,1760,-1641,1641
Gunnar Nelson,Jorge Santiago,Gunnar Nelson,2013-02-16,1,0,-8,8,3.8,2.083333,-5.080002,5.080002,0,0,-7.619995,7.619995,338,12,24,37,-13,13,1.71666669845581,-1.71666669845581,0,0,0,2,0,0,-2,2,0,497,-497,497
"Da'Mon Blackshear",Jose Johnson,"Da'Mon Blackshear",2023-08-12,1,0,1,-1,2.333333,1.875,-5.080002,5.080002,0,0,2.540009,-2.540009,177,0,20,23,-3,3,0.458333253860474,-0.458333253860474,1,0,0,0,1,-1,0,0,70,0,70,-70
John Lineker,Jose Maria,John Lineker,2013-08-03,1,0,-8,8,3.444444,5.285714,-5.080002,5.080002,10,-10,0.1799927,-0.1799927,51,33,40,44,-4,4,-1.84126973152161,1.84126973152161,1,0,0,0,1,-1,0,0,266,0,266,-266
Alejandro Perez,Jose Quinonez,Alejandro Perez,2014-11-15,1,0,1,-1,2.555556,1.8,-5.080002,5.080002,0,0,-5.080002,5.080002,26,208,32,14,18,-18,0.755555629730225,-0.755555629730225,0,0,0,0,0,0,0,0,0,0,0,0
Leonardo Morales,Jose Quinonez,Jose Quinonez,2015-06-06,0,1,-2,2,3,1.8,0,0,0,0,-10.25999,10.25999,0,131,8,14,-6,6,1.20000004768372,-1.20000004768372,0,0,0,0,0,0,0,0,203,203,0,0
Joey Gomez,Jose Quinonez,Jose Quinonez,2016-09-17,0,1,1,-1,7,1.8,5.080002,-5.080002,20,-20,5.080002,-5.080002,16,277,8,14,-6,6,5.20000004768372,-5.20000004768372,0,1,0,0,-1,1,0,0,0,469,-469,469
Teruto Ishihara,Jose Quinonez,Jose Quinonez,2018-02-10,0,1,-1,1,1.428571,1.8,-2.540009,2.540009,0,0,0,0,25,201,17,14,3,-3,-0.371428489685059,0.371428489685059,0,2,0,0,-2,2,0,0,218,511,-293,293
Carlos Huachin,Jose Quinonez,Jose Quinonez,2019-09-21,0,1,-6,6,2,1.8,-10.16,10.16,0,0,-5.080002,5.080002,0,253,15,14,1,-1,0.200000047683716,-0.200000047683716,0,3,0,0,-3,3,0,0,0,588,-588,588
"Sean O'Malley",Jose Quinonez,"Sean O'Malley",2020-03-07,1,0,-4,4,17,1.8,7.619995,-7.619995,0,0,7.62001,-7.62001,2,0,18,14,4,-4,15.2000000476837,-15.2000000476837,2,4,0,0,-2,2,0,0,735,168,567,-567
Jarred Brooks,Jose Torres,Jose Torres,2018-06-01,0,1,0,0,6.5,8,-2.539993,2.539993,0,0,-7.62001,7.62001,193,42,15,9,6,-6,-1.5,1.5,0,0,0,0,0,0,0,0,216,0,216,-216
Alex Perez,Jose Torres,Alex Perez,2018-08-04,1,0,0,0,3.428571,8,5.080002,-5.080002,0,0,0,0,3,0,31,9,22,-22,-4.57142853736877,4.57142853736877,1,1,0,0,0,0,0,0,161,64,97,-97
Jessica-Rose Clark,Joselyne Edwards,Jessica-Rose Clark,2021-10-23,1,0,7,-7,1.222222,2.6,-7.619995,7.619995,0,0,-15.24001,15.24001,700,98,20,18,2,-2,-1.37777769565582,1.37777769565582,0,0,0,0,0,0,0,0,714,0,714,-714
Nora Cornolle,Joselyne Edwards,Nora Cornolle,2023-09-02,1,0,6,-6,7,2.6,-2.540009,2.540009,0,0,-7.62001,7.62001,131,522,8,18,-10,10,4.40000009536743,-4.40000009536743,0,0,0,0,0,0,0,0,0,679,-679,679
Ali Bagautinov,Joseph Benavidez,Joseph Benavidez,2015-10-03,0,1,-1,1,2.5,3.5,0,0,0,0,0,0,19,0,21,36,-15,15,-1,1,0,0,0,0,0,0,0,0,476,0,476,-476
Askar Askarov,Joseph Benavidez,Askar Askarov,2021-03-06,1,0,-8,8,14,3.5,5.080002,-5.080002,0,0,5.079987,-5.079987,300,0,15,36,-21,21,10.5,-10.5,2,1,0,0,1,-1,0,0,231,1981,-1750,1750
Alen Amedovski,Joseph Holmes,Joseph Holmes,2022-05-21,0,1,8,-8,2,2,-15.23999,15.23999,0,0,-15.23999,15.23999,0,21,12,12,0,0,0,0,0,0,1,0,0,0,1,-1,966,0,966,-966
Deiveson Figueiredo,Joseph Morales,Deiveson Figueiredo,2018-02-03,1,0,7,-7,7,4.5,-2.539993,2.539993,0,0,-2.539993,2.539993,363,0,24,11,13,-13,2.5,-2.5,0,0,0,0,0,0,0,0,0,0,0,0
Nick Denis,Joseph Sandoval,Nick Denis,2012-01-20,1,0,3,-3,3.666667,1,0,0,0,0,0,0,1,0,14,14,0,0,2.66666674613953,-2.66666674613953,0,0,0,0,0,0,0,0,0,0,0,0
Andrei Arlovski,Josh Barnett,Josh Barnett,2016-09-03,0,1,-1,1,1.545455,4.375,0,0,-10,10,-2.539993,2.539993,142,392,56,43,13,-13,-2.82954549789429,2.82954549789429,0,0,5,0,0,0,5,-5,118,0,118,-118
SeungWoo Choi,Josh Culibao,Josh Culibao,2022-06-11,0,1,1,-1,1.833333,5.5,5.080002,-5.080002,0,0,2.540009,-2.540009,150,58,17,13,4,-4,-3.66666662693024,3.66666662693024,3,0,0,0,3,-3,0,0,357,0,357,-357
Melsik Baghdasaryan,Josh Culibao,Josh Culibao,2023-02-11,0,1,3,-3,4,5.5,-2.540009,2.540009,0,0,-7.619995,7.619995,0,14,10,13,-3,3,-1.5,1.5,1,1,0,0,0,0,0,0,462,245,217,-217
Felipe Arantes,Josh Emmett,Josh Emmett,2017-10-21,0,1,-3,3,1.8,4.5,5.080002,-5.080002,-10,10,7.619995,-7.619995,0,165,28,22,6,-6,-2.70000004768372,2.70000004768372,0,0,0,0,0,0,0,0,350,0,350,-350
Mirsad Bektic,Josh Emmett,Josh Emmett,2019-07-13,0,1,-6,6,3.25,4.5,5.080002,-5.080002,0,0,0,0,0,29,17,22,-5,5,-1.25,1.25,2,1,1,0,1,-1,1,-1,399,630,-231,231
Shane Burgos,Josh Emmett,Josh Emmett,2020-06-20,0,1,-6,6,5,4.5,12.7,-12.7,0,0,12.7,-12.7,0,84,18,22,-4,4,0.5,-0.5,2,2,1,0,0,0,1,-1,413,343,70,-70
Roland Delorme,Josh Ferguson,Roland Delorme,2011-12-03,1,0,4,-4,1.8,2,10.15999,-10.15999,10,-10,12.34,-12.34,88,299,14,15,-1,1,-0.200000047683716,0.200000047683716,0,0,0,0,0,0,0,0,0,0,0,0
Chris Cariaso,Josh Ferguson,Chris Cariaso,2012-07-11,1,0,7,-7,2.125,2,-5.080002,5.080002,0,0,-5.440002,5.440002,258,231,25,15,10,-10,0.125,-0.125,2,0,0,0,2,-2,0,0,137,221,-84,84
Sedriques Dumas,Josh Fremd,Josh Fremd,2023-03-11,0,1,-2,2,8,2.2,-5.079987,5.079987,0,0,7.62001,-7.62001,7,267,9,16,-7,7,5.79999995231628,-5.79999995231628,0,0,0,0,0,0,0,0,0,0,0,0
Michael Bisping,Josh Haynes,Michael Bisping,2006-06-24,1,0,-1,1,3.333333,1.272727,10.16,-10.16,15,-15,12.5,-12.5,329,53,39,25,14,-14,2.06060600280762,-2.06060600280762,0,0,0,0,0,0,0,0,0,0,0,0
Luke Cummo,Josh Haynes,Luke Cummo,2007-04-07,1,0,-3,3,1,1.272727,7.62001,-7.62001,0,0,9.960007,-9.960007,29,23,12,25,-13,13,-0.272727251052856,0.272727251052856,0,0,0,1,0,0,-1,1,283,287,-4,4
Gabriel Gonzaga,Josh Hendricks,Gabriel Gonzaga,2008-11-15,1,0,-3,3,1.545455,1.727273,0,0,7,-7,2.039993,-2.039993,4,0,28,30,-2,2,-0.181818246841431,0.181818246841431,1,0,1,0,1,-1,1,-1,133,0,133,-133
Drew Fickett,Josh Koscheck,Drew Fickett,2005-10-03,1,0,-2,2,2,1.545455,0,0,-15,15,-7.619995,7.619995,16,754,63,28,35,-35,0.454545497894287,-0.454545497894287,1,0,0,0,1,-1,0,0,58,0,58,-58
Ansar Chalangov,Josh Koscheck,Josh Koscheck,2006-04-06,0,1,-2,2,2.8,1.545455,-2.540009,2.540009,0,0,8.580002,-8.580002,8,165,19,28,-9,9,1.25454545021057,-1.25454545021057,0,0,0,0,0,0,0,0,0,185,-185,185
Jonathan Goulet,Josh Koscheck,Josh Koscheck,2006-08-17,0,1,-1,1,1.916667,1.545455,5.080002,-5.080002,0,0,0,0,0,217,35,28,7,-7,0.371212124824524,-0.371212124824524,0,1,1,0,-1,1,1,-1,213,133,80,-80
Jeff Joslin,Josh Koscheck,Josh Koscheck,2006-12-13,0,1,2,-2,1.666667,1.545455,5.080002,-5.080002,0,0,-7.419998,7.419998,0,556,8,28,-20,20,0.121212124824524,-0.121212124824524,0,2,0,0,-2,2,0,0,0,118,-118,118
Dustin Hazelett,Josh Koscheck,Josh Koscheck,2008-03-01,0,1,-9,9,1.714286,1.545455,7.619995,-7.619995,0,0,7.619995,-7.619995,0,72,19,28,-9,9,0.1688312292099,-0.1688312292099,2,3,0,0,-1,1,0,0,259,444,-185,185
Thiago Alves,Josh Koscheck,Thiago Alves,2008-10-25,1,0,-5,5,1.533333,1.545455,-2.540009,2.540009,0,0,-7.619995,7.619995,17,158,38,28,10,-10,-1.21212005615234e-02,1.21212005615234e-02,5,4,1,0,1,-1,1,-1,140,238,-98,98
Anthony Johnson,Josh Koscheck,Josh Koscheck,2009-11-21,0,1,-6,6,3.666667,1.545455,10.16,-10.16,35,-35,12.7,-12.7,43,239,28,28,0,0,2.12121224403381,-2.12121224403381,3,0,0,0,3,-3,0,0,28,392,-364,364
Paul Daley,Josh Koscheck,Josh Koscheck,2010-05-08,0,1,-5,5,2.6,1.545455,-2.540009,2.540009,0,0,7.619995,-7.619995,2,722,54,28,26,-26,1.05454540252686,-1.05454540252686,2,1,0,0,1,-1,0,0,126,168,-42,42
Matt Hughes,Josh Koscheck,Josh Koscheck,2011-09-24,0,1,4,-4,5,1.545455,-2.540009,2.540009,0,0,0,0,0,17,54,28,26,-26,3.45454549789429,-3.45454549789429,0,2,2,0,-2,2,2,-2,308,504,-196,196
Johny Hendricks,Josh Koscheck,Johny Hendricks,2012-05-05,1,0,-6,6,2.25,1.545455,-2.540009,2.540009,15,-15,-10.16,10.16,151,206,26,28,-2,2,0.704545497894287,-0.704545497894287,2,3,0,0,-1,1,0,0,273,224,49,-49
Jake Ellenberger,Josh Koscheck,Jake Ellenberger,2015-02-28,1,0,-8,8,2.066667,1.545455,-2.540009,2.540009,0,0,-5.080002,5.080002,22,212,46,28,18,-18,0.521212100982666,-0.521212100982666,0,0,2,0,0,0,2,-2,105,1029,-924,924
Drew Fickett,Josh Neer,Drew Fickett,2005-08-06,1,0,3,-3,2,2.25,-2.539993,2.539993,-15,15,-5.080002,5.080002,70,0,63,52,11,-11,-0.25,0.25,0,0,0,0,0,0,0,0,0,0,0,0
Melvin Guillard,Josh Neer,Josh Neer,2006-01-16,0,1,0,0,1.777778,2.25,-5.080002,5.080002,-15,15,-2.540009,2.540009,103,51,50,52,-2,2,-0.472222208976746,0.472222208976746,0,0,0,0,0,0,0,0,0,163,-163,163
Joshua Burkman,Josh Neer,Joshua Burkman,2006-07-08,1,0,3,-3,1.75,2.25,-2.539993,2.539993,0,0,0,0,405,190,44,52,-8,8,-0.5,0.5,0,1,0,0,-1,1,0,0,93,173,-80,80
Nick Diaz,Josh Neer,Nick Diaz,2006-08-26,1,0,0,0,2.6,2.25,5.080002,-5.080002,0,0,10.15999,-10.15999,121,70,36,52,-16,16,0.349999904632568,-0.349999904632568,0,0,0,0,0,0,0,0,133,49,84,-84
Nate Diaz,Josh Neer,Nate Diaz,2008-09-17,1,0,-2,2,1.692308,2.25,2.540009,-2.540009,0,0,10.15999,-10.15999,449,336,35,52,-17,17,-0.557692289352417,0.557692289352417,3,0,0,0,3,-3,0,0,168,753,-585,585
Mac Danzig,Josh Neer,Josh Neer,2009-02-07,0,1,4,-4,1.75,2.25,-7.619995,7.619995,-15,15,-5.080002,5.080002,178,133,33,52,-19,19,-0.5,0.5,0,0,0,0,0,0,0,0,143,143,0,0
Duane Ludwig,Josh Neer,Josh Neer,2012-01-20,0,1,5,-5,1.5,2.25,-2.539993,2.539993,0,0,-5.080002,5.080002,10,69,35,52,-17,17,-0.75,0.75,2,1,0,0,1,-1,0,0,159,1077,-918,918
Justin Edwards,Josh Neer,Justin Edwards,2012-10-05,1,0,0,0,1.8,2.25,-2.539993,2.539993,-15,15,-5.080002,5.080002,8,20,14,52,-38,38,-0.450000047683716,0.450000047683716,0,2,0,0,-2,2,0,0,335,259,76,-76
Court McGee,Josh Neer,Court McGee,2013-02-23,1,0,-1,1,1.833333,2.25,0,0,0,0,7.619995,-7.619995,288,4,34,52,-18,18,-0.416666626930237,0.416666626930237,0,0,0,0,0,0,0,0,217,141,76,-76
Roque Martinez,Josh Parisian,Josh Parisian,2021-06-19,0,1,4,-4,1.875,2.142857,-15.23999,15.23999,-15,15,-17.78,17.78,259,263,23,22,1,-1,-0.267857074737549,0.267857074737549,0,0,0,0,0,0,0,0,217,0,217,-217
"Don'Tale Mayes",Josh Parisian,"Don'Tale Mayes",2021-12-18,1,0,-3,3,2,2.142857,5.080002,-5.080002,-5,5,5.080002,-5.080002,692,21,15,22,-7,7,-0.142857074737549,0.142857074737549,0,1,0,0,-1,1,0,0,581,182,399,-399
Alan Baudot,Josh Parisian,Josh Parisian,2022-06-25,0,1,2,-2,2.666667,2.142857,-2.539993,2.539993,-22,22,0,0,103,189,11,22,-11,11,0.523809671401978,-0.523809671401978,0,0,0,1,0,0,-1,1,126,189,-63,63
Martin Buday,Josh Parisian,Martin Buday,2023-08-12,1,0,-3,3,13,2.142857,0,0,0,0,-5.080002,5.080002,116,13,14,22,-8,8,10.8571429252625,-10.8571429252625,1,1,0,1,0,0,-1,1,105,413,-308,308
Alex Karalexis,Josh Rafferty,Alex Karalexis,2005-04-09,1,0,3,-3,1.666667,1.125,-10.16,10.16,-15,15,-17.36,17.36,63,0,16,17,-1,1,0.541666626930237,-0.541666626930237,0,0,0,0,0,0,0,0,0,0,0,0
Kevin Casey,Josh Samman,Josh Samman,2013-04-13,0,1,6,-6,1.8,3.25,-10.16,10.16,0,0,-5.080002,5.080002,193,137,14,17,-3,3,-1.45000004768372,1.45000004768372,0,0,0,0,0,0,0,0,0,0,0,0
Eddie Gordon,Josh Samman,Josh Samman,2014-12-06,0,1,5,-5,2,3.25,-7.619995,7.619995,0,0,-7.62001,7.62001,393,16,12,17,-5,5,-1.25,1.25,1,1,0,0,0,0,0,0,153,602,-449,449
Caio Magalhaes,Josh Samman,Josh Samman,2015-07-12,0,1,0,0,3.333333,3.25,-5.080002,5.080002,0,0,-15.24001,15.24001,0,70,13,17,-4,4,8.33332538604736e-02,-8.33332538604736e-02,4,2,0,0,2,-2,0,0,246,218,28,-28
Tamdan McCrory,Josh Samman,Tamdan McCrory,2015-12-19,1,0,2,-2,2.8,3.25,2.539993,-2.539993,0,0,-7.62001,7.62001,438,380,19,17,2,-2,-0.450000047683716,0.450000047683716,1,3,0,0,-2,2,0,0,3112,160,2952,-2952
Tim Boetsch,Josh Samman,Tim Boetsch,2016-07-13,1,0,7,-7,1.615385,3.25,-7.619995,7.619995,0,0,-12.7,12.7,261,127,34,17,17,-17,-1.63461542129517,1.63461542129517,0,0,4,0,0,0,4,-4,178,207,-29,29
Ryan Benoit,Josh Sampo,Josh Sampo,2013-11-30,0,1,-5,5,1.25,2.2,2.540009,-2.540009,0,0,10.16,-10.16,141,251,18,16,2,-2,-0.950000047683716,0.950000047683716,0,0,0,0,0,0,0,0,0,0,0,0
Zach Makovsky,Josh Sampo,Zach Makovsky,2014-02-22,1,0,1,-1,2.5,2.2,0,0,0,0,0,0,327,90,28,16,12,-12,0.299999952316284,-0.299999952316284,0,1,0,0,-1,1,0,0,0,84,-84,84
Paddy Holohan,Josh Sampo,Paddy Holohan,2014-07-19,1,0,-3,3,6,2.2,15.24001,-15.24001,0,0,12.7,-12.7,113,0,14,16,-2,2,3.79999995231628,-3.79999995231628,0,0,0,0,0,0,0,0,0,147,-147,147
Jason Saggo,Josh Shockley,Jason Saggo,2014-06-14,1,0,4,-4,3,2.75,-5.080002,5.080002,0,0,-7.660004,7.660004,221,33,16,15,1,-1,0.25,-0.25,0,0,0,0,0,0,0,0,0,0,0,0
Ivan Jorge,Josh Shockley,Ivan Jorge,2015-02-22,1,0,9,-9,3.857143,2.75,-10.16,10.16,0,0,-2.580002,2.580002,367,82,34,15,19,-19,1.10714292526245,-1.10714292526245,1,0,0,1,1,-1,-1,1,536,253,283,-283
"Jake O'Brien",Josh Shockman,"Jake O'Brien",2006-11-18,1,0,-3,3,3.75,2,-2.539993,2.539993,-30,30,-2.960007,2.960007,622,27,19,9,10,-10,1.75,-1.75,0,0,0,0,0,0,0,0,0,0,0,0
Cory Hendricks,Josh Stansbury,Josh Stansbury,2016-07-08,0,1,-3,3,3,0.5,2.539993,-2.539993,0,0,5.039993,-5.039993,18,468,4,12,-8,8,2.5,-2.5,0,0,0,0,0,0,0,0,0,0,0,0
Devin Clark,Josh Stansbury,Devin Clark,2016-12-03,1,0,-6,6,1.75,0.5,-5.080002,5.080002,0,0,2.539993,-2.539993,280,231,22,12,10,-10,1.25,-1.25,0,1,1,0,-1,1,1,-1,143,148,-5,5
Jeremy Kimball,Josh Stansbury,Jeremy Kimball,2017-06-25,1,0,-6,6,1.875,0.5,-5.080002,5.080002,0,0,-5.080002,5.080002,8,23,23,12,11,-11,1.375,-1.375,0,0,1,0,0,0,1,-1,148,204,-56,56
Laverne Clark,Josh Stuart,Laverne Clark,1998-03-13,1,0,,,1.285714,0.25,5.080002,-5.080002,10,-10,3,-3,0,0,48,5,43,-43,1.03571426868439,-1.03571426868439,0,0,0,0,0,0,0,0,0,0,0,0
Gerald Strebendt,Josh Thomson,Josh Thomson,2003-09-26,0,1,-1,1,1.285714,2.444444,-2.540009,2.540009,0,0,-2.339996,2.339996,0,147,16,31,-15,15,-1.1587301492691,1.1587301492691,0,0,0,0,0,0,0,0,0,0,0,0
Hermes Franca,Josh Thomson,Josh Thomson,2004-01-31,0,1,4,-4,1.411765,2.444444,-10.16,10.16,0,0,0,0,319,245,41,31,10,-10,-1.03267967700958,1.03267967700958,1,1,0,0,0,0,0,0,127,127,0,0
Yves Edwards,Josh Thomson,Yves Edwards,2004-08-21,1,0,2,-2,1.909091,2.444444,-2.540009,2.540009,0,0,5.080002,-5.080002,40,97,64,31,33,-33,-0.535353541374207,0.535353541374207,3,2,0,0,1,-1,0,0,141,203,-62,62
Nate Diaz,Josh Thomson,Josh Thomson,2013-04-20,0,1,-6,6,1.692308,2.444444,5.080002,-5.080002,15,-15,12.7,-12.7,54,81,35,31,4,-4,-0.752136707305908,0.752136707305908,0,0,0,1,0,0,-1,1,133,3164,-3031,3031
Benson Henderson,Josh Thomson,Benson Henderson,2014-01-25,1,0,-5,5,3.428571,2.444444,-2.540009,2.540009,15,-15,-2.539993,2.539993,300,472,31,31,0,0,0.984127044677734,-0.984127044677734,0,1,0,1,-1,1,-1,1,147,280,-133,133
Bobby Green,Josh Thomson,Bobby Green,2014-07-26,1,0,-8,8,2.142857,2.444444,0,0,0,0,0,0,52,19,44,31,13,-13,-0.301587343215942,0.301587343215942,3,0,0,1,3,-3,-1,1,224,182,42,-42
Tony Ferguson,Josh Thomson,Tony Ferguson,2015-07-15,1,0,-5,5,2.888889,2.444444,2.539993,-2.539993,0,0,12.7,-12.7,105,152,35,31,4,-4,0.444444417953491,-0.444444417953491,4,0,0,1,4,-4,-1,1,137,354,-217,217
Christian Rodriguez,Joshua Weems,Christian Rodriguez,2022-10-29,1,0,-4,4,9,3.666667,-2.540009,2.540009,0,0,5.080002,-5.080002,56,63,10,14,-4,4,5.33333325386047,-5.33333325386047,0,0,0,0,0,0,0,0,0,0,0,0
Bea Malecki,Josiane Nunes,Josiane Nunes,2021-08-21,0,1,2,-2,4,10,17.78,-17.78,-10,10,17.78001,-17.78001,0,5,5,11,-6,6,-6,6,1,0,0,0,1,-1,0,0,812,0,812,-812
Zarah Fairn,Josiane Nunes,Josiane Nunes,2023-01-21,0,1,10,-10,1,10,15.24001,-15.24001,-10,10,12.70001,-12.70001,8,122,12,11,1,-1,-9,9,0,1,1,0,-1,1,1,-1,1057,518,539,-539
Randy Costa,Journey Newson,Randy Costa,2020-09-19,1,0,-5,5,1.5,2,10.15999,-10.15999,0,0,15.24001,-15.24001,2,0,10,15,-5,5,-0.5,0.5,1,0,0,0,1,-1,0,0,337,0,337,-337
Fernie Garcia,Journey Newson,Journey Newson,2022-05-07,0,1,-3,3,2.5,2,5.079987,-5.079987,0,0,0,0,2,42,14,15,-1,1,0.5,-0.5,0,0,0,1,0,0,-1,1,0,595,-595,595
Sergey Morozov,Journey Newson,Sergey Morozov,2022-12-17,1,0,0,0,3.8,2,2.539993,-2.539993,0,0,0,0,419,0,24,15,9,-9,1.79999995231628,-1.79999995231628,1,1,0,1,0,0,-1,1,175,224,-49,49
Marcus McGhee,Journey Newson,Marcus McGhee,2023-04-29,1,0,-2,2,8,2,7.619995,-7.619995,0,0,5.080002,-5.080002,31,63,9,15,-6,6,6,-6,0,0,0,1,0,0,-1,1,0,133,-133,133
Dooho Choi,Juan Manuel Puig,Dooho Choi,2014-11-22,1,0,-2,2,3.5,2.75,2.540009,-2.540009,0,0,-0.1999969,0.1999969,6,0,18,15,3,-3,0.75,-0.75,0,0,0,0,0,0,0,0,0,0,0,0
David Dvorak,Juancamilo Ronderos,David Dvorak,2021-05-22,1,0,2,-2,3.333333,2,5.080002,-5.080002,0,0,10.16,-10.16,23,0,26,6,20,-20,1.33333325386047,-1.33333325386047,2,0,0,0,2,-2,0,0,245,0,245,-245
Clayton Carpenter,Juancamilo Ronderos,Clayton Carpenter,2023-02-18,1,0,-2,2,7,2,7.619995,-7.619995,0,0,5.080002,-5.080002,79,82,7,6,1,-1,5,-5,0,0,0,0,0,0,0,0,0,637,-637,637
Grant Dawson,Julian Erosa,Grant Dawson,2019-03-09,1,0,-4,4,20,2.333333,-7.619995,7.619995,10,-10,-5.080002,5.080002,607,17,21,40,-19,19,17.6666667461395,-17.6666667461395,0,0,0,0,0,0,0,0,0,0,0,0
Julio Arce,Julian Erosa,Julio Arce,2019-05-18,1,0,0,0,3,2.333333,-15.24001,15.24001,-10,10,-10.16,10.16,13,33,24,40,-16,16,0.666666746139526,-0.666666746139526,0,0,0,0,0,0,0,0,196,70,126,-126
SeungWoo Choi,Julian Erosa,SeungWoo Choi,2021-06-19,1,0,-3,3,1.833333,2.333333,-2.539993,2.539993,0,0,0,0,3,0,17,40,-23,23,-0.49999988079071,0.49999988079071,2,0,0,1,2,-2,-1,1,133,763,-630,630
Hakeem Dawodu,Julian Erosa,Julian Erosa,2022-09-10,0,1,-2,2,3.25,2.333333,-12.7,12.7,0,0,-2.540009,2.540009,12,262,17,40,-23,23,0.916666746139526,-0.916666746139526,1,0,0,2,1,-1,-2,2,217,448,-231,231
Alex Caceres,Julian Erosa,Alex Caceres,2022-12-17,1,0,1,-1,1.5,2.333333,-7.619995,7.619995,0,0,-2.540009,2.540009,5,0,35,40,-5,5,-0.833333253860474,0.833333253860474,0,1,1,2,-1,1,-1,1,280,98,182,-182
Alessio Di Chirico,Julian Marquez,Alessio Di Chirico,2018-07-06,1,0,0,0,1.857143,2.25,-5.080002,5.080002,0,0,5.080002,-5.080002,238,3,20,13,7,-7,-0.392857193946838,0.392857193946838,0,0,0,0,0,0,0,0,524,0,524,-524
Sam Alvey,Julian Marquez,Julian Marquez,2021-04-10,0,1,4,-4,1.833333,2.25,0,0,0,0,7.619995,-7.619995,5,16,51,13,38,-38,-0.416666626930237,0.416666626930237,0,0,3,0,0,0,3,-3,336,1009,-673,673
Marc-Andre Barriault,Julian Marquez,Marc-Andre Barriault,2023-03-04,1,0,1,-1,2.666667,2.25,-2.540009,2.540009,0,0,5.080002,-5.080002,89,0,22,13,9,-9,0.416666746139526,-0.416666746139526,0,1,1,0,-1,1,1,-1,168,693,-525,525
Mark Coleman,Julian Sanchez,Mark Coleman,1996-09-20,1,0,,,1.6,0,-5.080002,5.080002,-95,95,-2.5,2.5,0,0,26,1,25,-25,1.60000002384186,-1.60000002384186,3,0,0,0,3,-3,0,0,70,0,70,-70
Joanna Jedrzejczyk,Juliana Lima,Joanna Jedrzejczyk,2014-07-26,1,0,-6,6,3.2,1.8,2.539993,-2.539993,0,0,0,0,9,370,21,14,7,-7,1.40000009536743,-1.40000009536743,0,0,0,0,0,0,0,0,0,0,0,0
Ericka Almeida,Juliana Lima,Juliana Lima,2015-05-30,0,1,-7,7,2.333333,1.8,2.539993,-2.539993,0,0,5.899994,-5.899994,33,591,10,14,-4,4,0.533333301544189,-0.533333301544189,0,0,0,0,0,0,0,0,0,308,-308,308
Carla Esparza,Juliana Lima,Carla Esparza,2016-04-23,1,0,-6,6,2.857143,1.8,-10.16,10.16,0,0,-5.080002,5.080002,575,134,27,14,13,-13,1.05714297294617,-1.05714297294617,0,1,1,0,-1,1,1,-1,406,329,77,-77
JJ Aldrich,Juliana Lima,Juliana Lima,2016-12-09,0,1,-10,10,2,1.8,0,0,10,-10,5.079987,-5.079987,46,424,18,14,4,-4,0.200000047683716,-0.200000047683716,0,0,0,0,0,0,0,0,0,230,-230,230
Veronica Hardy,Juliana Miller,Veronica Hardy,2023-03-18,1,0,1,-1,1.75,1.333333,-7.619995,7.619995,0,0,-5.080002,5.080002,456,79,11,7,4,-4,0.416666626930237,-0.416666626930237,0,0,0,0,0,0,0,0,1099,0,1099,-1099
Milana Dudieva,Julianna Pena,Julianna Pena,2015-04-04,0,1,0,0,1.833333,2.4,-7.619995,7.619995,0,0,-12.25999,12.25999,43,175,17,17,0,0,-0.566666722297668,0.566666722297668,1,0,0,0,1,-1,0,0,224,0,224,-224
Jessica Eye,Julianna Pena,Julianna Pena,2015-10-03,0,1,3,-3,1.363636,2.4,0,0,-10,10,-7.619995,7.619995,344,438,26,17,9,-9,-1.03636372089386,1.03636372089386,0,1,0,0,-1,1,0,0,70,182,-112,112
Nicco Montano,Julianna Pena,Julianna Pena,2019-07-13,0,1,1,-1,1.666667,2.4,-2.539993,2.539993,0,0,-10.15999,10.15999,372,277,8,17,-9,9,-0.733333468437195,0.733333468437195,0,2,0,0,-2,2,0,0,0,1379,-1379,1379
Germaine de Randamie,Julianna Pena,Germaine de Randamie,2020-10-03,1,0,5,-5,2.5,2.4,7.619995,-7.619995,0,0,5.080002,-5.080002,48,355,14,17,-3,3,9.99999046325684e-02,-9.99999046325684e-02,0,3,1,0,-3,3,1,-1,294,448,-154,154
Sara McMann,Julianna Pena,Julianna Pena,2021-01-23,0,1,9,-9,2.166667,2.4,0,0,0,0,-7.619995,7.619995,441,175,19,17,2,-2,-0.233333349227905,0.233333349227905,0,0,1,0,0,0,1,-1,1064,112,952,-952
Amanda Nunes,Julianna Pena,Julianna Pena,2021-12-11,0,1,1,-1,4.6,2.4,5.080002,-5.080002,0,0,0,0,215,25,28,17,11,-11,2.19999980926514,-2.19999980926514,6,1,1,0,5,-5,1,-1,553,322,231,-231
Amanda Nunes,Julianna Pena,Amanda Nunes,2022-07-30,1,0,2,-2,4.6,2.4,5.080002,-5.080002,0,0,0,0,709,0,28,17,11,-11,2.19999980926514,-2.19999980926514,0,2,1,0,-2,2,1,-1,231,231,0,0
Germaine de Randamie,Julie Kedzie,Germaine de Randamie,2013-07-27,1,0,-3,3,2.5,1.230769,10.15999,-10.15999,0,0,12.34,-12.34,231,291,14,29,-15,15,1.26923072338104,-1.26923072338104,0,0,0,0,0,0,0,0,0,0,0,0
Bethe Correia,Julie Kedzie,Bethe Correia,2013-12-06,1,0,-2,2,1.833333,1.230769,0,0,0,0,-5.440002,5.440002,196,4,17,29,-12,12,0.602564096450806,-0.602564096450806,0,0,0,0,0,0,0,0,0,132,-132,132
Leah Letson,Julija Stoliarenko,Leah Letson,2018-11-30,1,0,1,-1,1.666667,1.375,0,0,20,-20,12.7,-12.7,178,2,8,19,-11,11,0.291666626930237,-0.291666626930237,0,0,0,0,0,0,0,0,0,0,0,0
Yana Santos,Julija Stoliarenko,Yana Santos,2020-08-08,1,0,3,-3,1.75,1.375,-2.539993,2.539993,10,-10,5.080002,-5.080002,796,21,22,19,3,-3,0.375,-0.375,0,0,0,0,0,0,0,0,0,617,-617,617
Julia Avila,Julija Stoliarenko,Julia Avila,2021-06-26,1,0,5,-5,4.5,1.375,0,0,10,-10,5.080002,-5.080002,211,212,11,19,-8,8,3.125,-3.125,0,0,0,0,0,0,0,0,287,322,-35,35
Alexis Davis,Julija Stoliarenko,Alexis Davis,2022-02-05,1,0,9,-9,1.909091,1.375,-2.539993,2.539993,10,-10,5.080002,-5.080002,549,0,32,19,13,-13,0.534090876579285,-0.534090876579285,0,0,1,0,0,0,1,-1,238,224,14,-14
Jessica-Rose Clark,Julija Stoliarenko,Julija Stoliarenko,2022-07-02,0,1,5,-5,1.222222,1.375,-5.079987,5.079987,10,-10,-5.080002,5.080002,0,17,20,19,1,-1,-0.152777791023254,0.152777791023254,0,0,0,0,0,0,0,0,133,147,-14,14
Chelsea Chandler,Julija Stoliarenko,Chelsea Chandler,2022-10-01,1,0,2,-2,2.5,1.375,2.540009,-2.540009,20,-20,5.080002,-5.080002,125,19,7,19,-12,12,1.125,-1.125,0,1,0,0,-1,1,0,0,0,91,-91,91
Molly McCann,Julija Stoliarenko,Julija Stoliarenko,2023-07-22,0,1,3,-3,2.166667,1.375,-7.619995,7.619995,0,0,-10.16,10.16,7,19,19,19,0,0,0.791666746139526,-0.791666746139526,1,0,0,1,1,-1,-1,1,686,294,392,-392
TJ Grant,Julio Paulino,TJ Grant,2010-09-25,1,0,-8,8,4.2,4.6,-5.080002,5.080002,-15,15,-2.119995,2.119995,540,192,26,28,-2,2,-0.400000095367432,0.400000095367432,0,0,0,0,0,0,0,0,140,0,140,-140
Mark Eddiva,Jumabieke Tuerxun,Mark Eddiva,2014-03-01,1,0,1,-1,2,4.75,2.540009,-2.540009,10,-10,-0.2799988,0.2799988,620,50,9,23,-14,14,-2.75,2.75,0,0,0,0,0,0,0,0,0,0,0,0
Leandro Issa,Jumabieke Tuerxun,Leandro Issa,2014-07-06,1,0,2,-2,2.166667,4.75,0,0,0,0,2.259995,-2.259995,206,63,19,23,-4,4,-2.58333325386047,2.58333325386047,0,0,0,0,0,0,0,0,0,127,-127,127
Marcus Brimage,Jumabieke Tuerxun,Marcus Brimage,2014-11-07,1,0,1,-1,1,4.75,-7.619995,7.619995,0,0,7.339996,-7.339996,2,0,14,23,-9,9,-3.75,3.75,0,0,1,0,0,0,1,-1,125,124,1,-1
Shane Carwin,Junior Dos Santos,Junior Dos Santos,2011-06-11,0,1,9,-9,6,2.333333,-5.079987,5.079987,27,-27,7.619995,-7.619995,56,44,14,30,-16,16,3.66666674613953,-3.66666674613953,0,0,0,0,0,0,0,0,343,0,343,-343
Curtis Blaydes,Junior Dos Santos,Curtis Blaydes,2020-01-25,1,0,-7,7,4.25,2.333333,0,0,27,-27,7.619995,-7.619995,19,0,21,30,-9,9,1.91666674613953,-1.91666674613953,1,1,2,0,0,0,2,-2,308,3150,-2842,2842
Parker Porter,Junior Tafa,Junior Tafa,2023-08-26,0,1,12,-12,1.555556,5,-7.619995,7.619995,25,-25,0,0,17,4,23,6,17,-17,-3.44444441795349,3.44444441795349,1,0,1,0,1,-1,1,-1,112,0,112,-112
Anthony Hernandez,JunYong Park,Anthony Hernandez,2019-08-31,1,0,-3,3,5.5,3.4,5.080002,-5.080002,0,0,5.080002,-5.080002,272,16,13,22,-9,9,2.09999990463257,-2.09999990463257,0,0,0,0,0,0,0,0,210,0,210,-210
Marc-Andre Barriault,JunYong Park,JunYong Park,2019-12-21,0,1,1,-1,2.666667,3.4,7.619995,-7.619995,0,0,2.540009,-2.540009,7,208,22,22,0,0,-0.733333349227905,0.733333349227905,0,0,0,0,0,0,0,0,147,112,35,-35
Tafon Nchukwi,JunYong Park,JunYong Park,2021-05-08,0,1,-4,4,1.5,3.4,5.080002,-5.080002,0,0,10.16,-10.16,34,229,10,22,-12,12,-1.90000009536743,1.90000009536743,1,1,0,0,0,0,0,0,140,504,-364,364
Eryk Anders,JunYong Park,JunYong Park,2022-05-21,0,1,4,-4,1.875,3.4,7.619995,-7.619995,0,0,5.080002,-5.080002,285,31,23,22,1,-1,-1.52500009536743,1.52500009536743,0,2,1,0,-2,2,1,-1,161,378,-217,217
Joseph Holmes,JunYong Park,JunYong Park,2022-10-29,0,1,-4,4,2,3.4,15.23999,-15.23999,0,0,17.78,-17.78,39,277,12,22,-10,10,-1.40000009536743,1.40000009536743,0,3,0,0,-3,3,0,0,287,161,126,-126
Albert Duraev,JunYong Park,JunYong Park,2023-07-15,0,1,2,-2,3.2,3.4,2.539993,-2.539993,0,0,5.080002,-5.080002,74,119,21,22,-1,1,-0.200000047683716,0.200000047683716,2,4,0,0,-2,2,0,0,112,259,-147,147
John Dodson,Jussier Formiga,John Dodson,2012-10-05,1,0,1,-1,1.833333,2.875,-5.080002,5.080002,10,-10,-2.539993,2.539993,18,0,34,31,3,-3,-1.04166662693024,1.04166662693024,1,0,0,0,1,-1,0,0,153,0,153,-153
Chris Cariaso,Jussier Formiga,Jussier Formiga,2013-05-18,0,1,3,-3,2.125,2.875,-5.080002,5.080002,0,0,-7.619995,7.619995,81,530,25,31,-6,6,-0.75,0.75,0,0,0,1,0,0,-1,1,140,225,-85,85
Joseph Benavidez,Jussier Formiga,Joseph Benavidez,2013-09-04,1,0,1,-1,3.5,2.875,-2.540009,2.540009,0,0,-5.079987,5.079987,5,0,36,31,5,-5,0.625,-0.625,2,1,0,1,1,-1,-1,1,137,109,28,-28
Henry Cejudo,Jussier Formiga,Henry Cejudo,2015-11-21,1,0,-2,2,5.333333,2.875,-2.540009,2.540009,10,-10,-7.619995,7.619995,76,0,19,31,-12,12,2.45833349227905,-2.45833349227905,1,0,0,2,1,-1,-2,2,343,808,-465,465
Ray Borg,Jussier Formiga,Ray Borg,2017-03-11,1,0,-8,8,2.6,2.875,-2.540009,2.540009,10,-10,-10.15999,10.15999,262,205,18,31,-13,13,-0.275000095367432,0.275000095367432,1,0,0,2,1,-1,-2,2,71,476,-405,405
Deiveson Figueiredo,Jussier Formiga,Jussier Formiga,2019-03-23,0,1,-2,2,7,2.875,0,0,0,0,2.540009,-2.540009,11,401,24,31,-7,7,4.125,-4.125,2,0,0,2,2,-2,-2,2,210,742,-532,532
Joseph Benavidez,Jussier Formiga,Joseph Benavidez,2019-06-29,1,0,0,0,3.5,2.875,-2.540009,2.540009,0,0,-5.079987,5.079987,123,26,36,31,5,-5,0.625,-0.625,2,1,1,2,1,-1,-1,1,161,98,63,-63
Paul Buentello,Justin Eilers,Paul Buentello,2005-02-05,1,0,5,-5,2.058824,2.714286,2.540009,-2.540009,10,-10,7.580002,-7.580002,3,78,52,26,26,-26,-0.655462026596069,0.655462026596069,0,0,0,0,0,0,0,0,0,0,0,0
Andrei Arlovski,Justin Eilers,Andrei Arlovski,2005-06-04,1,0,0,0,1.545455,2.714286,5.080002,-5.080002,5,-5,7.580002,-7.580002,7,0,56,26,30,-30,-1.16883111000061,1.16883111000061,4,0,2,1,4,-4,1,-1,119,119,0,0
Juan Espino,Justin Frazier,Juan Espino,2018-11-30,1,0,9,-9,5.5,3.333333,7.619995,-7.619995,-10,10,12.7,-12.7,201,0,13,13,0,0,2.16666674613953,-2.16666674613953,0,0,0,0,0,0,0,0,0,0,0,0
Eddie Alvarez,Justin Gaethje,Eddie Alvarez,2017-12-02,1,0,4,-4,4.833333,6.25,-5.080002,5.080002,0,0,-2.540009,2.540009,20,6,35,29,6,-6,-1.41666650772095,1.41666650772095,0,0,1,0,0,0,1,-1,385,0,385,-385
Edson Barboza,Justin Gaethje,Justin Gaethje,2019-03-30,0,1,3,-3,2.090909,6.25,0,0,-10,10,12.7,-12.7,0,44,34,29,5,-5,-4.15909099578857,4.15909099578857,1,0,2,1,1,-1,1,-1,105,483,-378,378
Donald Cerrone,Justin Gaethje,Justin Gaethje,2019-09-14,0,1,6,-6,2.117647,6.25,5.080002,-5.080002,0,0,7.619995,-7.619995,0,4,53,29,24,-24,-4.13235282897949,4.13235282897949,0,1,5,1,-1,1,4,-4,98,168,-70,70
Tony Ferguson,Justin Gaethje,Justin Gaethje,2020-05-09,0,1,5,-5,2.888889,6.25,0,0,0,0,15.23999,-15.23999,0,0,35,29,6,-6,-3.36111116409302,3.36111116409302,8,2,0,1,6,-6,-1,1,581,238,343,-343
Michael Chandler,Justin Gaethje,Justin Gaethje,2021-11-06,0,1,3,-3,2.875,6.25,-7.619995,7.619995,0,0,2.539993,-2.539993,3,97,31,29,2,-2,-3.375,3.375,0,3,1,1,-3,3,0,0,175,546,-371,371
Rafael Fiziev,Justin Gaethje,Justin Gaethje,2023-03-18,0,1,-4,4,4,6.25,-7.619995,7.619995,0,0,2.539993,-2.539993,0,5,15,29,-14,14,-2.25,2.25,4,4,1,1,0,0,0,0,469,497,-28,28
Clay Guida,Justin James,Clay Guida,2006-10-14,1,0,-5,5,1.9,1.857143,-7.62001,7.62001,0,0,-2.199997,2.199997,452,26,58,20,38,-38,4.28571701049805e-02,-4.28571701049805e-02,0,0,0,0,0,0,0,0,0,0,0,0
Frank Camacho,Justin Jaynes,Justin Jaynes,2020-06-20,0,1,1,-1,2.2,2,7.62001,-7.62001,10,-10,12.7,-12.7,0,3,32,24,8,-8,0.200000047683716,-0.200000047683716,0,0,1,0,0,0,1,-1,238,0,238,-238
Gabriel Benitez,Justin Jaynes,Gabriel Benitez,2020-12-05,1,0,1,-1,2.090909,2,2.540009,-2.540009,10,-10,7.619995,-7.619995,0,0,34,24,10,-10,9.09090042114258e-02,-9.09090042114258e-02,0,1,2,0,-1,1,2,-2,206,168,38,-38
Corey Anderson,Justin Jones,Corey Anderson,2014-12-06,1,0,-2,2,2.8,4.5,10.16,-10.16,20,-20,17.66,-17.66,528,0,19,11,8,-8,-1.70000004768372,1.70000004768372,1,0,0,0,1,-1,0,0,153,0,153,-153
John Cofer,Justin Lawrence,Justin Lawrence,2012-06-01,0,1,6,-6,2,2.5,2.539993,-2.539993,10,-10,7.820007,-7.820007,52,53,12,14,-2,2,-0.5,0.5,0,0,0,0,0,0,0,0,0,0,0,0
Max Holloway,Justin Lawrence,Max Holloway,2012-08-11,1,0,-2,2,3.571429,2.5,7.619995,-7.619995,0,0,5.080002,-5.080002,5,9,32,14,18,-18,1.07142853736877,-1.07142853736877,1,1,0,0,0,0,0,0,71,71,0,0
Mark Godbeer,Justin Ledet,Justin Ledet,2016-11-19,0,1,4,-4,3.25,2.25,0,0,35,-35,-7.619995,7.619995,10,75,17,13,4,-4,1,-1,0,0,0,0,0,0,0,0,0,0,0,0
Azunna Anyanwu,Justin Ledet,Justin Ledet,2017-09-16,0,1,8,-8,2.8,2.25,-7.619995,7.619995,46,-46,-14.06999,14.06999,0,0,19,13,6,-6,0.549999952316284,-0.549999952316284,0,1,0,0,-1,1,0,0,0,301,-301,301
Aleksa Camur,Justin Ledet,Aleksa Camur,2020-01-18,1,0,-7,7,2,2.25,-7.619995,7.619995,0,0,-15.23999,15.23999,0,74,9,13,-4,4,-0.25,0.25,0,2,0,0,-2,2,0,0,0,854,-854,854
Dustin Jacoby,Justin Ledet,Dustin Jacoby,2020-10-31,1,0,0,0,2.714286,2.25,-2.539993,2.539993,0,0,-10.16,10.16,11,0,26,13,13,-13,0.464285612106323,-0.464285612106323,0,0,0,0,0,0,0,0,3290,287,3003,-3003
Eric Martin,Justin Martin,Justin Martin,1997-02-07,0,1,,,0,1.333333,,,,,-10,10,0,0,1,7,-6,6,-1.33333337306976,1.33333337306976,0,0,0,0,0,0,0,0,0,0,0,0
Antoni Hardonk,Justin McCully,Justin McCully,2007-04-05,0,1,0,0,1.333333,2.2,7.619995,-7.619995,20,-20,12.7,-12.7,0,810,14,16,-2,2,-0.866666674613953,0.866666674613953,1,0,0,0,1,-1,0,0,138,0,138,-138
Gabriel Gonzaga,Justin McCully,Gabriel Gonzaga,2008-07-05,1,0,-3,3,1.545455,2.2,2.540009,-2.540009,17,-17,7.619995,-7.619995,76,0,28,16,12,-12,-0.654545545578003,0.654545545578003,0,1,1,0,-1,1,1,-1,168,457,-289,289
Anton Kuivanen,Justin Salas,Justin Salas,2012-02-15,0,1,-2,2,2.4,1.714286,0,0,0,0,5.080002,-5.080002,1,254,34,19,15,-15,0.685714364051819,-0.685714364051819,0,0,0,0,0,0,0,0,0,0,0,0
Tim Means,Justin Salas,Tim Means,2012-06-08,1,0,-2,2,2.2,1.714286,15.24001,-15.24001,15,-15,12.7,-12.7,19,0,48,19,29,-29,0.485714316368103,-0.485714316368103,0,1,0,0,-1,1,0,0,0,114,-114,114
Aaron Riley,Justin Salas,Justin Salas,2013-07-27,0,1,1,-1,2.142857,1.714286,0,0,0,0,-2.540009,2.540009,0,30,44,19,25,-25,0.428571343421936,-0.428571343421936,0,0,0,1,0,0,-1,1,0,414,-414,414
Joe Proctor,Justin Salas,Joe Proctor,2014-07-16,1,0,-4,4,2.2,1.714286,5.080002,-5.080002,0,0,5.080002,-5.080002,7,36,16,19,-3,3,0.485714316368103,-0.485714316368103,0,1,0,1,-1,1,-1,1,0,354,-354,354
Jason Saggo,Justin Salas,Jason Saggo,2016-03-05,1,0,-3,3,3,1.714286,7.619995,-7.619995,0,0,2.539993,-2.539993,141,41,16,19,-3,3,1.28571426868439,-1.28571426868439,1,0,0,2,1,-1,-2,2,630,598,32,-32
Will Campuzano,Justin Scoggins,Justin Scoggins,2014-03-15,0,1,6,-6,2.333333,2.2,5.080002,-5.080002,0,0,10.16,-10.16,0,595,20,16,4,-4,0.133333206176758,-0.133333206176758,0,0,0,0,0,0,0,0,119,0,119,-119
Dustin Ortiz,Justin Scoggins,Dustin Ortiz,2014-07-06,1,0,3,-3,2.375,2.2,-5.079987,5.079987,0,0,-2.539993,2.539993,443,283,27,16,11,-11,0.174999952316284,-0.174999952316284,0,1,0,0,-1,1,0,0,0,113,-113,113
John Moraga,Justin Scoggins,John Moraga,2014-09-05,1,0,8,-8,2.714286,2.2,-2.539993,2.539993,0,0,0,0,0,271,26,16,10,-10,0.514285564422607,-0.514285564422607,1,0,0,0,1,-1,0,0,233,61,172,-172
Josh Sampo,Justin Scoggins,Justin Scoggins,2015-05-23,0,1,7,-7,2.2,2.2,-7.619995,7.619995,0,0,-5.080002,5.080002,87,31,16,16,0,0,0,0,0,0,0,0,0,0,0,0,0,260,-260,260
Ray Borg,Justin Scoggins,Justin Scoggins,2016-02-06,0,1,-1,1,2.6,2.2,-7.619995,7.619995,10,-10,-7.619995,7.619995,63,434,18,16,2,-2,0.399999856948853,-0.399999856948853,3,1,0,0,2,-2,0,0,182,259,-77,77
Pedro Munhoz,Justin Scoggins,Pedro Munhoz,2016-11-19,1,0,6,-6,2.5,2.2,-2.539993,2.539993,10,-10,-2.539993,2.539993,8,7,28,16,12,-12,0.299999952316284,-0.299999952316284,0,2,0,0,-2,2,0,0,378,287,91,-91
Yuta Sasaki,Justin Scoggins,Yuta Sasaki,2017-06-17,1,0,2,-2,3.5,2.2,7.62001,-7.62001,0,0,12.7,-12.7,68,330,27,16,11,-11,1.29999995231628,-1.29999995231628,0,0,0,0,0,0,0,0,0,210,-210,210
Said Nurmagomedov,Justin Scoggins,Said Nurmagomedov,2018-07-14,1,0,0,0,5.666667,2.2,2.540009,-2.540009,10,-10,10.16,-10.16,120,0,20,16,4,-4,3.46666646003723,-3.46666646003723,0,0,0,0,0,0,0,0,0,392,-392,392
Yorgan De Castro,Justin Tafa,Yorgan De Castro,2019-10-05,1,0,7,-7,2,2.333333,0,0,-14,14,0,0,12,69,9,10,-1,1,-0.333333253860474,0.333333253860474,0,0,0,0,0,0,0,0,0,0,0,0
Juan Adams,Justin Tafa,Justin Tafa,2020-02-08,0,1,2,-2,1.666667,2.333333,12.7,-12.7,1,-1,15.23999,-15.23999,0,2,8,10,-2,2,-0.666666626930237,0.666666626930237,0,0,1,1,0,0,0,0,203,126,77,-77
Carlos Felipe,Justin Tafa,Carlos Felipe,2021-01-16,1,0,-1,1,5.5,2.333333,0,0,-19,19,2.539993,-2.539993,41,113,13,10,3,-3,3.16666674613953,-3.16666674613953,0,1,0,1,-1,1,-1,1,182,343,-161,161
Harry Hunsucker,Justin Tafa,Justin Tafa,2021-12-18,0,1,4,-4,1.166667,2.333333,5.080002,-5.080002,-59,59,2.539993,-2.539993,0,62,13,10,3,-3,-1.16666662693024,1.16666662693024,0,0,1,1,0,0,0,0,273,336,-63,63
Parker Porter,Justin Tafa,Justin Tafa,2023-02-11,0,1,8,-8,1.555556,2.333333,0,0,1,-1,2.539993,-2.539993,0,0,23,10,13,-13,-0.777777671813965,0.777777671813965,1,1,0,1,0,0,-1,1,539,420,119,-119
Austen Lane,Justin Tafa,Justin Tafa,2023-09-09,0,1,6,-6,3,2.333333,15.23999,-15.23999,-19,19,15.23999,-15.23999,0,5,16,10,6,-6,0.666666746139526,-0.666666746139526,0,2,0,1,-2,2,-1,1,0,210,-210,210
James Mulheron,Justin Willis,Justin Willis,2017-07-16,0,1,0,0,5.5,4,-7.619995,7.619995,-21,21,-12.7,12.7,40,204,13,10,3,-3,1.5,-1.5,0,0,0,0,0,0,0,0,0,0,0,0
Allen Crowder,Justin Willis,Justin Willis,2017-12-02,0,1,-2,2,2.5,4,5.080002,-5.080002,-19,19,-5.080002,5.080002,0,2,14,10,4,-4,-1.5,1.5,0,1,0,0,-1,1,0,0,0,139,-139,139
Chase Sherman,Justin Willis,Justin Willis,2018-04-21,0,1,-2,2,1.333333,4,7.619995,-7.619995,-14,14,0,0,122,180,28,10,18,-18,-2.66666662693024,2.66666662693024,0,2,0,0,-2,2,0,0,0,140,-140,140
Mark Hunt,Justin Willis,Justin Willis,2018-12-01,0,1,13,-13,0.9285714,4,-7.619995,7.619995,1,-1,-15.23999,15.23999,0,0,27,10,17,-17,-3.07142859697342,3.07142859697342,0,3,3,0,-3,3,3,-3,77,224,-147,147
Curtis Blaydes,Justin Willis,Curtis Blaydes,2019-03-23,1,0,-3,3,4.25,4,7.619995,-7.619995,1,-1,5.080002,-5.080002,704,0,21,10,11,-11,0.25,-0.25,0,4,2,0,-4,4,2,-2,119,112,7,-7
Jon Madsen,Justin Wren,Jon Madsen,2009-12-05,1,0,7,-7,4,6.5,-5.080002,5.080002,-25,25,-8.119995,8.119995,0,16,10,15,-5,5,-2.5,2.5,0,0,0,0,0,0,0,0,0,0,0,0
Felice Herrig,Justine Kish,Felice Herrig,2017-06-25,1,0,3,-3,1.4,1.75,-2.540009,2.540009,-10,10,2.540009,-2.540009,564,104,24,11,13,-13,-0.350000023841858,0.350000023841858,0,0,0,0,0,0,0,0,799,0,799,-799
Tracy Cortez,Justine Kish,Tracy Cortez,2021-04-17,1,0,-6,6,11,1.75,0,0,0,0,2.540009,-2.540009,386,38,12,11,1,-1,9.25,-9.25,2,0,0,0,2,-2,0,0,189,1392,-1203,1203
Tony DeSouza,Jutaro Nakao,Jutaro Nakao,2001-09-28,0,1,-3,3,2.75,1.315789,7.62001,-7.62001,0,0,-0.1999969,0.1999969,0,252,15,44,-29,29,1.43421053886414,-1.43421053886414,1,0,0,0,1,-1,0,0,91,0,91,-91
TJ Brown,Kai Kamaka,TJ Brown,2021-05-01,1,0,4,-4,1.7,2,5.080002,-5.080002,0,0,7.62001,-7.62001,36,338,27,12,15,-15,-0.299999952316284,0.299999952316284,0,0,0,0,0,0,0,0,259,0,259,-259
Elias Garcia,Kai Kara-France,Kai Kara-France,2018-12-01,0,1,1,-1,3,2.181818,2.540009,-2.540009,0,0,-5.080002,5.080002,28,570,8,35,-27,27,0.818181753158569,-0.818181753158569,0,0,0,0,0,0,0,0,0,0,0,0
Mark De La Rosa,Kai Kara-France,Kai Kara-France,2019-08-31,0,1,-1,1,2.2,2.181818,5.080002,-5.080002,10,-10,-10.15999,10.15999,72,20,16,35,-19,19,1.81818008422852e-02,-1.81818008422852e-02,0,1,0,0,-1,1,0,0,154,273,-119,119
Rogerio Bontorin,Kai Kara-France,Kai Kara-France,2021-03-06,0,1,1,-1,4,2.181818,2.540009,-2.540009,0,0,-5.080002,5.080002,195,1,20,35,-15,15,1.81818175315857,-1.81818175315857,0,2,0,0,-2,2,0,0,385,553,-168,168
Cody Garbrandt,Kai Kara-France,Kai Kara-France,2021-12-11,0,1,2,-2,2.6,2.181818,10.16,-10.16,10,-10,-10.15999,10.15999,6,6,18,35,-17,17,0.418181657791138,-0.418181657791138,0,3,1,0,-3,3,1,-1,1015,280,735,-735
Askar Askarov,Kai Kara-France,Kai Kara-France,2022-03-26,0,1,0,0,14,2.181818,5.080002,-5.080002,0,0,-5.080002,5.080002,314,0,15,35,-20,20,11.8181817531586,-11.8181817531586,3,4,0,0,-1,1,0,0,385,105,280,-280
Amir Albazi,Kai Kara-France,Amir Albazi,2023-06-03,1,0,-1,1,17,2.181818,2.540009,-2.540009,0,0,-2.539993,2.539993,370,58,18,35,-17,17,14.8181817531586,-14.8181817531586,4,5,0,0,-1,1,0,0,168,434,-266,266
Alex Chambers,Kailin Curran,Alex Chambers,2015-05-09,1,0,12,-12,1,0.8,-2.539993,2.539993,0,0,-5.080002,5.080002,58,280,10,9,1,-1,0.199999988079071,-0.199999988079071,0,0,0,0,0,0,0,0,148,0,148,-148
Aleksandra Albu,Kailin Curran,Aleksandra Albu,2017-07-29,1,0,1,-1,1.5,0.8,-5.080002,5.080002,0,0,-5.080002,5.080002,151,340,5,9,-4,4,0.699999988079071,-0.699999988079071,1,0,0,0,1,-1,0,0,840,812,28,-28
Tae Hyun Bang,Kajan Johnson,Tae Hyun Bang,2014-06-14,1,0,1,-1,1.8,1.769231,-5.080002,5.080002,0,0,-10.16,10.16,95,105,28,36,-8,8,3.07692289352417e-02,-3.07692289352417e-02,0,0,0,0,0,0,0,0,161,0,161,-161
Danny Abbadi,Kalib Starnes,Kalib Starnes,2006-06-24,0,1,-9,9,0.6666667,1.545455,-10.16,10.16,-30,30,-5.460007,5.460007,0,101,10,28,-18,18,-0.878787815570831,0.878787815570831,0,0,0,0,0,0,0,0,0,0,0,0
Yushin Okami,Kalib Starnes,Yushin Okami,2006-10-14,1,0,-6,6,2.833333,1.545455,-2.539993,2.539993,-15,15,2.539993,-2.539993,246,123,46,28,18,-18,1.28787875175476,-1.28787875175476,0,1,0,0,-1,1,0,0,0,112,-112,112
Chris Leben,Kalib Starnes,Kalib Starnes,2007-05-26,0,1,-6,6,2,1.545455,-10.16,10.16,0,0,-2.540009,2.540009,78,308,33,28,5,-5,0.454545497894287,-0.454545497894287,0,0,1,1,0,0,0,0,147,224,-77,77
Alan Belcher,Kalib Starnes,Alan Belcher,2007-10-20,1,0,-9,9,2.25,1.545455,-2.539993,2.539993,0,0,2.539993,-2.539993,51,28,26,28,-2,2,0.704545497894287,-0.704545497894287,1,1,0,1,0,0,-1,1,147,147,0,0
Nate Quarry,Kalib Starnes,Nate Quarry,2008-04-19,1,0,3,-3,3,1.545455,-7.619995,7.619995,0,0,-5.080002,5.080002,0,41,16,28,-12,12,1.45454549789429,-1.45454549789429,3,0,0,2,3,-3,-2,2,213,182,31,-31
Jessica Eye,Kalindra Faria,Jessica Eye,2018-01-14,1,0,0,0,1.363636,2.25,-2.539993,2.539993,0,0,-5.360001,5.360001,384,63,26,26,0,0,-0.886363625526428,0.886363625526428,0,0,0,0,0,0,0,0,595,0,595,-595
Jim Miller,Kamal Shalorus,Jim Miller,2011-03-19,1,0,-11,11,2.117647,1.8,0,0,0,0,7.619995,-7.619995,206,60,53,14,39,-39,0.317647218704224,-0.317647218704224,3,0,0,0,3,-3,0,0,98,0,98,-98
Khabib Nurmagomedov,Kamal Shalorus,Khabib Nurmagomedov,2012-01-20,1,0,-16,16,29,1.8,5.080002,-5.080002,0,0,5.080002,-5.080002,358,5,29,14,15,-15,27.2000000476837,-27.2000000476837,0,0,0,1,0,0,-1,1,0,307,-307,307
Rafael Dos Anjos,Kamal Shalorus,Rafael Dos Anjos,2012-05-15,1,0,-12,12,2.133333,1.8,0,0,15,-15,5.080002,-5.080002,35,0,47,14,33,-33,0.333333492279053,-0.333333492279053,0,0,1,1,0,0,0,0,178,116,62,-62
Hayder Hassan,Kamaru Usman,Kamaru Usman,2015-07-12,0,1,4,-4,2,6.666667,-5.080002,5.080002,0,0,-12.03999,12.03999,0,311,9,23,-14,14,-4.66666650772095,4.66666650772095,0,0,0,0,0,0,0,0,0,0,0,0
Leon Edwards,Kamaru Usman,Kamaru Usman,2015-12-19,0,1,-4,4,7,6.666667,5.080002,-5.080002,0,0,-5.079987,5.079987,40,650,24,23,1,-1,0.333333492279053,-0.333333492279053,1,1,0,0,0,0,0,0,154,160,-6,6
Warlley Alves,Kamaru Usman,Kamaru Usman,2016-11-19,0,1,-4,4,2.5,6.666667,-2.540009,2.540009,0,0,-10.15999,10.15999,0,322,21,23,-2,2,-4.16666650772095,4.16666650772095,0,2,0,0,-2,2,0,0,189,336,-147,147
Sean Strickland,Kamaru Usman,Kamaru Usman,2017-04-08,0,1,-3,3,5.6,6.666667,2.539993,-2.539993,15,-15,0,0,0,488,33,23,10,-10,-1.06666660308838,1.06666660308838,0,3,0,0,-3,3,0,0,0,140,-140,140
Sergio Moraes,Kamaru Usman,Kamaru Usman,2017-09-16,0,1,5,-5,2.333333,6.666667,0,0,0,0,-10.15999,10.15999,0,5,20,23,-3,3,-4.33333325386047,4.33333325386047,2,4,0,0,-2,2,0,0,189,161,28,-28
Emil Meek,Kamaru Usman,Kamaru Usman,2018-01-14,0,1,-1,1,1.8,6.666667,-2.540009,2.540009,0,0,-5.079987,5.079987,2,771,14,23,-9,9,-4.86666655540466,4.86666655540466,1,5,0,0,-4,4,0,0,400,120,280,-280
Demian Maia,Kamaru Usman,Kamaru Usman,2018-05-19,0,1,9,-9,2.545455,6.666667,2.539993,-2.539993,0,0,-10.15999,10.15999,121,259,39,23,16,-16,-4.12121200561523,4.12121200561523,0,6,1,0,-6,6,1,-1,294,125,169,-169
Rafael Dos Anjos,Kamaru Usman,Kamaru Usman,2018-11-30,0,1,3,-3,2.133333,6.666667,-10.16,10.16,0,0,-15.23999,15.23999,21,1107,47,23,24,-24,-4.53333306312561,4.53333306312561,3,7,1,0,-4,4,1,-1,349,195,154,-154
Colby Covington,Kamaru Usman,Kamaru Usman,2019-12-14,0,1,-1,1,5.666667,6.666667,-2.540009,2.540009,0,0,-10.15999,10.15999,0,11,20,23,-3,3,-1,1,9,8,0,0,1,-1,0,0,133,379,-246,246
Jorge Masvidal,Kamaru Usman,Kamaru Usman,2020-07-11,0,1,2,-2,2.058824,6.666667,-2.540009,2.540009,0,0,-5.079987,5.079987,0,998,52,23,29,-29,-4.60784292221069,4.60784292221069,1,9,0,0,-8,8,0,0,483,210,273,-273
Gilbert Burns,Kamaru Usman,Kamaru Usman,2021-02-13,0,1,1,-1,3.666667,6.666667,-5.080002,5.080002,0,0,-12.7,12.7,0,125,28,23,5,-5,-2.99999976158142,2.99999976158142,5,10,1,0,-5,5,1,-1,259,217,42,-42
Jorge Masvidal,Kamaru Usman,Kamaru Usman,2021-04-24,0,1,3,-3,2.058824,6.666667,-2.540009,2.540009,0,0,-5.079987,5.079987,0,102,52,23,29,-29,-4.60784292221069,4.60784292221069,0,11,0,0,-11,11,0,0,287,70,217,-217
Colby Covington,Kamaru Usman,Kamaru Usman,2021-11-06,0,1,-1,1,5.666667,6.666667,-2.540009,2.540009,0,0,-10.15999,10.15999,114,76,20,23,-3,3,-1,1,1,12,1,0,-11,11,1,-1,413,196,217,-217
Leon Edwards,Kamaru Usman,Leon Edwards,2022-08-20,1,0,-5,5,7,6.666667,5.080002,-5.080002,0,0,-5.079987,5.079987,175,636,24,23,1,-1,0.333333492279053,-0.333333492279053,5,13,0,0,-8,8,0,0,1253,287,966,-966
Leon Edwards,Kamaru Usman,Leon Edwards,2023-03-18,1,0,-4,4,7,6.666667,5.080002,-5.080002,0,0,-5.079987,5.079987,0,303,24,23,1,-1,0.333333492279053,-0.333333492279053,6,0,0,1,6,-6,-1,1,210,210,0,0
Makwan Amirkhani,Kamuela Kirk,Kamuela Kirk,2021-06-05,0,1,5,-5,1.888889,2,0,0,-10,10,-7.619995,7.619995,410,94,26,18,8,-8,-0.111111164093018,0.111111164093018,0,0,1,0,0,0,1,-1,238,0,238,-238
Damon Jackson,Kamuela Kirk,Damon Jackson,2022-03-12,1,0,6,-6,3.666667,2,2.539993,-2.539993,-10,10,-10.16,10.16,337,0,28,18,10,-10,1.66666674613953,-1.66666674613953,1,1,1,0,0,0,1,-1,154,280,-126,126
Randa Markos,Kanako Murata,Kanako Murata,2020-11-14,0,1,8,-8,0.9166667,6,7.619995,-7.619995,0,0,2.540009,-2.540009,0,561,23,14,9,-9,-5.08333331346512,5.08333331346512,0,0,0,0,0,0,0,0,245,0,245,-245
Virna Jandiroba,Kanako Murata,Virna Jandiroba,2021-06-19,1,0,6,-6,6.333333,6,5.080002,-5.080002,0,0,5.080002,-5.080002,46,154,22,14,8,-8,0.333333492279053,-0.333333492279053,1,1,0,0,0,0,0,0,560,217,343,-343
Poliana Botelho,Karine Silva,Karine Silva,2022-06-04,0,1,5,-5,1.6,4.25,7.619995,-7.619995,0,0,0,0,0,47,13,21,-8,8,-2.64999997615814,2.64999997615814,0,0,0,0,0,0,0,0,399,0,399,-399
Maryna Moroz,Karine Silva,Karine Silva,2023-08-19,0,1,2,-2,2.2,4.25,5.079987,-5.079987,0,0,0,0,101,51,16,21,-5,5,-2.04999995231628,2.04999995231628,3,1,0,0,2,-2,0,0,2569,441,2128,-2128
Cezar Ferreira,Karl Roberson,Cezar Ferreira,2018-05-12,1,0,6,-6,1.625,1.5,0,0,-20,20,10.15999,-10.15999,260,0,21,15,6,-6,0.125,-0.125,1,0,1,0,1,-1,1,-1,182,0,182,-182
Jack Marshman,Karl Roberson,Karl Roberson,2018-11-03,0,1,0,0,2.3,1.5,-2.539993,2.539993,-20,20,-2.540009,2.540009,0,306,33,15,18,-18,0.799999952316284,-0.799999952316284,0,0,1,0,0,0,1,-1,622,175,447,-447
Roman Kopylov,Karl Roberson,Karl Roberson,2019-11-09,0,1,-1,1,6,1.5,-2.539993,2.539993,-20,20,2.539993,-2.539993,2,56,14,15,-1,1,4.5,-4.5,0,1,0,0,-1,1,0,0,0,371,-371,371
Brendan Allen,Karl Roberson,Brendan Allen,2021-04-24,1,0,-5,5,4.4,1.5,2.540009,-2.540009,-20,20,2.539993,-2.539993,196,0,27,15,12,-12,2.90000009536743,-2.90000009536743,0,2,1,0,-2,2,1,-1,161,532,-371,371
Kennedy Nzechukwu,Karl Roberson,Kennedy Nzechukwu,2022-07-09,1,0,-1,1,3,1.5,10.16,-10.16,0,0,22.86,-22.86,646,23,16,15,1,-1,1.5,-1.5,0,0,1,0,0,0,1,-1,238,441,-203,203
Lukasz Brzeski,Karl Williams,Karl Williams,2023-03-11,0,1,-3,3,2,9,2.539993,-2.539993,1,-1,-2.540009,2.540009,29,613,12,10,2,-2,-7,7,0,0,0,0,0,0,0,0,210,0,210,-210
Chase Sherman,Karl Williams,Karl Williams,2023-05-13,0,1,0,0,1.333333,9,2.539993,-2.539993,15,-15,-2.540009,2.540009,12,155,28,10,18,-18,-7.66666662693024,7.66666662693024,2,1,0,0,1,-1,0,0,308,63,245,-245
Jon Madsen,Karlos Vemola,Jon Madsen,2010-07-03,1,0,5,-5,4,3.4,0,0,55,-55,-7.619995,7.619995,589,11,10,22,-12,12,0.599999904632568,-0.599999904632568,1,0,0,0,1,-1,0,0,210,0,210,-210
Seth Petruzelli,Karlos Vemola,Karlos Vemola,2010-11-13,0,1,5,-5,1.75,3.4,0,0,20,-20,2.539993,-2.539993,0,198,22,22,0,0,-1.65000009536743,1.65000009536743,0,0,0,0,0,0,0,0,133,133,0,0
Ronny Markes,Karlos Vemola,Ronny Markes,2011-08-14,1,0,-3,3,3.4,3.4,2.539993,-2.539993,0,0,0,0,778,36,22,22,0,0,0,0,0,1,0,0,-1,1,0,0,0,274,-274,274
Mike Massenzio,Karlos Vemola,Karlos Vemola,2012-05-05,0,1,3,-3,1.444444,3.4,5.080002,-5.080002,0,0,-5.080002,5.080002,157,65,22,22,0,0,-1.95555567741394,1.95555567741394,0,0,0,0,0,0,0,0,112,265,-153,153
Francis Carmont,Karlos Vemola,Francis Carmont,2012-07-11,1,0,3,-3,2.083333,3.4,7.619995,-7.619995,20,-20,7.619995,-7.619995,218,126,37,22,15,-15,-1.31666684150696,1.31666684150696,1,1,0,0,0,0,0,0,88,67,21,-21
Caio Magalhaes,Karlos Vemola,Caio Magalhaes,2013-06-08,1,0,-2,2,3.333333,3.4,2.539993,-2.539993,0,0,-5.080002,5.080002,149,294,13,22,-9,9,-6.6666841506958e-02,6.6666841506958e-02,0,0,0,0,0,0,0,0,365,332,33,-33
Nick Diaz,Karo Parisyan,Karo Parisyan,2004-08-21,0,1,0,0,2.6,2.181818,7.619995,-7.619995,0,0,10.15999,-10.15999,78,414,36,35,1,-1,0.418181657791138,-0.418181657791138,2,0,0,0,2,-2,0,0,141,0,141,-141
Chris Lytle,Karo Parisyan,Karo Parisyan,2005-02-05,0,1,8,-8,1.722222,2.181818,2.539993,-2.539993,0,0,-10.16,10.16,33,773,49,35,14,-14,-0.459596037864685,0.459596037864685,0,1,0,0,-1,1,0,0,0,168,-168,168
Drew Fickett,Karo Parisyan,Karo Parisyan,2006-12-13,0,1,2,-2,2,2.181818,0,0,-15,15,-5.080002,5.080002,72,285,63,35,28,-28,-0.181818246841431,0.181818246841431,3,2,0,0,1,-1,0,0,158,676,-518,518
Joshua Burkman,Karo Parisyan,Karo Parisyan,2007-05-26,0,1,3,-3,1.75,2.181818,0,0,0,0,0,0,156,89,44,35,9,-9,-0.431818246841431,0.431818246841431,2,3,0,0,-1,1,0,0,121,164,-43,43
Ryo Chonan,Karo Parisyan,Karo Parisyan,2007-11-17,0,1,6,-6,1.692308,2.181818,-2.540009,2.540009,0,0,-5.080002,5.080002,110,444,35,35,0,0,-0.489510536193848,0.489510536193848,0,4,0,0,-4,4,0,0,0,175,-175,175
Thiago Alves,Karo Parisyan,Thiago Alves,2008-04-02,1,0,-1,1,1.533333,2.181818,-2.540009,2.540009,0,0,-5.080002,5.080002,2,115,38,35,3,-3,-0.648484945297241,0.648484945297241,3,5,1,0,-2,2,1,-1,137,137,0,0
Dennis Hallman,Karo Parisyan,Dennis Hallman,2010-11-20,1,0,6,-6,2.65,2.181818,-2.540009,2.540009,-15,15,0,0,5,58,73,35,38,-38,0.468181848526001,-0.468181848526001,1,0,2,1,1,-1,1,-1,105,962,-857,857
Lara Procopio,Karol Rosa,Karol Rosa,2019-08-31,0,1,-1,1,3.5,3.4,-2.540009,2.540009,-20,20,0,0,22,64,9,22,-13,13,9.99999046325684e-02,-9.99999046325684e-02,0,0,0,0,0,0,0,0,0,0,0,0
Vanessa Melo,Karol Rosa,Karol Rosa,2020-07-11,0,1,7,-7,1.375,3.4,0,0,-10,10,-5.079987,5.079987,6,350,19,22,-3,3,-2.02500009536743,2.02500009536743,0,1,0,0,-1,1,0,0,0,315,-315,315
Joselyne Edwards,Karol Rosa,Karol Rosa,2021-02-06,0,1,-1,1,2.6,3.4,7.619995,-7.619995,-10,10,7.62001,-7.62001,2,673,18,22,-4,4,-0.800000190734863,0.800000190734863,1,2,0,0,-1,1,0,0,21,210,-189,189
Bethe Correia,Karol Rosa,Karol Rosa,2021-10-02,0,1,12,-12,1.833333,3.4,0,0,-10,10,-7.619995,7.619995,0,170,17,22,-5,5,-1.56666672229767,1.56666672229767,0,3,2,0,-3,3,2,-2,434,238,196,-196
Sara McMann,Karol Rosa,Sara McMann,2022-03-26,1,0,14,-14,2.166667,3.4,2.539993,-2.539993,-10,10,-2.539993,2.539993,627,116,19,22,-3,3,-1.23333334922791,1.23333334922791,0,4,1,0,-4,4,1,-1,427,175,252,-252
Lina Lansberg,Karol Rosa,Karol Rosa,2022-10-22,0,1,13,-13,1.25,3.4,5.079987,-5.079987,-10,10,-5.079987,5.079987,168,584,18,22,-4,4,-2.15000009536743,2.15000009536743,0,0,0,0,0,0,0,0,1001,210,791,-791
Norma Dumont,Karol Rosa,Norma Dumont,2023-04-22,1,0,4,-4,5,3.4,5.079987,-5.079987,0,0,0,0,294,193,12,22,-10,10,1.59999990463257,-1.59999990463257,4,1,0,0,3,-3,0,0,224,182,42,-42
Heather Clark,Karolina Kowalkiewicz,Karolina Kowalkiewicz,2016-05-08,0,1,5,-5,1.166667,2.142857,7.619995,-7.619995,0,0,0,0,300,44,13,22,-9,9,-0.976190447807312,0.976190447807312,1,0,0,0,1,-1,0,0,513,0,513,-513
Joanna Jedrzejczyk,Karolina Kowalkiewicz,Joanna Jedrzejczyk,2016-11-12,1,0,-2,2,3.2,2.142857,7.619995,-7.619995,0,0,2.540009,-2.540009,209,214,21,22,-1,1,1.05714297294617,-1.05714297294617,3,1,0,0,2,-2,0,0,364,188,176,-176
Claudia Gadelha,Karolina Kowalkiewicz,Claudia Gadelha,2017-06-03,1,0,-3,3,3.6,2.142857,2.539993,-2.539993,0,0,-2.539993,2.539993,46,0,23,22,1,-1,1.45714282989502,-1.45714282989502,0,0,0,0,0,0,0,0,330,203,127,-127
Jodie Esquibel,Karolina Kowalkiewicz,Karolina Kowalkiewicz,2017-10-21,0,1,-1,1,1,2.142857,-5.080002,5.080002,0,0,0,0,72,10,12,22,-10,10,-1.14285707473755,1.14285707473755,0,0,0,0,0,0,0,0,0,140,-140,140
Felice Herrig,Karolina Kowalkiewicz,Karolina Kowalkiewicz,2018-04-07,0,1,1,-1,1.4,2.142857,2.539993,-2.539993,0,0,2.540009,-2.540009,105,71,24,22,2,-2,-0.742857098579407,0.742857098579407,1,1,0,0,0,0,0,0,286,168,118,-118
Jessica Andrade,Karolina Kowalkiewicz,Jessica Andrade,2018-09-08,1,0,-6,6,2,2.142857,-5.080002,5.080002,0,0,-5.080002,5.080002,1,0,36,22,14,-14,-0.142857074737549,0.142857074737549,2,2,1,0,0,0,1,-1,196,154,42,-42
Alexa Grasso,Karolina Kowalkiewicz,Alexa Grasso,2019-06-08,1,0,-8,8,5.333333,2.142857,5.080002,-5.080002,10,-10,5.080002,-5.080002,7,34,19,22,-3,3,3.1904764175415,-3.1904764175415,0,0,0,1,0,0,-1,1,385,273,112,-112
Felice Herrig,Karolina Kowalkiewicz,Karolina Kowalkiewicz,2022-06-04,0,1,1,-1,1.4,2.142857,2.539993,-2.539993,0,0,2.540009,-2.540009,1,190,24,22,2,-2,-0.742857098579407,0.742857098579407,0,0,0,1,0,0,-1,1,658,1092,-434,434
Silvana Gomez Juarez,Karolina Kowalkiewicz,Karolina Kowalkiewicz,2022-11-12,0,1,0,0,2.2,2.142857,0,0,0,0,2.540009,-2.540009,10,243,16,22,-6,6,5.7142972946167e-02,-5.7142972946167e-02,1,1,0,1,0,0,-1,1,154,161,-7,7
Vanessa Demopoulos,Karolina Kowalkiewicz,Karolina Kowalkiewicz,2023-05-20,0,1,-3,3,1.8,2.142857,-2.540009,2.540009,0,0,-12.7,12.7,0,112,14,22,-8,8,-0.342857122421265,0.342857122421265,3,2,0,1,1,-1,-1,1,182,189,-7,7
Liz Carmouche,Katlyn Chookagian,Liz Carmouche,2016-11-12,1,0,5,-5,1.857143,3.6,-7.619995,7.619995,0,0,-5.080002,5.080002,456,10,20,23,-3,3,-1.74285709857941,1.74285709857941,1,0,0,0,1,-1,0,0,588,0,588,-588
Irene Aldana,Katlyn Chookagian,Katlyn Chookagian,2017-04-08,0,1,1,-1,2,3.6,0,0,10,-10,0,0,0,18,21,23,-2,2,-1.59999990463257,1.59999990463257,0,0,0,0,0,0,0,0,112,147,-35,35
Jessica Andrade,Katlyn Chookagian,Jessica Andrade,2020-10-17,1,0,-2,2,2,3.6,-20.31999,20.31999,-10,10,-15.24001,15.24001,146,25,36,23,13,-13,-1.59999990463257,1.59999990463257,0,1,2,0,-1,1,2,-2,98,1288,-1190,1190
Cynthia Calvillo,Katlyn Chookagian,Katlyn Chookagian,2020-11-21,0,1,2,-2,1.5,3.6,-12.7,12.7,-10,10,-10.16,10.16,0,2,15,23,-8,8,-2.09999990463257,2.09999990463257,2,0,0,1,2,-2,-1,1,161,35,126,-126
Viviane Araujo,Katlyn Chookagian,Katlyn Chookagian,2021-05-15,0,1,2,-2,2.2,3.6,-12.7,12.7,0,0,0,0,184,1,16,23,-7,7,-1.39999985694885,1.39999985694885,2,1,0,1,1,-1,-1,1,115,175,-60,60
Tony Ferguson,Katsunori Kikuno,Tony Ferguson,2014-05-24,1,0,-2,2,2.888889,3,7.619995,-7.619995,10,-10,25.39999,-25.39999,37,23,35,32,3,-3,-0.111111164093018,0.111111164093018,1,0,0,0,1,-1,0,0,217,0,217,-217
Diego Brandao,Katsunori Kikuno,Diego Brandao,2015-09-26,1,0,-5,5,2,3,-2.540009,2.540009,0,0,-5.080002,5.080002,8,2,33,32,1,-1,-1,1,1,0,2,1,1,-1,1,-1,161,490,-329,329
Lyoto Machida,Kazuhiro Nakamura,Lyoto Machida,2007-09-22,1,0,1,-1,3,1.615385,5.080002,-5.080002,-20,20,10.16,-10.16,548,107,32,34,-2,2,1.38461542129517,-1.38461542129517,0,0,0,0,0,0,0,0,0,0,0,0
Cristiano Marcello,Kazuki Tokudome,Kazuki Tokudome,2013-03-02,0,1,10,-10,2.166667,2.571429,-5.080002,5.080002,0,0,-2.539993,2.539993,55,506,19,25,-6,6,-0.404761791229248,0.404761791229248,0,0,1,0,0,0,1,-1,274,0,274,-274
Norman Parke,Kazuki Tokudome,Norman Parke,2013-07-06,1,0,0,0,3.833333,2.571429,0,0,0,0,-7.619995,7.619995,283,158,29,25,4,-4,1.2619047164917,-1.2619047164917,0,1,0,0,-1,1,0,0,0,126,-126,126
Yui Chul Nam,Kazuki Tokudome,Yui Chul Nam,2014-03-01,1,0,6,-6,2.25,2.571429,-5.080002,5.080002,-10,10,-7.419998,7.419998,294,463,26,25,1,-1,-0.321428537368774,0.321428537368774,0,0,0,0,0,0,0,0,0,238,-238,238
Johnny Case,Kazuki Tokudome,Johnny Case,2014-09-20,1,0,-2,2,3.666667,2.571429,-2.539993,2.539993,0,0,-2.539993,2.539993,12,178,28,25,3,-3,1.09523820877075,-1.09523820877075,0,0,0,0,0,0,0,0,0,203,-203,203
Alex Da Silva,Kazula Vargas,Alex Da Silva,2019-08-10,1,0,-10,10,5.25,2.4,0,0,0,0,5.080002,-5.080002,721,18,25,17,8,-8,2.84999990463257,-2.84999990463257,0,0,0,0,0,0,0,0,112,0,112,-112
Paddy Pimblett,Kazula Vargas,Paddy Pimblett,2022-03-19,1,0,-9,9,6.666667,2.4,5.080002,-5.080002,0,0,5.080002,-5.080002,53,163,23,17,6,-6,4.26666641235352,-4.26666641235352,1,0,0,0,1,-1,0,0,196,952,-756,756
Marcio Cruz,Keigo Kunihara,Marcio Cruz,2005-10-07,1,0,,,2.666667,1.5,10.15999,-10.15999,-3,3,10,-10,27,195,11,5,6,-6,1.16666674613953,-1.16666674613953,0,0,0,0,0,0,0,0,0,0,0,0
Eugene Jackson,Keiichiro Yamamiya,Eugene Jackson,1999-11-19,1,0,6,-6,1.666667,1.285714,-7.619995,7.619995,0,0,-5,5,156,51,24,80,-56,56,0.38095235824585,-0.38095235824585,0,0,0,0,0,0,0,0,0,0,0,0
Brock Larson,Keita Nakamura,Brock Larson,2006-12-13,1,0,7,-7,4.2,3.4,0,0,0,0,-5.080002,5.080002,602,1,52,44,8,-8,0.799999713897705,-0.799999713897705,0,0,0,0,0,0,0,0,0,0,0,0
Drew Fickett,Keita Nakamura,Drew Fickett,2007-04-05,1,0,5,-5,2,3.4,-2.539993,2.539993,-15,15,-7.619995,7.619995,404,181,63,44,19,-19,-1.40000009536743,1.40000009536743,0,0,0,0,0,0,0,0,113,113,0,0
Rob Emerson,Keita Nakamura,Rob Emerson,2008-02-02,1,0,3,-3,1.5,3.4,-5.080002,5.080002,-15,15,-7.619995,7.619995,0,88,30,44,-14,14,-1.90000009536743,1.90000009536743,0,0,0,0,0,0,0,0,0,303,-303,303
Li Jingliang,Keita Nakamura,Keita Nakamura,2015-09-26,0,1,-4,4,2.375,3.4,2.540009,-2.540009,0,0,-5.080002,5.080002,95,261,27,44,-17,17,-1.02500009536743,1.02500009536743,1,0,0,0,1,-1,0,0,133,2793,-2660,2660
Tom Breese,Keita Nakamura,Tom Breese,2016-02-27,1,0,-7,7,4,3.4,10.16,-10.16,15,-15,0,0,386,239,15,44,-29,29,0.599999904632568,-0.599999904632568,2,1,0,0,1,-1,0,0,126,154,-28,28
Alex Morono,Keita Nakamura,Keita Nakamura,2017-09-22,0,1,-6,6,2.875,3.4,0,0,0,0,-2.539993,2.539993,0,45,31,44,-13,13,-0.525000095367432,0.525000095367432,1,0,0,0,1,-1,0,0,629,573,56,-56
Sultan Aliev,Keita Nakamura,Sultan Aliev,2019-04-20,1,0,0,0,5,3.4,0,0,0,0,2.540009,-2.540009,346,18,18,44,-26,26,1.59999990463257,-1.59999990463257,0,1,2,0,-1,1,2,-2,343,575,-232,232
Royce Gracie,Keith Hackney,Royce Gracie,1994-12-16,1,0,,,7.5,1,5.080002,-5.080002,-25,25,9,-9,0,0,17,4,13,-13,6.5,-6.5,4,0,0,0,4,-4,0,0,98,0,98,-98
Stephan Bonnar,Keith Jardine,Stephan Bonnar,2006-04-06,1,0,-1,1,1.666667,1.545455,5.079987,-5.079987,20,-20,7.62001,-7.62001,234,28,24,28,-4,4,0.121212124824524,-0.121212124824524,2,0,0,0,2,-2,0,0,80,0,80,-80
Wilson Gouveia,Keith Jardine,Keith Jardine,2006-06-24,0,1,-3,3,1.75,1.545455,-2.540009,2.540009,0,0,0,0,29,33,22,28,-6,6,0.204545497894287,-0.204545497894287,0,0,0,0,0,0,0,0,0,79,-79,79
Forrest Griffin,Keith Jardine,Keith Jardine,2006-12-30,0,1,-4,4,2.714286,1.545455,2.539993,-2.539993,20,-20,2.540009,-2.540009,0,11,26,28,-2,2,1.16883111000061,-1.16883111000061,0,1,0,0,-1,1,0,0,259,189,70,-70
Houston Alexander,Keith Jardine,Houston Alexander,2007-05-26,1,0,4,-4,1.133333,1.545455,-5.080002,5.080002,20,-20,-10.15999,10.15999,20,0,32,28,4,-4,-0.412121176719666,0.412121176719666,0,2,0,0,-2,2,0,0,0,147,-147,147
Quinton Jackson,Keith Jardine,Quinton Jackson,2009-03-07,1,0,-3,3,3.083333,1.545455,-2.540009,2.540009,20,-20,-7.619995,7.619995,174,28,49,28,21,-21,1.53787875175476,-1.53787875175476,2,0,0,1,2,-2,-1,1,70,651,-581,581
Ryan Bader,Keith Jardine,Ryan Bader,2010-02-20,1,0,-8,8,4.6,1.545455,0,0,20,-20,-5.079987,5.079987,276,0,28,28,0,0,3.05454540252686,-3.05454540252686,3,0,0,1,3,-3,-1,1,119,350,-231,231
Matt Hamill,Keith Jardine,Matt Hamill,2010-06-19,1,0,-1,1,1.5,1.545455,-2.540009,2.540009,20,-20,0,0,91,0,20,28,-8,8,-4.54545021057129e-02,4.54545021057129e-02,4,0,0,2,4,-4,-2,2,196,119,77,-77
Sam Adkins,Keith Mielke,Sam Adkins,1996-02-16,1,0,,,0.35,0,17.78,-17.78,40,-40,27,-27,0,0,27,5,22,-22,0.349999994039536,-0.349999994039536,0,0,0,0,0,0,0,0,0,0,0,0
Eugene Jackson,Keith Rockel,Eugene Jackson,2002-01-11,1,0,,,1.666667,3,-10.16,10.16,0,0,3,-3,4,331,24,16,8,-8,-1.33333337306976,1.33333337306976,0,0,0,0,0,0,0,0,637,0,637,-637
Chris Liguori,Keith Rockel,Keith Rockel,2003-11-21,0,1,,,1.5,3,-7.62001,7.62001,0,0,3,-3,8,184,25,16,9,-9,-1.5,1.5,0,0,0,0,0,0,0,0,0,679,-679,679
Nick Thompson,Keith Wisniewski,Nick Thompson,2005-11-19,1,0,0,0,2.714286,1.866667,2.539993,-2.539993,0,0,2.960007,-2.960007,429,246,52,43,9,-9,0.847618937492371,-0.847618937492371,0,0,0,0,0,0,0,0,0,0,0,0
Josh Neer,Keith Wisniewski,Josh Neer,2011-10-01,1,0,-1,1,2.25,1.866667,-2.540009,2.540009,0,0,-2.119995,2.119995,42,220,52,43,9,-9,0.383333325386047,-0.383333325386047,0,0,0,0,0,0,0,0,707,2142,-1435,1435
Chris Clements,Keith Wisniewski,Chris Clements,2012-04-21,1,0,6,-6,2,1.866667,-5.080002,5.080002,0,0,-7.199997,7.199997,94,350,18,43,-25,25,0.133333325386047,-0.133333325386047,0,0,0,1,0,0,-1,1,0,203,-203,203
Ivan Jorge,Keith Wisniewski,Ivan Jorge,2013-09-04,1,0,1,-1,3.857143,1.866667,-7.62001,7.62001,-15,15,0.4199982,-0.4199982,425,39,34,43,-9,9,1.9904762506485,-1.9904762506485,0,0,0,1,0,0,-1,1,0,501,-501,501
Jake Ellenberger,Kelvin Gastelum,Kelvin Gastelum,2014-11-15,0,1,6,-6,2.066667,2.25,0,0,0,0,0,0,3,116,46,26,20,-20,-0.183333396911621,0.183333396911621,0,0,2,0,0,0,2,-2,175,0,175,-175
Michael Bisping,Kelvin Gastelum,Kelvin Gastelum,2017-11-25,0,1,12,-12,3.333333,2.25,10.16,-10.16,15,-15,10.16,-10.16,0,7,39,26,13,-13,1.08333325386047,-1.08333325386047,0,1,1,0,-1,1,1,-1,21,1106,-1085,1085
Israel Adesanya,Kelvin Gastelum,Israel Adesanya,2019-04-13,1,0,2,-2,8,2.25,17.78,-17.78,15,-15,22.86,-22.86,42,81,27,26,1,-1,5.75,-5.75,5,2,0,0,3,-3,0,0,63,504,-441,441
Jared Cannonier,Kelvin Gastelum,Jared Cannonier,2021-08-21,1,0,8,-8,2.833333,2.25,5.080002,-5.080002,15,-15,15.24001,-15.24001,2,151,23,26,-3,3,0.583333253860474,-0.583333253860474,0,0,2,0,0,0,2,-2,301,861,-560,560
Chris Curtis,Kelvin Gastelum,Kelvin Gastelum,2023-04-08,0,1,4,-4,3,2.25,2.540009,-2.540009,15,-15,10.16,-10.16,1,81,40,26,14,-14,0.75,-0.75,0,0,0,0,0,0,0,0,259,595,-336,336
Felix Lee Mitchell,Ken Shamrock,Ken Shamrock,1994-09-09,0,1,,,0.2857143,1.647059,,,,,-9.880005,9.880005,0,0,9,45,-36,36,-1.36134454607964,1.36134454607964,0,0,0,0,0,0,0,0,0,0,0,0
Christophe Leninger,Ken Shamrock,Ken Shamrock,1994-09-09,0,1,,,0.75,1.647059,-2.539993,2.539993,-5,5,3.119995,-3.119995,0,0,7,45,-38,38,-0.897058844566345,0.897058844566345,0,1,0,0,-1,1,0,0,0,0,0,0
Dan Severn,Ken Shamrock,Ken Shamrock,1995-07-14,0,1,6,-6,5.31579,1.647059,2.540009,-2.540009,45,-45,8.119995,-8.119995,0,0,120,45,75,-75,3.6687308549881,-3.6687308549881,1,2,0,0,-1,1,0,0,98,308,-210,210
Kimo Leopoldo,Ken Shamrock,Ken Shamrock,1996-02-16,0,1,-4,4,1.428571,1.647059,5.080002,-5.080002,30,-30,10.12,-10.12,0,0,17,45,-28,28,-0.21848738193512,0.21848738193512,0,3,0,0,-3,3,0,0,0,217,-217,217
Dan Severn,Ken Shamrock,Dan Severn,1996-05-17,1,0,5,-5,5.31579,1.647059,2.540009,-2.540009,45,-45,8.119995,-8.119995,0,0,120,45,75,-75,3.6687308549881,-3.6687308549881,2,4,0,0,-2,2,0,0,153,91,62,-62
Brian Johnston,Ken Shamrock,Ken Shamrock,1996-12-07,0,1,,,1,1.647059,5.080002,-5.080002,25,-25,10.12,-10.12,0,0,10,45,-35,35,-0.647058844566345,0.647058844566345,1,0,0,0,1,-1,0,0,78,204,-126,126
Tito Ortiz,Ken Shamrock,Tito Ortiz,2002-11-22,1,0,-11,11,1.583333,1.647059,5.080002,-5.080002,0,0,5.080002,-5.080002,627,1,31,45,-14,14,-6.3725471496582e-02,6.3725471496582e-02,3,1,1,0,2,-2,1,-1,511,2176,-1665,1665
Kimo Leopoldo,Ken Shamrock,Ken Shamrock,2004-06-19,0,1,-4,4,1.428571,1.647059,5.080002,-5.080002,30,-30,10.12,-10.12,6,9,17,45,-28,28,-0.21848738193512,0.21848738193512,1,0,0,1,1,-1,-1,1,2751,575,2176,-2176
Rich Franklin,Ken Shamrock,Rich Franklin,2005-04-09,1,0,-11,11,4.142857,1.647059,0,0,-20,20,10.15999,-10.15999,17,25,36,45,-9,9,2.4957982301712,-2.4957982301712,2,1,0,1,1,-1,-1,1,169,294,-125,125
Tito Ortiz,Ken Shamrock,Tito Ortiz,2006-07-08,1,0,-11,11,1.583333,1.647059,5.080002,-5.080002,0,0,5.080002,-5.080002,64,4,31,45,-14,14,-6.3725471496582e-02,6.3725471496582e-02,4,0,1,2,4,-4,-1,1,1324,455,869,-869
Tito Ortiz,Ken Shamrock,Tito Ortiz,2006-10-10,1,0,-11,11,1.583333,1.647059,5.080002,-5.080002,0,0,5.080002,-5.080002,126,0,31,45,-14,14,-6.3725471496582e-02,6.3725471496582e-02,5,0,1,3,5,-5,-2,2,94,94,0,0
Scott Jorgensen,Ken Stone,Scott Jorgensen,2011-06-04,1,0,0,0,1.25,2.75,-7.619995,7.619995,0,0,-12.7,12.7,69,21,27,15,12,-12,-1.5,1.5,0,0,0,0,0,0,0,0,0,0,0,0
Dustin Pague,Ken Stone,Ken Stone,2012-06-22,0,1,-5,5,1.090909,2.75,2.539993,-2.539993,0,0,7.62001,-7.62001,1,306,23,15,8,-8,-1.65909087657928,1.65909087657928,1,0,0,1,1,-1,-1,1,14,384,-370,370
Erik Perez,Ken Stone,Erik Perez,2012-08-11,1,0,-7,7,2.833333,2.75,0,0,0,0,-7.619995,7.619995,4,0,23,15,8,-8,8.33332538604736e-02,-8.33332538604736e-02,0,1,0,1,-1,1,-1,1,0,50,-50,50
Alan Belcher,Kendall Grove,Kendall Grove,2007-04-07,0,1,-2,2,2.25,1.352941,-10.15999,10.15999,0,0,-10.16,10.16,132,284,26,40,-14,14,0.897058844566345,-0.897058844566345,1,0,0,0,1,-1,0,0,115,0,115,-115
Patrick Cote,Kendall Grove,Patrick Cote,2007-08-25,1,0,3,-3,2.090909,1.352941,-17.78,17.78,-15,15,-10.16,10.16,161,6,34,40,-6,6,0.737967848777771,-0.737967848777771,1,1,0,0,0,0,0,0,203,140,63,-63
Jason Day,Kendall Grove,Kendall Grove,2009-03-07,0,1,1,-1,1.583333,1.352941,-15.23999,15.23999,0,0,-17.78,17.78,0,3,31,40,-9,9,0.230392217636108,-0.230392217636108,0,0,0,1,0,0,-1,1,0,560,-560,560
Ricardo Almeida,Kendall Grove,Ricardo Almeida,2009-08-08,1,0,6,-6,2.6,1.352941,-15.23999,15.23999,-15,15,-12.7,12.7,673,57,18,40,-22,22,1.24705874919891,-1.24705874919891,1,1,1,1,0,0,0,0,129,154,-25,25
Tim Boetsch,Kendall Grove,Tim Boetsch,2011-05-28,1,0,2,-2,1.615385,1.352941,-15.23999,15.23999,0,0,-12.7,12.7,600,108,34,40,-6,6,0.262443423271179,-0.262443423271179,0,0,1,1,0,0,0,0,189,658,-469,469
Katsuhisa Fujii,Kenichi Yamamoto,Kenichi Yamamoto,1999-11-19,0,1,4,-4,0.5,0.4166667,0,0,35,-35,1,-1,528,0,27,17,10,-10,8.33333432674408e-02,-8.33333432674408e-02,1,0,0,0,1,-1,0,0,0,0,0,0
Daiju Takase,Kenichi Yamamoto,Kenichi Yamamoto,1999-11-19,0,1,-2,2,0.8,0.4166667,0,0,0,0,0,0,0,856,27,17,10,-10,0.38333335518837,-0.38333335518837,0,1,0,0,-1,1,0,0,0,0,0,0
Pat Miletich,Kenichi Yamamoto,Pat Miletich,2000-12-16,1,0,8,-8,4.142857,0.4166667,-5.080002,5.080002,0,0,-5,5,264,1,36,17,19,-19,3.72619041800499,-3.72619041800499,3,2,0,0,1,-1,0,0,519,393,126,-126
Paul Craig,Kennedy Nzechukwu,Paul Craig,2019-03-30,1,0,5,-5,2.833333,3,-5.080002,5.080002,-20,20,-17.78001,17.78001,98,264,23,16,7,-7,-0.166666746139526,0.166666746139526,0,0,2,0,0,0,2,-2,119,0,119,-119
Danilo Marques,Kennedy Nzechukwu,Kennedy Nzechukwu,2021-06-26,0,1,6,-6,2.75,3,2.539993,-2.539993,0,0,-15.24001,15.24001,462,0,15,16,-1,1,-0.25,0.25,1,0,0,0,1,-1,0,0,140,819,-679,679
Nicolae Negumereanu,Kennedy Nzechukwu,Nicolae Negumereanu,2022-03-05,1,0,-2,2,6.5,3,-12.7,12.7,0,0,-12.70001,12.70001,208,0,15,16,-1,1,3.5,-3.5,1,1,0,0,0,0,0,0,133,252,-119,119
Ion Cutelaba,Kennedy Nzechukwu,Kennedy Nzechukwu,2022-11-19,0,1,-2,2,1.888889,3,-10.16,10.16,0,0,-20.32001,20.32001,212,74,26,16,10,-10,-1.11111116409302,1.11111116409302,0,0,0,0,0,0,0,0,70,259,-189,189
Devin Clark,Kennedy Nzechukwu,Kennedy Nzechukwu,2023-05-06,0,1,3,-3,1.75,3,-12.7,12.7,0,0,-20.32001,20.32001,64,222,22,16,6,-6,-1.25,1.25,1,1,3,0,0,0,3,-3,91,168,-77,77
Dustin Jacoby,Kennedy Nzechukwu,Dustin Jacoby,2023-08-05,1,0,4,-4,2.714286,3,-5.080002,5.080002,0,0,-17.78001,17.78001,4,0,26,16,10,-10,-0.285714387893677,0.285714387893677,0,2,0,0,-2,2,0,0,112,91,21,-21
Kit Cope,Kenny Florian,Kenny Florian,2005-11-05,0,1,-1,1,0.8571429,2.333333,5.080002,-5.080002,25,-25,-1.960007,1.960007,15,259,13,20,-7,7,-1.47619038820267,1.47619038820267,0,0,0,0,0,0,0,0,0,0,0,0
Jose Aldo,Kenny Florian,Jose Aldo,2011-10-08,1,0,-10,10,3.875,2.333333,-7.62001,7.62001,-10,10,-10.16,10.16,351,367,39,20,19,-19,1.54166674613953,-1.54166674613953,1,1,0,0,0,0,0,0,161,2163,-2002,2002
Mike Pierce,Kenny Robertson,Mike Pierce,2011-02-05,1,0,4,-4,2.428571,3,-5.080002,5.080002,0,0,-7.62001,7.62001,239,13,24,20,4,-4,-0.571428537368774,0.571428537368774,0,0,0,0,0,0,0,0,0,0,0,0
Brock Jardine,Kenny Robertson,Kenny Robertson,2013-02-23,0,1,-2,2,2,3,2.539993,-2.539993,0,0,-7.960007,7.960007,0,155,18,20,-2,2,-1,1,0,0,0,1,0,0,-1,1,246,749,-503,503
Sean Pierson,Kenny Robertson,Sean Pierson,2013-06-15,1,0,8,-8,2.333333,3,5.080002,-5.080002,0,0,5.079987,-5.079987,91,401,20,20,0,0,-0.666666746139526,0.666666746139526,1,1,0,1,0,0,-1,1,917,112,805,-805
Thiago Perpetuo,Kenny Robertson,Kenny Robertson,2014-03-23,0,1,-4,4,2.25,3,0,0,0,0,-7.960007,7.960007,30,63,13,20,-7,7,-0.75,0.75,0,0,0,1,0,0,-1,1,0,281,-281,281
Ildemar Alcantara,Kenny Robertson,Kenny Robertson,2014-07-05,0,1,1,-1,1.909091,3,10.16,-10.16,15,-15,10.15999,-10.15999,43,521,32,20,12,-12,-1.09090912342072,1.09090912342072,1,1,0,1,0,0,-1,1,140,104,36,-36
Sultan Aliev,Kenny Robertson,Kenny Robertson,2015-01-24,0,1,0,0,5,3,2.539993,-2.539993,0,0,0,0,22,29,18,20,-2,2,2,-2,0,2,0,1,-2,2,-1,1,0,203,-203,203
Roan Carneiro,Kenny Robertson,Roan Carneiro,2016-09-17,1,0,6,-6,1.909091,3,2.539993,-2.539993,0,0,5.079987,-5.079987,157,192,32,20,12,-12,-1.09090912342072,1.09090912342072,1,3,0,1,-2,2,-1,1,567,602,-35,35
Keith Jardine,Kerry Schall,Keith Jardine,2005-11-05,1,0,-4,4,1.545455,1.846154,0,0,-80,80,2.039993,-2.039993,0,0,28,37,-9,9,-0.300699353218079,0.300699353218079,0,0,0,0,0,0,0,0,0,0,0,0
Karine Silva,Ketlen Souza,Karine Silva,2023-06-03,1,0,1,-1,4.25,3.25,5.080002,-5.080002,0,0,10.15999,-10.15999,81,0,21,17,4,-4,1,-1,0,0,0,0,0,0,0,0,0,0,0,0
Kelly Faszholz,Ketlen Vieira,Ketlen Vieira,2016-10-01,0,1,6,-6,2,4.666667,0,0,0,0,2.279999,-2.279999,45,504,6,17,-11,11,-2.66666650772095,2.66666650772095,0,0,1,0,0,0,1,-1,223,0,223,-223
Ashlee Evans-Smith,Ketlen Vieira,Ketlen Vieira,2017-04-15,0,1,4,-4,1,4.666667,0,0,0,0,-2.540009,2.540009,5,246,12,17,-5,5,-3.66666650772095,3.66666650772095,2,1,0,0,1,-1,0,0,224,196,28,-28
Sara McMann,Ketlen Vieira,Ketlen Vieira,2017-09-09,0,1,10,-10,2.166667,4.666667,-5.080002,5.080002,0,0,-5.080002,5.080002,332,105,19,17,2,-2,-2.49999976158142,2.49999976158142,0,2,1,0,-2,2,1,-1,763,147,616,-616
Irene Aldana,Ketlen Vieira,Irene Aldana,2019-12-14,1,0,3,-3,2,4.666667,2.539993,-2.539993,0,0,0,0,2,0,21,17,4,-4,-2.66666650772095,2.66666650772095,1,3,0,0,-2,2,0,0,84,826,-742,742
Sijara Eubanks,Ketlen Vieira,Ketlen Vieira,2020-09-26,0,1,6,-6,1.142857,4.666667,-10.16,10.16,-10,10,-2.540009,2.540009,39,147,15,17,-2,2,-3.52380931377411,3.52380931377411,1,0,0,1,1,-1,-1,1,136,287,-151,151
Yana Santos,Ketlen Vieira,Yana Santos,2021-02-20,1,0,2,-2,1.75,4.666667,-5.080002,5.080002,0,0,0,0,309,518,22,17,5,-5,-2.91666650772095,2.91666650772095,1,1,0,1,0,0,-1,1,196,147,49,-49
Miesha Tate,Ketlen Vieira,Ketlen Vieira,2021-11-20,0,1,5,-5,2.111111,4.666667,-5.080002,5.080002,0,0,-7.619995,7.619995,172,2,28,17,11,-11,-2.55555534362793,2.55555534362793,0,0,1,1,0,0,0,0,3143,273,2870,-2870
Holly Holm,Ketlen Vieira,Ketlen Vieira,2022-05-21,0,1,10,-10,2.142857,4.666667,0,0,0,0,2.539993,-2.539993,603,84,22,17,5,-5,-2.5238094329834,2.5238094329834,1,1,1,1,0,0,0,0,854,182,672,-672
Raquel Pennington,Ketlen Vieira,Raquel Pennington,2023-01-14,1,0,3,-3,1.666667,4.666667,-2.540009,2.540009,0,0,-2.540009,2.540009,78,285,24,17,7,-7,-2.99999988079071,2.99999988079071,3,2,0,1,1,-1,-1,1,938,238,700,-700
Pannie Kianzad,Ketlen Vieira,Ketlen Vieira,2023-07-22,0,1,0,0,2.428571,4.666667,-2.540009,2.540009,0,0,-5.080002,5.080002,131,649,24,17,7,-7,-2.23809504508972,2.23809504508972,1,0,0,1,1,-1,-1,1,462,189,273,-273
Ildemar Alcantara,Kevin Casey,Kevin Casey,2015-07-15,0,1,-2,2,1.909091,1.8,7.62001,-7.62001,0,0,2.539993,-2.539993,20,238,32,14,18,-18,0.109090924263,-0.109090924263,1,0,0,0,1,-1,0,0,165,0,165,-165
Sam Alvey,Kevin Casey,Sam Alvey,2016-08-27,1,0,-5,5,1.833333,1.8,7.62001,-7.62001,0,0,-5.080002,5.080002,31,156,51,14,37,-37,3.3333420753479e-02,-3.3333420753479e-02,1,1,1,0,0,0,1,-1,45,409,-364,364
Alex Caceres,Kevin Croom,Alex Caceres,2021-02-27,1,0,-1,1,1.5,1.4,-2.539993,2.539993,10,-10,0,0,224,452,35,36,-1,1,0.100000023841858,-0.100000023841858,3,0,1,0,3,-3,1,-1,182,0,182,-182
Houston Alexander,Kevin Ferguson,Kevin Ferguson,2009-12-05,0,1,2,-2,1.133333,2.5,-5.080002,5.080002,-30,30,-12.7,12.7,16,199,32,7,25,-25,-1.36666667461395,1.36666667461395,0,0,2,0,0,0,2,-2,444,0,444,-444
Alessio Di Chirico,Kevin Holland,Kevin Holland,2019-06-22,0,1,3,-3,1.857143,2.5,-7.619995,7.619995,15,-15,-17.78,17.78,102,200,20,35,-15,15,-0.642857193946838,0.642857193946838,1,0,0,0,1,-1,0,0,351,0,351,-351
Brendan Allen,Kevin Holland,Brendan Allen,2019-10-18,1,0,-3,3,4.4,2.5,-2.539993,2.539993,15,-15,-15.24001,15.24001,173,283,27,35,-8,8,1.90000009536743,-1.90000009536743,0,1,0,0,-1,1,0,0,0,118,-118,118
Anthony Hernandez,Kevin Holland,Kevin Holland,2020-05-16,0,1,-1,1,5.5,2.5,-7.619995,7.619995,15,-15,-15.24001,15.24001,0,4,13,35,-22,22,3,-3,1,0,0,0,1,-1,0,0,259,211,48,-48
Joaquin Buckley,Kevin Holland,Kevin Holland,2020-08-08,0,1,-1,1,2.666667,2.5,-12.7,12.7,0,0,-12.70001,12.70001,13,12,22,35,-13,13,0.166666746139526,-0.166666746139526,0,1,0,0,-1,1,0,0,0,84,-84,84
Derek Brunson,Kevin Holland,Derek Brunson,2021-03-20,1,0,9,-9,2.555556,2.5,-5.080002,5.080002,15,-15,-10.16,10.16,1015,107,32,35,-3,3,5.55555820465088e-02,-5.55555820465088e-02,3,2,3,0,1,-1,3,-3,231,224,7,-7
Khamzat Chimaev,Kevin Holland,Khamzat Chimaev,2022-09-10,1,0,-1,1,12,2.5,-2.539993,2.539993,15,-15,-15.24001,15.24001,116,0,12,35,-23,23,9.5,-9.5,4,0,0,0,4,-4,0,0,315,539,-224,224
Michael Chiesa,Kevin Holland,Kevin Holland,2023-07-29,0,1,5,-5,2.571429,2.5,-5.080002,5.080002,0,0,-15.24001,15.24001,15,40,25,35,-10,10,7.14285373687744e-02,-7.14285373687744e-02,0,0,1,0,0,0,1,-1,721,322,399,-399
Jack Della Maddalena,Kevin Holland,Jack Della Maddalena,2023-09-16,1,0,-3,3,8,2.5,-10.16,10.16,0,0,-20.32001,20.32001,0,0,18,35,-17,17,5.5,-5.5,4,1,0,0,3,-3,0,0,63,49,14,-14
Tony Fryklund,Kevin Jackson,Kevin Jackson,1997-07-27,0,1,,,1.555556,2,5.080002,-5.080002,-14,14,6,-6,0,0,23,6,17,-17,-0.444444417953491,0.444444417953491,0,0,0,0,0,0,0,0,0,0,0,0
Todd Butler,Kevin Jackson,Kevin Jackson,1997-07-27,0,1,,,0.25,2,7.619995,-7.619995,1,-1,16,-16,0,0,5,6,-1,1,-1.75,1.75,0,1,0,0,-1,1,0,0,0,0,0,0
Jerry Bohlander,Kevin Jackson,Jerry Bohlander,1998-03-13,1,0,,,2.75,2,2.539993,-2.539993,0,0,3,-3,0,0,15,6,9,-9,0.75,-0.75,3,2,1,0,1,-1,1,-1,399,229,170,-170
Paul Buentello,Kevin Jordan,Paul Buentello,2005-06-04,1,0,-3,3,2.058824,1.222222,-2.539993,2.539993,0,0,2.580002,-2.580002,40,82,52,20,32,-32,0.836601376533508,-0.836601376533508,1,0,0,0,1,-1,0,0,119,0,119,-119
Gabriel Gonzaga,Kevin Jordan,Gabriel Gonzaga,2005-11-19,1,0,-8,8,1.545455,1.222222,-2.539993,2.539993,-3,3,3.999329e-02,-3.999329e-02,291,5,28,20,8,-8,0.323232293128967,-0.323232293128967,0,0,0,0,0,0,0,0,0,168,-168,168
Kiefer Crosbie,Kevin Jousset,Kevin Jousset,2023-09-09,0,1,3,-3,2.5,4.5,-7.62001,7.62001,0,0,-12.7,12.7,0,45,14,11,3,-3,-2,2,0,0,0,0,0,0,0,0,0,0,0,0
Al Iaquinta,Kevin Lee,Al Iaquinta,2014-02-01,1,0,5,-5,2,2.25,2.540009,-2.540009,-15,15,-17.78,17.78,108,250,21,26,-5,5,-0.25,0.25,0,0,0,0,0,0,0,0,0,0,0,0
Efrain Escudero,Kevin Lee,Kevin Lee,2016-04-23,0,1,7,-7,2.333333,2.25,0,0,-15,15,-15.24001,15.24001,133,256,40,26,14,-14,8.33332538604736e-02,-8.33332538604736e-02,0,0,0,0,0,0,0,0,154,812,-658,658
Michael Chiesa,Kevin Lee,Kevin Lee,2017-06-25,0,1,5,-5,2.571429,2.25,10.16,-10.16,0,0,-5.080002,5.080002,8,213,25,26,-1,1,0.321428537368774,-0.321428537368774,3,1,1,0,2,-2,1,-1,435,428,7,-7
Tony Ferguson,Kevin Lee,Tony Ferguson,2017-10-07,1,0,8,-8,2.888889,2.25,5.080002,-5.080002,-15,15,-2.540009,2.540009,2,289,35,26,9,-9,0.638888835906982,-0.638888835906982,6,2,0,0,4,-4,0,0,451,104,347,-347
Edson Barboza,Kevin Lee,Kevin Lee,2018-04-21,0,1,7,-7,2.090909,2.25,5.080002,-5.080002,-25,25,-5.080002,5.080002,10,901,34,26,8,-8,-0.159090995788574,0.159090995788574,0,0,1,0,0,0,1,-1,112,196,-84,84
Al Iaquinta,Kevin Lee,Al Iaquinta,2018-12-15,1,0,5,-5,2,2.25,2.540009,-2.540009,-15,15,-17.78,17.78,14,325,21,26,-5,5,-0.25,0.25,0,1,0,0,-1,1,0,0,252,238,14,-14
Rafael Dos Anjos,Kevin Lee,Rafael Dos Anjos,2019-05-18,1,0,8,-8,2.133333,2.25,-2.539993,2.539993,0,0,-17.78,17.78,233,522,47,26,21,-21,-0.116666555404663,0.116666555404663,0,0,1,0,0,0,1,-1,169,154,15,-15
Gregor Gillespie,Kevin Lee,Kevin Lee,2019-11-02,0,1,5,-5,14,2.25,-5.080002,5.080002,-15,15,-15.24001,15.24001,0,1,15,26,-11,11,11.75,-11.75,5,0,0,0,5,-5,0,0,287,168,119,-119
Rinat Fakhretdinov,Kevin Lee,Rinat Fakhretdinov,2023-07-01,1,0,1,-1,21,2.25,7.62001,-7.62001,0,0,-7.619995,7.619995,20,0,22,26,-4,4,18.75,-18.75,1,1,0,0,0,0,0,0,392,1337,-945,945
Miles Johns,Kevin Natividad,Miles Johns,2020-10-31,1,0,-1,1,7,2.25,2.539993,-2.539993,0,0,-10.16,10.16,183,0,16,13,3,-3,4.75,-4.75,1,0,0,0,1,-1,0,0,413,0,413,-413
Batgerel Danaa,Kevin Natividad,Batgerel Danaa,2021-04-24,1,0,3,-3,2.4,2.25,2.539993,-2.539993,0,0,0,0,4,0,17,13,4,-4,0.150000095367432,-0.150000095367432,0,0,0,1,0,0,-1,1,0,175,-175,175
Randy Couture,Kevin Randleman,Randy Couture,2000-11-17,1,0,8,-8,1.727273,1.0625,7.619995,-7.619995,0,0,10.5,-10.5,177,531,30,33,-3,3,0.664772748947144,-0.664772748947144,3,0,0,0,3,-3,0,0,1062,0,1062,-1062
Chuck Liddell,Kevin Randleman,Chuck Liddell,2001-05-04,1,0,2,-2,2.625,1.0625,10.16,-10.16,0,0,13.03999,-13.03999,2,40,29,33,-4,4,1.5625,-1.5625,1,0,0,1,1,-1,-1,1,139,168,-29,29
Joe Charles,Kevin Rosier,Joe Charles,1994-12-16,1,0,,,0.4615385,0.3333333,-7.619995,7.619995,-15,15,-15,15,0,0,19,8,11,-11,0.128205120563507,-0.128205120563507,0,0,0,0,0,0,0,0,0,0,0,0
Pat Healy,Khabib Nurmagomedov,Khabib Nurmagomedov,2013-09-21,0,1,5,-5,1.478261,29,5.080002,-5.080002,0,0,5.080002,-5.080002,6,391,57,29,28,-28,-27.5217391252518,27.5217391252518,0,0,0,0,0,0,0,0,2592,0,2592,-2592
Rafael Dos Anjos,Khabib Nurmagomedov,Khabib Nurmagomedov,2014-04-19,0,1,4,-4,2.133333,29,-5.080002,5.080002,15,-15,0,0,13,587,47,29,18,-18,-26.8666665554047,26.8666665554047,3,1,1,0,2,-2,1,-1,336,210,126,-126
Darrell Horcher,Khabib Nurmagomedov,Khabib Nurmagomedov,2016-04-16,0,1,1,-1,3.25,29,0,0,0,0,0,0,0,332,17,29,-12,12,-25.75,25.75,0,2,0,0,-2,2,0,0,0,728,-728,728
Michael Johnson,Khabib Nurmagomedov,Khabib Nurmagomedov,2016-11-12,0,1,2,-2,1.157895,29,0,0,0,0,7.619995,-7.619995,0,524,41,29,12,-12,-27.8421052694321,27.8421052694321,3,3,0,0,0,0,0,0,56,210,-154,154
Edson Barboza,Khabib Nurmagomedov,Khabib Nurmagomedov,2017-12-30,0,1,2,-2,2.090909,29,2.539993,-2.539993,-10,10,12.7,-12.7,0,632,34,29,5,-5,-26.9090909957886,26.9090909957886,3,4,1,0,-1,1,1,-1,294,413,-119,119
Al Iaquinta,Khabib Nurmagomedov,Khabib Nurmagomedov,2018-04-07,0,1,1,-1,2,29,0,0,0,0,0,0,0,633,21,29,-8,8,-27,27,5,5,0,0,0,0,0,0,350,98,252,-252
Conor McGregor,Khabib Nurmagomedov,Khabib Nurmagomedov,2018-10-06,0,1,0,0,3.666667,29,-2.540009,2.540009,0,0,10.16,-10.16,0,735,28,29,-1,1,-25.3333332538605,25.3333332538605,3,6,0,0,-3,3,0,0,1183,182,1001,-1001
Justin Gaethje,Khabib Nurmagomedov,Khabib Nurmagomedov,2020-10-24,0,1,-1,1,6.25,29,2.539993,-2.539993,0,0,0,0,14,55,29,29,0,0,-22.75,22.75,1,7,1,0,-6,6,1,-1,791,749,42,-42
Ed Herman,Khadis Ibragimov,Ed Herman,2019-11-09,1,0,15,-15,1.6875,2,-5.080002,5.080002,0,0,-2.539993,2.539993,140,374,43,12,31,-31,-0.3125,0.3125,0,0,2,0,0,0,2,-2,378,0,378,-378
Roman Dolidze,Khadis Ibragimov,Roman Dolidze,2020-07-18,1,0,7,-7,6,2,-2.539993,2.539993,-20,20,-5.080002,5.080002,3,34,14,12,2,-2,4,-4,0,0,0,0,0,0,0,0,0,252,-252,252
CB Dollaway,Khalid Murtazaliev,Khalid Murtazaliev,2018-09-15,0,1,10,-10,1.888889,7,5.080002,-5.080002,0,0,0,0,98,359,26,16,10,-10,-5.11111116409302,5.11111116409302,2,0,4,0,2,-2,4,-4,196,0,196,-196
Nad Narimani,Khalid Taha,Nad Narimani,2018-07-22,1,0,5,-5,3,2.6,7.619995,-7.619995,10,-10,2.540009,-2.540009,605,35,16,18,-2,2,0.400000095367432,-0.400000095367432,0,0,0,0,0,0,0,0,0,0,0,0
Boston Salmon,Khalid Taha,Khalid Taha,2019-04-13,0,1,1,-1,2,2.6,10.15999,-10.15999,0,0,0,0,0,2,9,18,-9,9,-0.599999904632568,0.599999904632568,0,0,0,0,0,0,0,0,0,265,-265,265
Raoni Barcelos,Khalid Taha,Raoni Barcelos,2020-11-07,1,0,5,-5,3.4,2.6,5.079987,-5.079987,0,0,-5.080002,5.080002,195,87,22,18,4,-4,0.800000190734863,-0.800000190734863,4,1,0,0,3,-3,0,0,322,574,-252,252
Sergey Morozov,Khalid Taha,Sergey Morozov,2021-07-17,1,0,3,-3,3.8,2.6,2.539993,-2.539993,0,0,-5.080002,5.080002,514,0,24,18,6,-6,1.20000004768372,-1.20000004768372,0,0,0,0,0,0,0,0,178,252,-74,74
Cristian Quinonez,Khalid Taha,Cristian Quinonez,2022-09-03,1,0,-4,4,4.5,2.6,7.619995,-7.619995,0,0,2.540009,-2.540009,2,0,22,18,4,-4,1.90000009536743,-1.90000009536743,0,0,0,0,0,0,0,0,0,413,-413,413
Tyson Pedro,Khalil Rountree Jr.,Tyson Pedro,2016-11-26,1,0,-1,1,2.5,2.6,5.080002,-5.080002,0,0,7.62001,-7.62001,189,0,14,18,-4,4,-9.99999046325684e-02,9.99999046325684e-02,0,0,0,0,0,0,0,0,0,0,0,0
Daniel Jolly,Khalil Rountree Jr.,Khalil Rountree Jr.,2017-02-04,0,1,6,-6,1.666667,2.6,0,0,0,0,-2.539993,2.539993,8,1,8,18,-10,10,-0.933333277702332,0.933333277702332,0,0,0,0,0,0,0,0,0,70,-70,70
Paul Craig,Khalil Rountree Jr.,Khalil Rountree Jr.,2017-07-16,0,1,2,-2,2.833333,2.6,5.080002,-5.080002,-20,20,0,0,0,4,23,18,5,-5,0.233333349227905,-0.233333349227905,0,1,1,0,-1,1,1,-1,134,162,-28,28
Eryk Anders,Khalil Rountree Jr.,Khalil Rountree Jr.,2019-04-13,0,1,2,-2,1.875,2.6,0,0,-20,20,-2.539993,2.539993,27,68,23,18,5,-5,-0.724999904632568,0.724999904632568,0,2,1,0,-2,2,1,-1,126,636,-510,510
Ion Cutelaba,Khalil Rountree Jr.,Ion Cutelaba,2019-09-28,1,0,-4,4,1.888889,2.6,0,0,0,0,-2.539993,2.539993,80,0,26,18,8,-8,-0.711111068725586,0.711111068725586,0,3,0,0,-3,3,0,0,154,168,-14,14
Marcin Prachnio,Khalil Rountree Jr.,Marcin Prachnio,2021-01-23,1,0,2,-2,2.285714,2.6,5.080002,-5.080002,0,0,-5.079987,5.079987,5,0,23,18,5,-5,-0.314285516738892,0.314285516738892,0,0,1,1,0,0,0,0,154,483,-329,329
Modestas Bukauskas,Khalil Rountree Jr.,Khalil Rountree Jr.,2021-09-04,0,1,-4,4,3,2.6,5.080002,-5.080002,0,0,5.080002,-5.080002,0,0,20,18,2,-2,0.400000095367432,-0.400000095367432,0,0,1,1,0,0,0,0,161,224,-63,63
Karl Roberson,Khalil Rountree Jr.,Khalil Rountree Jr.,2022-03-12,0,1,-1,1,1.5,2.6,0,0,0,0,-5.079987,5.079987,0,15,15,18,-3,3,-1.09999990463257,1.09999990463257,0,1,0,1,-1,1,-1,1,637,189,448,-448
Dustin Jacoby,Khalil Rountree Jr.,Khalil Rountree Jr.,2022-10-29,0,1,2,-2,2.714286,2.6,5.080002,-5.080002,0,0,0,0,5,0,26,18,8,-8,0.114285707473755,-0.114285707473755,4,2,0,1,2,-2,-1,1,105,231,-126,126
Chris Daukaus,Khalil Rountree Jr.,Khalil Rountree Jr.,2023-08-12,0,1,0,0,1.714286,2.6,5.080002,-5.080002,0,0,0,0,4,31,19,18,1,-1,-0.885714173316956,0.885714173316956,0,3,2,1,-3,3,1,-1,245,287,-42,42
Devonte Smith,Khama Worthy,Khama Worthy,2019-08-17,0,1,-6,6,2.75,1.777778,-5.080002,5.080002,0,0,5.079987,-5.079987,0,2,15,25,-10,10,0.972222208976746,-0.972222208976746,0,0,0,0,0,0,0,0,0,0,0,0
Luis Pena,Khama Worthy,Khama Worthy,2020-06-27,0,1,-7,7,3,1.777778,10.16,-10.16,0,0,2.539993,-2.539993,253,46,12,25,-13,13,1.22222220897675,-1.22222220897675,2,1,0,0,1,-1,0,0,371,315,56,-56
Ottman Azaitar,Khama Worthy,Ottman Azaitar,2020-09-12,1,0,-3,3,6.5,1.777778,-7.619995,7.619995,0,0,-7.62001,7.62001,6,0,15,25,-10,10,4.72222220897675,-4.72222220897675,1,2,0,0,-1,1,0,0,371,77,294,-294
Jamie Mullarkey,Khama Worthy,Jamie Mullarkey,2021-03-27,1,0,-8,8,2.833333,1.777778,2.540009,-2.540009,0,0,0,0,4,0,23,25,-2,2,1.05555546283722,-1.05555546283722,0,0,0,1,0,0,-1,1,161,196,-35,35
Jai Herbert,Khama Worthy,Jai Herbert,2021-10-23,1,0,-2,2,2.4,1.777778,5.080002,-5.080002,0,0,7.619995,-7.619995,5,0,17,25,-8,8,0.622222304344177,-0.622222304344177,0,0,1,2,0,0,-1,1,119,210,-91,91
Gilbert Burns,Khamzat Chimaev,Khamzat Chimaev,2022-04-09,0,1,8,-8,3.666667,12,-10.16,10.16,-15,15,-10.16,10.16,6,143,28,12,16,-16,-8.33333325386047,8.33333325386047,1,0,2,0,1,-1,2,-2,273,0,273,-273
Alex Morono,Khaos Williams,Khaos Williams,2020-02-08,0,1,4,-4,2.875,4.666667,-2.540009,2.540009,0,0,-12.7,12.7,0,5,31,17,14,-14,-1.79166650772095,1.79166650772095,1,0,0,0,1,-1,0,0,336,0,336,-336
Abdul Razak Alhassan,Khaos Williams,Khaos Williams,2020-11-14,0,1,9,-9,2.4,4.666667,-5.080002,5.080002,15,-15,-10.16,10.16,0,0,17,17,0,0,-2.26666641235352,2.26666641235352,1,1,0,0,0,0,0,0,1456,280,1176,-1176
Michel Pereira,Khaos Williams,Michel Pereira,2020-12-19,1,0,1,-1,2.545455,4.666667,2.539993,-2.539993,15,-15,-10.16,10.16,81,36,39,17,22,-22,-2.12121200561523,2.12121200561523,0,2,0,0,-2,2,0,0,308,35,273,-273
Matthew Semelsberger,Khaos Williams,Khaos Williams,2021-06-19,0,1,1,-1,1.833333,4.666667,2.539993,-2.539993,0,0,-5.080002,5.080002,2,113,17,17,0,0,-2.83333313465118,2.83333313465118,1,0,0,0,1,-1,0,0,98,182,-84,84
Miguel Baeza,Khaos Williams,Khaos Williams,2021-11-13,0,1,2,-2,3.333333,4.666667,5.080002,-5.080002,0,0,-7.619995,7.619995,0,48,13,17,-4,4,-1.33333325386047,1.33333325386047,0,1,0,0,-1,1,0,0,161,147,14,-14
Randy Brown,Khaos Williams,Randy Brown,2022-05-07,1,0,3,-3,3.4,4.666667,7.619995,-7.619995,0,0,2.539993,-2.539993,11,249,22,17,5,-5,-1.26666641235352,1.26666641235352,2,2,2,0,0,0,2,-2,210,175,35,-35
Rolando Bedoya,Khaos Williams,Khaos Williams,2023-05-06,0,1,-3,3,4.666667,4.666667,-2.540009,2.540009,0,0,-7.619995,7.619995,7,73,17,17,0,0,0,0,0,0,0,0,0,0,0,0,0,364,-364,364
Luiz Dutra,Kiichi Kunimoto,Kiichi Kunimoto,2014-01-04,0,1,-1,1,2.166667,2.571429,2.539993,-2.539993,0,0,2.660004,-2.660004,0,57,19,25,-6,6,-0.404761791229248,0.404761791229248,0,0,0,0,0,0,0,0,0,0,0,0
Royce Gracie,Kimo Leopoldo,Royce Gracie,1994-09-09,1,0,1,-1,7.5,1.428571,-5.080002,5.080002,-60,60,1,-1,0,0,17,17,0,0,6.07142853736877,-6.07142853736877,3,0,0,0,3,-3,0,0,182,0,182,-182
Tsuyoshi Kohsaka,Kimo Leopoldo,Tsuyoshi Kohsaka,1998-03-13,1,0,-2,2,1.421053,1.428571,-10.16,10.16,-10,10,-10,10,0,0,46,17,29,-29,-7.51888751983643e-03,7.51888751983643e-03,0,0,0,0,0,0,0,0,0,1281,-1281,1281
David Abbott,Kimo Leopoldo,Kimo Leopoldo,2003-06-06,0,1,,,0.6666667,1.428571,-7.619995,7.619995,30,-30,-10.5,10.5,1,112,25,17,8,-8,-0.761904776096344,0.761904776096344,0,0,2,0,0,0,2,-2,98,1911,-1813,1813
Donald Cerrone,KJ Noons,Donald Cerrone,2013-05-25,1,0,0,0,2.117647,1.444444,7.619995,-7.619995,0,0,7.619995,-7.619995,348,0,53,22,31,-31,0.673202753067017,-0.673202753067017,0,0,1,0,0,0,1,-1,119,0,119,-119
Joshua Burkman,KJ Noons,Joshua Burkman,2016-02-06,1,0,2,-2,1.75,1.444444,0,0,15,-15,5.080002,-5.080002,183,0,44,22,22,-22,0.305555582046509,-0.305555582046509,0,0,1,0,0,0,1,-1,167,987,-820,820
Farid Basharat,Kleydson Rodrigues,Farid Basharat,2023-09-02,1,0,-1,1,11,2.666667,7.619995,-7.619995,0,0,10.16,-10.16,195,30,11,11,0,0,8.33333325386047,-8.33333325386047,1,0,0,0,1,-1,0,0,182,0,182,-182
Mark Hall,Koji Kitao,Mark Hall,1996-05-17,1,0,,,0.8333333,0.5,-17.78,17.78,-160,160,-12,12,0,0,11,3,8,-8,0.333333313465118,-0.333333313465118,2,0,0,0,2,-2,0,0,153,0,153,-153
Laverne Clark,Koji Oishi,Laverne Clark,2000-04-14,1,0,4,-4,1.285714,2.5,7.619995,-7.619995,0,0,8,-8,315,305,48,35,13,-13,-1.21428573131561,1.21428573131561,2,0,0,0,2,-2,0,0,343,0,343,-343
Nick Diaz,Koji Oishi,Nick Diaz,2005-06-04,1,0,-7,7,2.6,2.5,12.7,-12.7,0,0,20.03999,-20.03999,3,0,36,35,1,-1,9.99999046325684e-02,-9.99999046325684e-02,1,0,0,0,1,-1,0,0,119,1877,-1758,1758
Carlos Eduardo Rocha,Kris McCray,Carlos Eduardo Rocha,2010-11-13,1,0,0,0,2.25,1.6,-5.080002,5.080002,0,0,-7.619995,7.619995,24,89,13,13,0,0,0.649999976158142,-0.649999976158142,0,0,0,0,0,0,0,0,0,0,0,0
John Hathaway,Kris McCray,John Hathaway,2011-03-26,1,0,-6,6,8.5,1.6,2.539993,-2.539993,0,0,-2.539993,2.539993,257,456,19,13,6,-6,6.89999997615814,-6.89999997615814,0,0,0,0,0,0,0,0,161,133,28,-28
Guido Cannetti,Kris Moutinho,Guido Cannetti,2022-03-12,1,0,13,-13,1.25,1.5,-2.539993,2.539993,0,0,0,0,1,0,18,15,3,-3,-0.25,0.25,0,0,1,0,0,0,1,-1,196,0,196,-196
Rob MacDonald,Kristian Rothaermel,Rob MacDonald,2006-06-28,1,0,-7,7,1.25,1.333333,7.619995,-7.619995,0,0,13.12,-13.12,168,0,9,7,2,-2,-8.33333730697632e-02,8.33333730697632e-02,0,0,0,0,0,0,0,0,0,0,0,0
Alex Caceres,Kron Gracie,Kron Gracie,2019-02-17,0,1,0,0,1.5,2.5,2.540009,-2.540009,0,0,7.619995,-7.619995,0,74,35,7,28,-28,-1,1,0,0,1,0,0,0,1,-1,449,0,449,-449
Magnus Cedenblad,Krzysztof Jotko,Magnus Cedenblad,2014-05-31,1,0,8,-8,2.8,4,10.16,-10.16,0,0,5.080002,-5.080002,387,116,19,30,-11,11,-1.20000004768372,1.20000004768372,1,0,0,0,1,-1,0,0,273,0,273,-273
Scott Askham,Krzysztof Jotko,Krzysztof Jotko,2015-10-24,0,1,1,-1,3.5,4,5.080002,-5.080002,0,0,-5.080002,5.080002,142,245,18,30,-12,12,-0.5,0.5,1,0,0,0,1,-1,0,0,126,511,-385,385
David Branch,Krzysztof Jotko,David Branch,2017-05-13,1,0,8,-8,3.666667,4,0,0,0,0,2.539993,-2.539993,312,57,28,30,-2,2,-0.333333253860474,0.333333253860474,0,1,1,0,-1,1,1,-1,2263,567,1696,-1696
Uriah Hall,Krzysztof Jotko,Uriah Hall,2017-09-16,1,0,5,-5,1.636364,4,-2.539993,2.539993,0,0,5.080002,-5.080002,6,138,29,30,-1,1,-2.36363637447357,2.36363637447357,0,0,1,0,0,0,1,-1,301,126,175,-175
Alen Amedovski,Krzysztof Jotko,Krzysztof Jotko,2019-04-20,0,1,2,-2,2,4,-7.619995,7.619995,0,0,-7.619995,7.619995,13,576,12,30,-18,18,-2,2,0,0,0,1,0,0,-1,1,0,581,-581,581
Marc-Andre Barriault,Krzysztof Jotko,Krzysztof Jotko,2019-07-27,0,1,0,0,2.666667,4,0,0,0,0,-7.619995,7.619995,136,289,22,30,-8,8,-1.33333325386047,1.33333325386047,0,1,0,1,-1,1,-1,1,84,98,-14,14
Eryk Anders,Krzysztof Jotko,Krzysztof Jotko,2020-05-16,0,1,3,-3,1.875,4,0,0,0,0,-5.080002,5.080002,351,46,23,30,-7,7,-2.125,2.125,2,2,1,1,0,0,0,0,217,294,-77,77
Misha Cirkunov,Krzysztof Jotko,Krzysztof Jotko,2021-10-02,0,1,2,-2,1.666667,4,5.080002,-5.080002,20,-20,0,0,246,44,24,30,-6,6,-2.33333337306976,2.33333337306976,0,3,4,1,-3,3,3,-3,203,504,-301,301
Brendan Allen,Krzysztof Jotko,Brendan Allen,2022-10-01,1,0,-7,7,4.4,4,2.540009,-2.540009,0,0,-5.080002,5.080002,144,93,27,30,-3,3,0.400000095367432,-0.400000095367432,2,4,2,1,-2,2,1,-1,112,364,-252,252
Shane Primm,Krzysztof Soszynski,Krzysztof Soszynski,2008-12-13,0,1,-7,7,1,2.166667,5.080002,-5.080002,0,0,-2.580002,2.580002,77,283,10,38,-28,28,-1.16666674613953,1.16666674613953,0,0,0,0,0,0,0,0,0,0,0,0
Andre Gusmao,Krzysztof Soszynski,Krzysztof Soszynski,2009-05-23,0,1,1,-1,2,2.166667,-2.539993,2.539993,0,0,-9.580002,9.580002,3,16,9,38,-29,29,-0.166666746139526,0.166666746139526,0,1,0,0,-1,1,0,0,287,161,126,-126
Stephan Bonnar,Krzysztof Soszynski,Krzysztof Soszynski,2010-02-20,0,1,0,0,1.666667,2.166667,7.619995,-7.619995,0,0,5.080002,-5.080002,165,76,24,38,-14,14,-0.50000011920929,0.50000011920929,0,2,0,0,-2,2,0,0,224,273,-49,49
Stephan Bonnar,Krzysztof Soszynski,Stephan Bonnar,2010-07-03,1,0,1,-1,1.666667,2.166667,7.619995,-7.619995,0,0,5.080002,-5.080002,197,70,24,38,-14,14,-0.50000011920929,0.50000011920929,0,3,1,0,-3,3,1,-1,133,133,0,0
Goran Reljic,Krzysztof Soszynski,Krzysztof Soszynski,2010-11-13,0,1,-7,7,1.875,2.166667,5.080002,-5.080002,0,0,10.16,-10.16,338,243,23,38,-15,15,-0.291666746139526,0.291666746139526,0,0,0,1,0,0,-1,1,0,133,-133,133
Mike Massenzio,Krzysztof Soszynski,Krzysztof Soszynski,2011-06-11,0,1,-5,5,1.444444,2.166667,2.540009,-2.540009,-20,20,-10.16,10.16,223,328,22,38,-16,16,-0.722222328186035,0.722222328186035,0,1,0,1,-1,1,-1,1,314,210,104,-104
Igor Pokrajac,Krzysztof Soszynski,Igor Pokrajac,2011-12-10,1,0,-2,2,2.153846,2.166667,-2.539993,2.539993,0,0,-7.619995,7.619995,5,0,41,38,3,-3,-1.28204822540283e-02,1.28204822540283e-02,0,2,1,1,-2,2,0,0,658,182,476,-476
Jon Fitch,Kuniyoshi Hironaka,Jon Fitch,2006-10-14,1,0,-2,2,4.285714,2.555556,5.080002,-5.080002,2,-2,10.16,-10.16,720,50,37,32,5,-5,1.73015856742859,-1.73015856742859,1,0,0,0,1,-1,0,0,376,0,376,-376
Thiago Alves,Kuniyoshi Hironaka,Thiago Alves,2007-09-19,1,0,-8,8,1.533333,2.555556,-2.540009,2.540009,2,-2,0,0,54,95,38,32,6,-6,-1.02222228050232,1.02222228050232,1,0,1,0,1,-1,1,-1,263,340,-77,77
Jonathan Goulet,Kuniyoshi Hironaka,Jonathan Goulet,2008-04-19,1,0,-3,3,1.916667,2.555556,5.080002,-5.080002,2,-2,7.619995,-7.619995,20,77,35,32,3,-3,-0.638888955116272,0.638888955116272,0,0,2,1,0,0,1,-1,213,213,0,0
Raoni Barcelos,Kurt Holobaugh,Raoni Barcelos,2018-07-14,1,0,0,0,3.4,3,-10.16,10.16,-20,20,-7.62001,7.62001,155,38,22,28,-6,6,0.400000095367432,-0.400000095367432,0,0,0,0,0,0,0,0,0,0,0,0
Shane Burgos,Kurt Holobaugh,Shane Burgos,2018-11-03,1,0,-5,5,5,3,0,0,-10,10,12.7,-12.7,0,13,18,28,-10,10,2,-2,0,0,1,1,0,0,0,0,287,112,175,-175
Drew Fickett,Kurt Pellegrino,Drew Fickett,2006-07-08,1,0,-1,1,2,2.285714,5.080002,-5.080002,0,0,0,0,36,435,63,23,40,-40,-0.285714387893677,0.285714387893677,2,0,0,0,2,-2,0,0,278,0,278,-278
Junior Assuncao,Kurt Pellegrino,Kurt Pellegrino,2006-10-14,0,1,-2,2,2.666667,2.285714,2.539993,-2.539993,-10,10,5.080002,-5.080002,0,114,22,23,-1,1,0.38095235824585,-0.38095235824585,0,0,0,0,0,0,0,0,0,98,-98,98
Nate Mohr,Kurt Pellegrino,Kurt Pellegrino,2007-04-05,0,1,-3,3,1.285714,2.285714,2.539993,-2.539993,0,0,5.080002,-5.080002,0,113,16,23,-7,7,-1.00000011920929,1.00000011920929,0,1,0,0,-1,1,0,0,0,173,-173,173
Alberto Crane,Kurt Pellegrino,Kurt Pellegrino,2008-01-23,0,1,3,-3,3,2.285714,-7.619995,7.619995,0,0,-9.800003,9.800003,45,122,20,23,-3,3,0.714285612106323,-0.714285612106323,0,2,1,0,-2,2,1,-1,151,293,-142,142
Nate Diaz,Kurt Pellegrino,Nate Diaz,2008-04-02,1,0,-6,6,1.692308,2.285714,10.16,-10.16,15,-15,15.23999,-15.23999,82,341,35,23,12,-12,-0.593406677246094,0.593406677246094,2,3,0,0,-1,1,0,0,70,70,0,0
Rob Emerson,Kurt Pellegrino,Kurt Pellegrino,2009-02-07,0,1,-2,2,1.5,2.285714,2.539993,-2.539993,0,0,0,0,60,89,30,23,7,-7,-0.785714387893677,0.785714387893677,2,0,0,0,2,-2,0,0,182,311,-129,129
Josh Neer,Kurt Pellegrino,Kurt Pellegrino,2009-08-08,0,1,-4,4,2.25,2.285714,7.619995,-7.619995,15,-15,5.080002,-5.080002,33,738,52,23,29,-29,-3.57143878936768e-02,3.57143878936768e-02,2,1,0,0,1,-1,0,0,493,182,311,-311
Fabricio Camoes,Kurt Pellegrino,Kurt Pellegrino,2010-03-27,0,1,1,-1,1.555556,2.285714,5.080002,-5.080002,0,0,2.539993,-2.539993,100,407,23,23,0,0,-0.730158805847168,0.730158805847168,0,2,0,0,-2,2,0,0,0,231,-231,231
Russell Doane,Kwan Ho Kwak,Russell Doane,2017-06-17,1,0,3,-3,1.875,4.5,5.079987,-5.079987,0,0,9.800003,-9.800003,2,12,23,11,12,-12,-2.625,2.625,0,0,0,0,0,0,0,0,345,0,345,-345
Enrique Barzola,Kyle Bochniak,Kyle Bochniak,2016-08-27,0,1,-2,2,3.4,1.6,0,0,0,0,0,0,18,27,22,13,9,-9,1.80000007152557,-1.80000007152557,1,0,0,0,1,-1,0,0,280,0,280,-280
Brendan Allen,Kyle Daukaus,Brendan Allen,2020-06-27,1,0,-3,3,4.4,2.75,-2.539993,2.539993,0,0,-2.539993,2.539993,337,464,27,15,12,-12,1.65000009536743,-1.65000009536743,2,0,0,0,2,-2,0,0,119,0,119,-119
Eryk Anders,Kyle Daukaus,Eryk Anders,2022-12-03,1,0,6,-6,1.875,2.75,-5.080002,5.080002,0,0,-2.539993,2.539993,146,44,23,15,8,-8,-0.875,0.875,0,0,1,0,0,0,1,-1,196,889,-693,693
Razak Al-Hassan,Kyle Kingsbury,Kyle Kingsbury,2009-10-24,0,1,0,0,2.6,1.833333,-5.079987,5.079987,0,0,-10.2,10.2,228,329,18,17,1,-1,0.766666531562805,-0.766666531562805,0,0,0,0,0,0,0,0,318,0,318,-318
Jared Hamman,Kyle Kingsbury,Kyle Kingsbury,2010-09-15,0,1,0,0,2.333333,1.833333,-2.539993,2.539993,-20,20,-10.16,10.16,15,284,20,17,3,-3,0.49999988079071,-0.49999988079071,1,1,0,0,0,0,0,0,172,326,-154,154
Stephan Bonnar,Kyle Kingsbury,Stephan Bonnar,2011-11-19,1,0,5,-5,1.666667,1.833333,0,0,0,0,0,0,635,58,24,17,7,-7,-0.166666746139526,0.166666746139526,2,2,1,0,0,0,1,-1,350,430,-80,80
Patrick Cummins,Kyle Kingsbury,Patrick Cummins,2014-07-26,1,0,1,-1,1.428571,1.833333,-5.079987,5.079987,0,0,-7.62001,7.62001,574,16,17,17,0,0,-0.404761910438538,0.404761910438538,1,0,0,0,1,-1,0,0,49,980,-931,931
Diego Ferreira,Kyle Nelson,Diego Ferreira,2018-12-08,1,0,6,-6,3.6,3,-5.080002,5.080002,10,-10,7.62001,-7.62001,208,14,23,20,3,-3,0.599999904632568,-0.599999904632568,1,0,1,0,1,-1,1,-1,293,0,293,-293
Jai Herbert,Kyle Nelson,Jai Herbert,2022-07-23,1,0,3,-3,2.4,3,5.080002,-5.080002,10,-10,15.24001,-15.24001,357,186,17,20,-3,3,-0.599999904632568,0.599999904632568,0,0,2,1,0,0,1,-1,126,1323,-1197,1197
Blake Bilder,Kyle Nelson,Kyle Nelson,2023-06-10,0,1,0,0,8,3,-7.619995,7.619995,0,0,-7.619995,7.619995,165,141,9,20,-11,11,5,-5,1,0,0,1,1,-1,-1,1,119,322,-203,203
Josh Bryant,Kyle Noke,Kyle Noke,2010-06-19,0,1,0,0,3.75,2.2,-7.619995,7.619995,15,-15,-13.03999,13.03999,0,5,19,32,-13,13,1.54999995231628,-1.54999995231628,0,0,0,0,0,0,0,0,0,0,0,0
Rob Kimmons,Kyle Noke,Kyle Noke,2010-11-13,0,1,-1,1,2.777778,2.2,-7.619995,7.619995,15,-15,-7.619995,7.619995,80,242,34,32,2,-2,0.577777624130249,-0.577777624130249,1,1,1,0,0,0,1,-1,104,147,-43,43
Chris Camozzi,Kyle Noke,Kyle Noke,2011-02-26,0,1,-6,6,1.846154,2.2,2.540009,-2.540009,15,-15,-2.539993,2.539993,41,0,37,32,5,-5,-0.353846192359924,0.353846192359924,2,2,0,0,0,0,0,0,126,105,21,-21
Ed Herman,Kyle Noke,Ed Herman,2011-08-14,1,0,-1,1,1.6875,2.2,0,0,35,-35,2.540009,-2.540009,12,205,43,32,11,-11,-0.512500047683716,0.512500047683716,0,3,1,0,-3,3,1,-1,715,169,546,-546
Andrew Craig,Kyle Noke,Andrew Craig,2012-03-02,1,0,-5,5,2.25,2.2,0,0,0,0,0,0,236,209,13,32,-19,19,4.99999523162842e-02,-4.99999523162842e-02,0,0,0,0,0,0,0,0,0,201,-201,201
Charlie Brenneman,Kyle Noke,Kyle Noke,2012-09-22,0,1,-1,1,2.375,2.2,-7.619995,7.619995,-15,15,-15.23999,15.23999,0,2,27,32,-5,5,0.174999952316284,-0.174999952316284,0,0,2,0,0,0,2,-2,106,204,-98,98
Patrick Cote,Kyle Noke,Patrick Cote,2014-04-16,1,0,0,0,2.090909,2.2,-5.080002,5.080002,0,0,-2.539993,2.539993,434,26,34,32,2,-2,-0.10909104347229,0.10909104347229,2,1,1,0,1,-1,1,-1,396,571,-175,175
Alex Morono,Kyle Noke,Alex Morono,2016-01-02,1,0,-10,10,2.875,2.2,-5.080002,5.080002,0,0,-10.15999,10.15999,66,190,31,32,-1,1,0.674999952316284,-0.674999952316284,0,0,0,0,0,0,0,0,0,626,-626,626
Keita Nakamura,Kyle Noke,Keita Nakamura,2016-07-13,1,0,-4,4,3.4,2.2,-5.080002,5.080002,0,0,-7.619995,7.619995,32,33,44,32,12,-12,1.20000004768372,-1.20000004768372,0,0,0,0,0,0,0,0,0,193,-193,193
Omari Akhmedov,Kyle Noke,Omari Akhmedov,2016-11-26,1,0,-7,7,3.5,2.2,-2.539993,2.539993,15,-15,-7.619995,7.619995,387,0,27,32,-5,5,1.29999995231628,-1.29999995231628,0,0,2,0,0,0,2,-2,224,136,88,-88
Austin Hubbard,Kyle Prepolec,Austin Hubbard,2019-09-14,1,0,-3,3,2.285714,1.714286,0,0,-15,15,2.539993,-2.539993,342,48,23,19,4,-4,0.571428656578064,-0.571428656578064,0,0,0,0,0,0,0,0,119,0,119,-119
Chance Rencountre,Kyle Stewart,Chance Rencountre,2019-01-19,1,0,3,-3,3.5,3.666667,5.080002,-5.080002,0,0,-2.539993,2.539993,119,0,18,14,4,-4,-0.166666746139526,0.166666746139526,0,0,0,0,0,0,0,0,0,0,0,0
Erik Koch,Kyle Stewart,Erik Koch,2019-07-27,1,0,0,0,2.666667,3.666667,-5.080002,5.080002,0,0,-12.7,12.7,540,135,22,14,8,-8,-1,1,1,0,1,0,1,-1,1,-1,1981,189,1792,-1792
Sako Chivitchian,Kyle Watson,Kyle Watson,2010-12-04,0,1,-5,5,8,1.625,-2.540009,2.540009,0,0,-5,5,178,147,9,21,-12,12,6.375,-6.375,0,0,0,0,0,0,0,0,0,0,0,0
John Makdessi,Kyle Watson,John Makdessi,2011-04-30,1,0,-6,6,2,1.625,-10.16,10.16,0,0,-12.28,12.28,1,17,27,21,6,-6,0.375,-0.375,0,1,0,0,-1,1,0,0,0,147,-147,147
Cameron Else,Kyler Phillips,Kyler Phillips,2020-10-03,0,1,8,-8,1.666667,5.5,2.539993,-2.539993,0,0,-2.540009,2.540009,3,145,16,13,3,-3,-3.83333337306976,3.83333337306976,0,0,0,0,0,0,0,0,0,0,0,0
Raulian Paiva,Kyler Phillips,Raulian Paiva,2021-07-24,1,0,-1,1,4.2,5.5,0,0,0,0,-7.62001,7.62001,212,182,26,13,13,-13,-1.30000019073486,1.30000019073486,1,1,0,0,0,0,0,0,378,294,84,-84
Raoni Barcelos,Kyler Phillips,Kyler Phillips,2023-08-05,0,1,8,-8,3.4,5.5,-2.540009,2.540009,0,0,-12.70001,12.70001,102,47,22,13,9,-9,-2.09999990463257,2.09999990463257,0,0,1,0,0,0,1,-1,203,742,-539,539
Jon Delos Reyes,Kyoji Horiguchi,Kyoji Horiguchi,2014-09-20,0,1,4,-4,1.6,9.5,2.539993,-2.539993,0,0,2.539993,-2.539993,0,137,13,21,-8,8,-7.89999997615814,7.89999997615814,0,0,0,0,0,0,0,0,259,0,259,-259
Louis Gaudinot,Kyoji Horiguchi,Kyoji Horiguchi,2015-01-03,0,1,6,-6,2,9.5,-5.080002,5.080002,0,0,-7.619995,7.619995,0,118,12,21,-9,9,-7.5,7.5,1,1,0,0,0,0,0,0,973,105,868,-868
Chico Camus,Kyoji Horiguchi,Kyoji Horiguchi,2015-09-26,0,1,6,-6,2.428571,9.5,2.539993,-2.539993,0,0,0,0,24,20,24,21,3,-3,-7.07142853736877,7.07142853736877,0,2,0,0,-2,2,0,0,105,266,-161,161
Ali Bagautinov,Kyoji Horiguchi,Kyoji Horiguchi,2016-11-19,0,1,5,-5,2.5,9.5,-2.540009,2.540009,0,0,-2.539993,2.539993,169,272,21,21,0,0,-7,7,1,3,0,0,-2,2,0,0,154,420,-266,266
Chico Camus,Kyung Ho Kang,Chico Camus,2013-08-31,1,0,3,-3,2.428571,2.111111,-7.619995,7.619995,-10,10,-17.78,17.78,148,558,24,28,-4,4,0.317460298538208,-0.317460298538208,0,0,0,0,0,0,0,0,210,0,210,-210
Guido Cannetti,Kyung Ho Kang,Kyung Ho Kang,2018-01-14,0,1,8,-8,1.25,2.111111,-7.619995,7.619995,0,0,-12.7,12.7,87,38,18,28,-10,10,-0.861111164093018,0.861111164093018,1,0,0,0,1,-1,0,0,897,1597,-700,700
Brandon Davis,Kyung Ho Kang,Kyung Ho Kang,2019-08-17,0,1,-2,2,1.4,2.111111,2.540009,-2.540009,0,0,-2.539993,2.539993,24,381,24,28,-4,4,-0.711111187934875,0.711111187934875,0,1,0,0,-1,1,0,0,343,580,-237,237
Batgerel Danaa,Kyung Ho Kang,Kyung Ho Kang,2022-06-11,0,1,-2,2,2.4,2.111111,-5.080002,5.080002,0,0,-7.619995,7.619995,3,0,17,28,-11,11,0.288888931274414,-0.288888931274414,0,2,1,0,-2,2,1,-1,77,1029,-952,952
Seth Baczynski,Lance Benoist,Seth Baczynski,2012-06-08,1,0,7,-7,1.428571,3.5,10.16,-10.16,0,0,7.619995,-7.619995,227,390,34,9,25,-25,-2.07142853736877,2.07142853736877,2,0,0,0,2,-2,0,0,202,0,202,-202
Jermaine Andre,Lance Gibson,Lance Gibson,2000-03-10,0,1,,,3.5,0.8,-5.080002,5.080002,15,-15,-4.419998,4.419998,16,657,18,9,9,-9,2.69999998807907,-2.69999998807907,0,0,0,0,0,0,0,0,0,0,0,0
Tony Ferguson,Lando Vannata,Tony Ferguson,2016-07-13,1,0,8,-8,2.888889,1.714286,5.080002,-5.080002,0,0,12.7,-12.7,0,70,35,19,16,-16,1.17460310459137,-1.17460310459137,5,0,0,0,5,-5,0,0,364,0,364,-364
John Makdessi,Lando Vannata,Lando Vannata,2016-12-10,0,1,7,-7,2,1.714286,-2.539993,2.539993,0,0,-7.619995,7.619995,0,1,27,19,8,-8,0.285714268684387,-0.285714268684387,0,0,0,0,0,0,0,0,364,150,214,-214
David Teymur,Lando Vannata,David Teymur,2017-03-04,1,0,3,-3,4,1.714286,0,0,0,0,5.080002,-5.080002,50,7,10,19,-9,9,2.28571426868439,-2.28571426868439,0,1,0,0,-1,1,0,0,0,84,-84,84
Drakkar Klose,Lando Vannata,Drakkar Klose,2018-07-07,1,0,4,-4,6.5,1.714286,0,0,0,0,-2.539993,2.539993,198,62,15,19,-4,4,4.78571426868439,-4.78571426868439,0,0,0,0,0,0,0,0,217,490,-273,273
Marcos Mariano,Lando Vannata,Lando Vannata,2019-02-09,0,1,6,-6,1,1.714286,10.16,-10.16,0,0,12.7,-12.7,0,215,12,19,-7,7,-0.714285731315613,0.714285731315613,0,0,0,0,0,0,0,0,0,217,-217,217
Marc Diakiese,Lando Vannata,Marc Diakiese,2019-09-28,1,0,-1,1,2.285714,1.714286,2.540009,-2.540009,0,0,5.080002,-5.080002,308,6,23,19,4,-4,0.571428656578064,-0.571428656578064,1,1,0,0,0,0,0,0,196,231,-35,35
Yancy Medeiros,Lando Vannata,Lando Vannata,2020-02-15,0,1,5,-5,1.875,1.714286,2.540009,-2.540009,0,0,10.16,-10.16,0,4,23,19,4,-4,0.160714268684387,-0.160714268684387,3,0,1,0,3,-3,1,-1,805,140,665,-665
Bobby Green,Lando Vannata,Bobby Green,2020-08-01,1,0,5,-5,2.142857,1.714286,2.540009,-2.540009,0,0,0,0,185,27,44,19,25,-25,0.428571343421936,-0.428571343421936,1,1,1,0,0,0,1,-1,42,168,-126,126
Mike Grundy,Lando Vannata,Lando Vannata,2021-05-15,0,1,5,-5,3,1.714286,-5.080002,5.080002,-10,10,2.540009,-2.540009,157,23,16,19,-3,3,1.28571426868439,-1.28571426868439,1,0,0,0,1,-1,0,0,791,287,504,-504
Charles Jourdain,Lando Vannata,Charles Jourdain,2022-04-23,1,0,-4,4,2.5,1.714286,0,0,-10,10,-5.080002,5.080002,19,57,21,19,2,-2,0.785714268684387,-0.785714268684387,1,1,0,0,0,0,0,0,406,343,63,-63
Nasrat Haqparast,Landon Quinones,Nasrat Haqparast,2023-09-09,1,0,1,-1,3,3.5,2.540009,-2.540009,0,0,5.080002,-5.080002,21,41,20,9,11,-11,-0.5,0.5,1,0,0,0,1,-1,0,0,371,0,371,-371
Molly McCann,Lara Procopio,Lara Procopio,2021-02-06,0,1,5,-5,2.166667,3.5,0,0,0,0,-12.7,12.7,50,703,19,9,10,-10,-1.33333325386047,1.33333325386047,0,0,0,0,0,0,0,0,206,0,206,-206
"Casey O'Neill",Lara Procopio,"Casey O'Neill",2021-06-19,1,0,-2,2,9,3.5,5.080002,-5.080002,0,0,5.080002,-5.080002,342,170,10,9,1,-1,5.5,-5.5,0,1,0,0,-1,1,0,0,0,133,-133,133
Jessica Andrade,Larissa Pacheco,Jessica Andrade,2014-09-13,1,0,2,-2,2,5,-15.23999,15.23999,-20,20,-2.520004,2.520004,261,0,36,12,24,-24,-3,3,2,0,1,0,2,-2,1,-1,182,0,182,-182
Germaine de Randamie,Larissa Pacheco,Germaine de Randamie,2015-03-14,1,0,10,-10,2.5,5,5.080002,-5.080002,0,0,20.34,-20.34,5,19,14,12,2,-2,-2.5,2.5,0,0,1,0,0,0,1,-1,493,182,311,-311
Hector Aldana,Laureano Staropoli,Laureano Staropoli,2018-11-17,0,1,5,-5,1.333333,1.8,-5.080002,5.080002,-15,15,2.540009,-2.540009,43,0,7,14,-7,7,-0.466666579246521,0.466666579246521,0,0,1,0,0,0,1,-1,147,0,147,-147
Thiago Alves,Laureano Staropoli,Laureano Staropoli,2019-05-11,0,1,9,-9,1.533333,1.8,-10.16,10.16,-15,15,-2.539993,2.539993,27,32,38,14,24,-24,-0.266666650772095,0.266666650772095,1,1,3,0,0,0,3,-3,98,175,-77,77
Muslim Salikhov,Laureano Staropoli,Muslim Salikhov,2019-10-26,1,0,9,-9,4.75,1.8,-5.080002,5.080002,-15,15,-2.539993,2.539993,30,0,23,14,9,-9,2.95000004768372,-2.95000004768372,1,2,0,0,-1,1,0,0,49,168,-119,119
Tim Means,Laureano Staropoli,Tim Means,2020-08-08,1,0,9,-9,2.2,1.8,2.540009,-2.540009,-15,15,10.16,-10.16,367,4,48,14,34,-34,0.400000095367432,-0.400000095367432,0,0,1,0,0,0,1,-1,175,287,-112,112
Roman Dolidze,Laureano Staropoli,Roman Dolidze,2021-06-05,1,0,4,-4,6,1.8,2.540009,-2.540009,0,0,12.7,-12.7,577,50,14,14,0,0,4.20000004768372,-4.20000004768372,0,0,0,0,0,0,0,0,77,301,-224,224
Jamie Pickett,Laureano Staropoli,Jamie Pickett,2021-10-23,1,0,5,-5,1.3,1.8,2.540009,-2.540009,0,0,22.86,-22.86,157,326,23,14,9,-9,-0.5,0.5,0,0,1,0,0,0,1,-1,161,140,21,-21
Shana Dobson,Lauren Mueller,Lauren Mueller,2018-04-14,0,1,3,-3,0.8,1.666667,2.539993,-2.539993,0,0,5.080002,-5.080002,44,168,9,8,1,-1,-0.866666615009308,0.866666615009308,0,0,0,0,0,0,0,0,0,0,0,0
Poliana Botelho,Lauren Mueller,Poliana Botelho,2019-04-13,1,0,3,-3,1.6,1.666667,7.619995,-7.619995,0,0,0,0,413,176,13,8,5,-5,-6.66666030883789e-02,6.66666030883789e-02,0,1,0,0,-1,1,0,0,147,364,-217,217
JJ Aldrich,Lauren Mueller,JJ Aldrich,2019-10-12,1,0,0,0,2,1.666667,0,0,0,0,0,0,112,21,18,8,10,-10,0.333333373069763,-0.333333373069763,0,0,1,0,0,0,1,-1,203,182,21,-21
Sara McMann,Lauren Murphy,Sara McMann,2014-08-16,1,0,2,-2,2.166667,2.666667,2.539993,-2.539993,10,-10,-2.539993,2.539993,638,16,19,22,-3,3,-0.5,0.5,0,0,1,0,0,0,1,-1,175,0,175,-175
Liz Carmouche,Lauren Murphy,Liz Carmouche,2015-04-04,1,0,0,0,1.857143,2.666667,2.539993,-2.539993,0,0,-2.539993,2.539993,95,448,20,22,-2,2,-0.809523940086365,0.809523940086365,0,0,0,0,0,0,0,0,350,231,119,-119
Kelly Faszholz,Lauren Murphy,Lauren Murphy,2016-02-21,0,1,-2,2,2,2.666667,7.619995,-7.619995,10,-10,4.820007,-4.820007,61,376,6,22,-16,16,-0.666666746139526,0.666666746139526,0,0,0,0,0,0,0,0,0,323,-323,323
Katlyn Chookagian,Lauren Murphy,Katlyn Chookagian,2016-07-13,1,0,-5,5,3.6,2.666667,10.15999,-10.15999,0,0,2.540009,-2.540009,7,342,23,22,1,-1,0.933333158493042,-0.933333158493042,0,1,0,0,-1,1,0,0,0,143,-143,143
Barb Honchak,Lauren Murphy,Lauren Murphy,2017-12-01,0,1,4,-4,2.5,2.666667,-2.540009,2.540009,0,0,-5.079987,5.079987,21,208,14,22,-8,8,-0.166666746139526,0.166666746139526,0,0,0,0,0,0,0,0,0,506,-506,506
Sijara Eubanks,Lauren Murphy,Sijara Eubanks,2018-06-01,1,0,-1,1,1.142857,2.666667,-2.540009,2.540009,0,0,0,0,290,10,15,22,-7,7,-1.52380955219269,1.52380955219269,0,1,0,0,-1,1,0,0,0,182,-182,182
Andrea Lee,Lauren Murphy,Lauren Murphy,2020-02-08,0,1,-6,6,1.625,2.666667,2.539993,-2.539993,0,0,5.080002,-5.080002,37,151,21,22,-1,1,-1.04166674613953,1.04166674613953,0,0,0,0,0,0,0,0,154,617,-463,463
Roxanne Modafferi,Lauren Murphy,Lauren Murphy,2020-06-20,0,1,1,-1,1.190476,2.666667,5.079987,-5.079987,0,0,5.080002,-5.080002,248,53,46,22,24,-24,-1.4761905670166,1.4761905670166,1,1,0,0,0,0,0,0,427,133,294,-294
Jessica Andrade,Lauren Murphy,Jessica Andrade,2023-01-21,1,0,-8,8,2,2.666667,-10.16,10.16,-10,10,-12.7,12.7,71,9,36,22,14,-14,-0.666666746139526,0.666666746139526,2,2,3,0,0,0,3,-3,273,945,-672,672
Joey Beltran,Lavar Johnson,Lavar Johnson,2012-01-28,0,1,-4,4,1.214286,1.8,-7.619995,7.619995,-55,55,-17.78,17.78,4,65,31,28,3,-3,-0.585714221000671,0.585714221000671,0,0,0,0,0,0,0,0,112,0,112,-112
Pat Barry,Lavar Johnson,Lavar Johnson,2012-05-05,0,1,-2,2,1.142857,1.8,-12.7,12.7,-5,5,-20.31999,20.31999,147,42,15,28,-13,13,-0.657142758369446,0.657142758369446,1,1,1,0,0,0,1,-1,106,98,8,-8
Frank Caracci,Laverne Clark,Laverne Clark,1999-01-08,0,1,,,0.6666667,1.285714,,,,,-8,8,0,0,5,48,-43,43,-0.619047582149506,0.619047582149506,0,0,0,0,0,0,0,0,0,0,0,0
Russell Doane,Leandro Issa,Russell Doane,2014-01-04,1,0,-3,3,1.875,2.166667,0,0,0,0,2.540009,-2.540009,254,90,23,19,4,-4,-0.291666746139526,0.291666746139526,0,0,0,0,0,0,0,0,0,0,0,0
Iuri Alcantara,Leandro Issa,Iuri Alcantara,2015-08-01,1,0,3,-3,3.5,2.166667,5.080002,-5.080002,0,0,5.080002,-5.080002,131,326,45,19,26,-26,1.33333325386047,-1.33333325386047,0,0,0,0,0,0,0,0,160,574,-414,414
Ildemar Alcantara,Leandro Silva,Ildemar Alcantara,2013-06-08,1,0,3,-3,1.909091,3.333333,12.70001,-12.70001,30,-30,15.23999,-15.23999,183,78,32,26,6,-6,-1.42424237728119,1.42424237728119,1,0,0,0,1,-1,0,0,140,0,140,-140
Charlie Brenneman,Leandro Silva,Leandro Silva,2014-11-08,0,1,5,-5,2.375,3.333333,2.540009,-2.540009,0,0,-5.080002,5.080002,141,64,27,26,1,-1,-0.958333253860474,0.958333253860474,0,0,4,0,0,0,4,-4,196,518,-322,322
Lewis Gonzalez,Leandro Silva,Leandro Silva,2015-06-27,0,1,-2,2,3.666667,3.333333,2.540009,-2.540009,15,-15,-2.880005,2.880005,280,225,14,26,-12,12,0.333333492279053,-0.333333492279053,0,1,0,0,-1,1,0,0,0,231,-231,231
Efrain Escudero,Leandro Silva,Leandro Silva,2015-11-21,0,1,-1,1,2.333333,3.333333,0,0,0,0,-2.540009,2.540009,304,203,40,26,14,-14,-1,1,0,2,0,0,-2,2,0,0,434,147,287,-287
Jason Saggo,Leandro Silva,Jason Saggo,2016-06-18,1,0,0,0,3,3.333333,5.080002,-5.080002,0,0,-2.540009,2.540009,201,73,16,26,-10,10,-0.333333253860474,0.333333253860474,2,3,0,0,-1,1,0,0,105,210,-105,105
Rustam Khabilov,Leandro Silva,Rustam Khabilov,2016-09-03,1,0,-1,1,6,3.333333,-2.539993,2.539993,0,0,2.539993,-2.539993,232,13,28,26,2,-2,2.66666674613953,-2.66666674613953,2,0,0,0,2,-2,0,0,118,77,41,-41
Tae Hyun Bang,Leo Kuntz,Tae Hyun Bang,2015-11-28,1,0,0,0,1.8,4.5,-2.540009,2.540009,0,0,0.3399963,-0.3399963,25,384,28,22,6,-6,-2.70000004768372,2.70000004768372,0,0,0,0,0,0,0,0,196,0,196,-196
Seth Baczynski,Leon Edwards,Leon Edwards,2015-04-11,0,1,10,-10,1.428571,7,2.539993,-2.539993,0,0,2.539993,-2.539993,0,2,34,24,10,-10,-5.57142853736877,5.57142853736877,0,0,2,0,0,0,2,-2,238,0,238,-238
Bryan Barberena,Leon Edwards,Leon Edwards,2017-09-02,0,1,2,-2,1.636364,7,-5.080002,5.080002,0,0,-5.080002,5.080002,85,488,29,24,5,-5,-5.36363637447357,5.36363637447357,1,1,0,0,0,0,0,0,133,875,-742,742
Donald Cerrone,Leon Edwards,Leon Edwards,2018-06-23,0,1,9,-9,2.117647,7,-2.540009,2.540009,-15,15,-2.540009,2.540009,163,48,53,24,29,-29,-4.88235282897949,4.88235282897949,1,2,4,0,-1,1,4,-4,125,294,-169,169
Rafael Dos Anjos,Leon Edwards,Leon Edwards,2019-07-20,0,1,7,-7,2.133333,7,-15.24001,15.24001,0,0,-10.16,10.16,143,437,47,24,23,-23,-4.86666655540466,4.86666655540466,1,3,1,0,-2,2,1,-1,63,392,-329,329
Nate Diaz,Leon Edwards,Leon Edwards,2021-06-12,0,1,7,-7,1.692308,7,-5.080002,5.080002,0,0,5.079987,-5.079987,113,299,35,24,11,-11,-5.30769228935242,5.30769228935242,0,4,2,0,-4,4,2,-2,588,693,-105,105
Allen Berube,Leonard Garcia,Leonard Garcia,2007-06-23,0,1,5,-5,1.333333,1.384615,-5.080002,5.080002,10,-10,2.279999,-2.279999,160,77,7,31,-24,24,-5.12820482254028e-02,5.12820482254028e-02,0,0,0,0,0,0,0,0,0,0,0,0
Antonio Carlos Junior,Leonardo Guimaraes,Antonio Carlos Junior,2016-09-17,1,0,-8,8,2.2,2.2,5.080002,-5.080002,0,0,14.66,-14.66,613,11,16,16,0,0,0,0,0,0,1,0,0,0,1,-1,182,0,182,-182
Cain Carrizosa,Leonardo Mafra,Leonardo Mafra,2015-03-21,0,1,3,-3,3.333333,3.25,-5.080002,5.080002,0,0,-2.800003,2.800003,56,413,13,17,-4,4,8.33332538604736e-02,-8.33332538604736e-02,0,0,0,0,0,0,0,0,203,0,203,-203
William Macario,Leonardo Santos,Leonardo Santos,2013-06-08,0,1,-12,12,3,2.571429,-2.540009,2.540009,15,-15,0,0,243,82,12,25,-13,13,0.428571462631226,-0.428571462631226,0,0,0,0,0,0,0,0,0,0,0,0
Efrain Escudero,Leonardo Santos,Leonardo Santos,2014-09-13,0,1,-6,6,2.333333,2.571429,-7.62001,7.62001,0,0,-10.16,10.16,50,416,40,25,15,-15,-0.238095283508301,0.238095283508301,0,1,0,0,-1,1,0,0,988,462,526,-526
Anthony Rocco Martin,Leonardo Santos,Leonardo Santos,2015-03-21,0,1,-10,10,2.833333,2.571429,0,0,15,-15,-5.080002,5.080002,108,87,23,25,-2,2,0.261904716491699,-0.261904716491699,0,2,0,0,-2,2,0,0,0,189,-189,189
Kevin Lee,Leonardo Santos,Leonardo Santos,2015-12-12,0,1,-12,12,2.25,2.571429,-7.62001,7.62001,15,-15,5.080002,-5.080002,0,30,26,25,1,-1,-0.321428537368774,0.321428537368774,4,3,0,0,1,-1,0,0,150,266,-116,116
Adriano Martins,Leonardo Santos,Leonardo Santos,2016-10-08,0,1,-3,3,3.111111,2.571429,-5.080002,5.080002,0,0,-7.619995,7.619995,0,0,37,25,12,-12,0.539682626724243,-0.539682626724243,0,4,0,0,-4,4,0,0,0,301,-301,301
Stevie Ray,Leonardo Santos,Leonardo Santos,2019-06-01,0,1,-10,10,2.555556,2.571429,-5.080002,5.080002,0,0,-12.7,12.7,0,1,32,25,7,-7,-1.58729553222656e-02,1.58729553222656e-02,0,5,0,0,-5,5,0,0,0,966,-966,966
Roman Bogatov,Leonardo Santos,Leonardo Santos,2020-07-11,0,1,-11,11,10,2.571429,-10.16,10.16,0,0,-5.080002,5.080002,367,94,11,25,-14,14,7.42857146263123,-7.42857146263123,0,6,0,0,-6,6,0,0,0,406,-406,406
Grant Dawson,Leonardo Santos,Grant Dawson,2021-03-20,1,0,-14,14,20,2.571429,-5.080002,5.080002,0,0,-7.619995,7.619995,498,81,21,25,-4,4,17.4285714626312,-17.4285714626312,4,7,0,0,-3,3,0,0,245,252,-7,7
Clay Guida,Leonardo Santos,Clay Guida,2021-12-04,1,0,-2,2,1.9,2.571429,-12.70001,12.70001,0,0,-12.7,12.7,129,61,58,25,33,-33,-0.671428561210632,0.671428561210632,0,0,2,1,0,0,1,-1,105,259,-154,154
Jared Gordon,Leonardo Santos,Jared Gordon,2022-08-20,1,0,-9,9,3.166667,2.571429,-7.62001,7.62001,0,0,-17.78,17.78,235,54,25,25,0,0,0.595238208770752,-0.595238208770752,1,0,2,1,1,-1,1,-1,322,259,63,-63
Makwan Amirkhani,Lerone Murphy,Lerone Murphy,2021-10-30,0,1,2,-2,1.888889,13,2.540009,-2.540009,0,0,-2.539993,2.539993,245,9,26,13,13,-13,-11.111111164093,11.111111164093,0,0,1,0,0,0,1,-1,147,0,147,-147
Josh Culibao,Lerone Murphy,Lerone Murphy,2023-07-22,0,1,-3,3,5.5,13,2.540009,-2.540009,0,0,0,0,90,458,13,13,0,0,-7.5,7.5,1,1,1,0,0,0,1,-1,791,630,161,-161
Sarah Kaufman,Leslie Smith,Sarah Kaufman,2014-04-16,1,0,-3,3,4.5,1.428571,-10.15999,10.15999,0,0,0,0,159,128,22,17,5,-5,3.07142853736877,-3.07142853736877,0,0,0,0,0,0,0,0,0,0,0,0
Jessamyn Duke,Leslie Smith,Leslie Smith,2014-07-16,0,1,-3,3,0.6,1.428571,5.080002,-5.080002,0,0,17.78,-17.78,0,1,8,17,-9,9,-0.828571438789368,0.828571438789368,1,0,0,0,1,-1,0,0,228,91,137,-137
Jessica Eye,Leslie Smith,Jessica Eye,2014-11-15,1,0,-4,4,1.363636,1.428571,-7.619995,7.619995,-10,10,0,0,0,0,26,17,9,-9,-6.49350881576538e-02,6.49350881576538e-02,0,1,0,0,-1,1,0,0,0,122,-122,122
Rin Nakai,Leslie Smith,Leslie Smith,2016-03-19,0,1,-4,4,9.5,1.428571,-20.31999,20.31999,0,0,-2.639999,2.639999,332,2,21,17,4,-4,8.07142853736877,-8.07142853736877,0,0,0,1,0,0,-1,1,546,490,56,-56
Cristiane Justino,Leslie Smith,Cristiane Justino,2016-05-14,1,0,-3,3,10.5,1.428571,-2.539993,2.539993,10,-10,5.080002,-5.080002,12,0,23,17,6,-6,9.07142853736877,-9.07142853736877,0,1,0,1,-1,1,-1,1,0,56,-56,56
Irene Aldana,Leslie Smith,Leslie Smith,2016-12-17,0,1,-6,6,2,1.428571,0,0,0,0,5.080002,-5.080002,6,17,21,17,4,-4,0.571428537368774,-0.571428537368774,0,0,0,2,0,0,-2,2,0,217,-217,217
Amanda Lemos,Leslie Smith,Leslie Smith,2017-07-16,0,1,-4,4,4.333333,1.428571,-12.7,12.7,-20,20,-2.539993,2.539993,34,88,16,17,-1,1,2.90476202964783,-2.90476202964783,0,1,0,2,-1,1,-2,2,0,211,-211,211
Mark Eddiva,Levan Makashvili,Levan Makashvili,2015-05-16,0,1,3,-3,2,7.5,0,0,0,0,0,0,27,348,9,17,-8,8,-5.5,5.5,0,0,1,0,0,0,1,-1,350,0,350,-350
Hacran Dias,Levan Makashvili,Hacran Dias,2015-06-27,1,0,5,-5,3.833333,7.5,0,0,10,-10,2.539993,-2.539993,202,346,29,17,12,-12,-3.66666674613953,3.66666674613953,1,1,0,0,0,0,0,0,189,42,147,-147
Frank Camacho,Li Jingliang,Li Jingliang,2017-06-17,0,1,-1,1,2.2,2.375,-5.080002,5.080002,-15,15,5.080002,-5.080002,39,73,32,27,5,-5,-0.174999952316284,0.174999952316284,0,0,0,0,0,0,0,0,0,0,0,0
Daichi Abe,Li Jingliang,Li Jingliang,2018-06-23,0,1,-4,4,3,2.375,-2.540009,2.540009,0,0,0,0,0,0,8,27,-19,19,0.625,-0.625,0,1,0,0,-1,1,0,0,133,371,-238,238
Khamzat Chimaev,Li Jingliang,Khamzat Chimaev,2021-10-30,1,0,-6,6,12,2.375,5.080002,-5.080002,15,-15,10.16,-10.16,181,0,12,27,-15,15,9.625,-9.625,3,2,0,0,1,-1,0,0,406,1225,-819,819
Diana Belbita,Liana Jojua,Liana Jojua,2020-07-15,0,1,-1,1,2.142857,1.6,7.619995,-7.619995,-10,10,15.24001,-15.24001,94,52,22,13,9,-9,0.542857050895691,-0.542857050895691,0,0,0,0,0,0,0,0,271,0,271,-271
Cortney Casey,Liana Jojua,Cortney Casey,2021-11-13,1,0,8,-8,1,1.6,7.619995,-7.619995,0,0,12.7,-12.7,0,93,20,13,7,-7,-0.600000023841858,0.600000023841858,0,1,0,0,-1,1,0,0,511,486,25,-25
Ariane Carnelossi,Liang Na,Ariane Carnelossi,2021-04-24,1,0,4,-4,4.666667,2.714286,-7.62001,7.62001,-10,10,-15.23999,15.23999,156,168,17,26,-9,9,1.95238089561462,-1.95238089561462,0,0,1,0,0,0,1,-1,581,0,581,-581
Silvana Gomez Juarez,Liang Na,Silvana Gomez Juarez,2022-06-11,1,0,12,-12,2.2,2.714286,-5.080002,5.080002,-10,10,-5.079987,5.079987,0,9,16,26,-10,10,-0.514285564422607,0.514285564422607,0,0,0,1,0,0,-1,1,0,413,-413,413
JJ Aldrich,Liang Na,JJ Aldrich,2023-08-26,1,0,3,-3,2,2.714286,0,0,0,0,0,0,311,98,18,26,-8,8,-0.714285612106323,0.714285612106323,0,0,1,2,0,0,-1,1,168,441,-273,273
Lauren Murphy,Liliya Shakirova,Lauren Murphy,2020-10-24,1,0,8,-8,2.666667,4,2.540009,-2.540009,0,0,5.079987,-5.079987,70,29,22,10,12,-12,-1.33333325386047,1.33333325386047,1,0,0,0,1,-1,0,0,448,0,448,-448
Cristiane Justino,Lina Lansberg,Cristiane Justino,2016-09-24,1,0,-3,3,10.5,1.25,2.540009,-2.540009,10,-10,7.619995,-7.619995,344,25,23,18,5,-5,9.25,-9.25,1,0,0,0,1,-1,0,0,133,0,133,-133
Aspen Ladd,Lina Lansberg,Aspen Ladd,2017-10-21,1,0,-13,13,3,1.25,-2.539993,2.539993,0,0,2.539993,-2.539993,204,163,12,18,-6,6,1.75,-1.75,0,0,0,1,0,0,-1,1,0,392,-392,392
Tonya Evinger,Lina Lansberg,Lina Lansberg,2019-06-01,0,1,0,0,2.375,1.25,0,0,0,0,12.7,-12.7,346,478,27,18,9,-9,1.125,-1.125,0,0,2,2,0,0,0,0,238,588,-350,350
Macy Chiasson,Lina Lansberg,Lina Lansberg,2019-09-28,0,1,-9,9,3,1.25,10.16,-10.16,0,0,17.78,-17.78,347,465,12,18,-6,6,1.75,-1.75,3,1,0,2,2,-2,-2,2,147,119,28,-28
Pannie Kianzad,Lina Lansberg,Pannie Kianzad,2022-04-16,1,0,-10,10,2.428571,1.25,0,0,0,0,2.539993,-2.539993,271,143,24,18,6,-6,1.17857146263123,-1.17857146263123,0,2,0,2,-2,2,-2,2,210,931,-721,721
Mayra Bueno Silva,Lina Lansberg,Mayra Bueno Silva,2023-02-18,1,0,-9,9,5.5,1.25,-2.539993,2.539993,0,0,2.539993,-2.539993,309,21,13,18,-5,5,4.25,-4.25,2,0,0,2,2,-2,-2,2,196,308,-112,112
Johnny Munoz,Liudvik Sholinian,Johnny Munoz,2022-11-05,1,0,-3,3,4,2.25,-2.540009,2.540009,0,0,0,0,159,90,15,13,2,-2,1.75,-1.75,1,0,0,0,1,-1,0,0,455,0,455,-455
Alex Chambers,Livinha Souza,Livinha Souza,2018-09-22,0,1,12,-12,1,3.5,0,0,0,0,0,0,0,39,10,18,-8,8,-2.5,2.5,0,0,0,0,0,0,0,0,308,0,308,-308
Sarah Frota,Livinha Souza,Livinha Souza,2019-02-02,0,1,4,-4,4.5,3.5,7.619995,-7.619995,10,-10,15.23999,-15.23999,276,222,11,18,-7,7,1,-1,0,1,0,0,-1,1,0,0,0,133,-133,133
Brianna Fortino,Livinha Souza,Brianna Fortino,2019-07-13,1,0,-3,3,3,3.5,-7.62001,7.62001,0,0,-2.540009,2.540009,281,43,12,18,-6,6,-0.5,0.5,0,2,0,0,-2,2,0,0,0,161,-161,161
Amanda Lemos,Livinha Souza,Amanda Lemos,2021-03-06,1,0,4,-4,4.333333,3.5,2.539993,-2.539993,0,0,5.080002,-5.080002,73,0,16,18,-2,2,0.833333492279053,-0.833333492279053,0,0,1,0,0,0,1,-1,1329,602,727,-727
Randa Markos,Livinha Souza,Randa Markos,2021-10-23,1,0,6,-6,0.9166667,3.5,2.539993,-2.539993,0,0,0,0,527,211,23,18,5,-5,-2.58333331346512,2.58333331346512,0,0,0,1,0,0,-1,1,175,231,-56,56
Jessica Andrade,Liz Carmouche,Liz Carmouche,2013-07-27,0,1,-8,8,2,1.857143,-12.7,12.7,-10,10,-10.16,10.16,21,472,36,20,16,-16,0.142857193946838,-0.142857193946838,0,0,0,0,0,0,0,0,0,0,0,0
Nate Quarry,Lodune Sincaid,Nate Quarry,2005-04-09,1,0,2,-2,3,1.666667,7.62001,-7.62001,0,0,4.880005,-4.880005,0,0,16,24,-8,8,1.33333337306976,-1.33333337306976,0,0,0,0,0,0,0,0,0,0,0,0
Steve Byrnes,Logan Clark,Logan Clark,2006-12-13,0,1,,,6,3,-5.080002,5.080002,-15,15,2,-2,538,229,7,24,-17,17,3,-3,0,0,0,0,0,0,0,0,0,0,0,0
Aleksandra Albu,Loma Lookboonmee,Loma Lookboonmee,2019-10-26,0,1,6,-6,1.5,2.666667,2.539993,-2.539993,0,0,5.080002,-5.080002,122,23,5,11,-6,6,-1.16666674613953,1.16666674613953,0,0,0,0,0,0,0,0,251,0,251,-251
Angela Hill,Loma Lookboonmee,Angela Hill,2020-02-22,1,0,11,-11,1.153846,2.666667,5.080002,-5.080002,0,0,7.619995,-7.619995,192,95,28,11,17,-17,-1.51282060146332,1.51282060146332,0,1,0,0,-1,1,0,0,259,119,140,-140
Sam Hughes,Loma Lookboonmee,Loma Lookboonmee,2021-05-01,0,1,3,-3,1.6,2.666667,10.16,-10.16,0,0,7.619995,-7.619995,394,90,13,11,2,-2,-1.06666672229767,1.06666672229767,0,0,1,0,0,0,1,-1,140,434,-294,294
Loopy Godinez,Loma Lookboonmee,Loopy Godinez,2021-11-20,1,0,3,-3,3.666667,2.666667,2.539993,-2.539993,0,0,0,0,452,173,14,11,3,-3,1,-1,1,1,0,0,0,0,0,0,42,203,-161,161
Denise Gomes,Loma Lookboonmee,Loma Lookboonmee,2022-09-17,0,1,-4,4,4,2.666667,2.539993,-2.539993,0,0,5.080002,-5.080002,331,421,10,11,-1,1,1.33333325386047,-1.33333325386047,0,0,0,0,0,0,0,0,0,301,-301,301
Luana Carolina,Loopy Godinez,Luana Carolina,2021-10-16,1,0,0,0,2.25,3.666667,10.16,-10.16,10,-10,20.31999,-20.31999,52,457,13,14,-1,1,-1.41666674613953,1.41666674613953,0,0,0,0,0,0,0,0,455,0,455,-455
Ariane Carnelossi,Loopy Godinez,Loopy Godinez,2022-05-07,0,1,1,-1,4.666667,3.666667,0,0,0,0,0,0,0,806,17,14,3,-3,0.999999761581421,-0.999999761581421,2,0,1,0,2,-2,1,-1,203,203,0,0
Cynthia Calvillo,Loopy Godinez,Loopy Godinez,2023-04-08,0,1,6,-6,1.5,3.666667,5.080002,-5.080002,0,0,7.619995,-7.619995,75,1,15,14,1,-1,-2.16666674613953,2.16666674613953,0,1,1,0,-1,1,1,-1,238,336,-98,98
Emily Ducote,Loopy Godinez,Loopy Godinez,2023-05-20,0,1,0,0,1.5,3.666667,0,0,0,0,5.080002,-5.080002,11,13,20,14,6,-6,-2.16666674613953,2.16666674613953,0,2,0,0,-2,2,0,0,168,42,126,-126
Francis Carmont,Lorenz Larkin,Francis Carmont,2013-04-20,1,0,5,-5,2.083333,3,10.16,-10.16,35,-35,15.23999,-15.23999,317,8,37,24,13,-13,-0.916666746139526,0.916666746139526,3,0,0,0,3,-3,0,0,154,0,154,-154
Chris Camozzi,Lorenz Larkin,Lorenz Larkin,2013-11-06,0,1,-1,1,1.846154,3,7.62001,-7.62001,15,-15,7.619995,-7.619995,107,63,37,24,13,-13,-1.15384614467621,1.15384614467621,0,0,0,0,0,0,0,0,172,200,-28,28
Derek Brunson,Lorenz Larkin,Derek Brunson,2014-08-30,1,0,3,-3,2.555556,3,5.080002,-5.080002,15,-15,12.7,-12.7,642,0,32,24,8,-8,-0.444444417953491,0.444444417953491,0,1,1,0,-1,1,1,-1,227,297,-70,70
John Howard,Lorenz Larkin,Lorenz Larkin,2015-01-18,0,1,3,-3,1.846154,3,-10.16,10.16,0,0,0,0,30,11,37,24,13,-13,-1.15384614467621,1.15384614467621,0,0,0,0,0,0,0,0,282,141,141,-141
Johnny Bedford,Louis Gaudinot,Johnny Bedford,2011-12-03,1,0,1,-1,1.615385,2,17.78,-17.78,10,-10,20.31999,-20.31999,561,0,34,12,22,-22,-0.384615421295166,0.384615421295166,0,0,0,0,0,0,0,0,0,0,0,0
Tim Elliott,Louis Gaudinot,Tim Elliott,2013-08-31,1,0,-3,3,1.666667,2,10.15999,-10.15999,0,0,7.619995,-7.619995,548,14,32,12,20,-20,-0.333333373069763,0.333333373069763,1,0,0,1,1,-1,-1,1,259,637,-378,378
Alptekin Ozkilic,Louis Smolka,Louis Smolka,2014-01-15,0,1,5,-5,1.8,1.888889,-10.15999,10.15999,-10,10,-7.619995,7.619995,215,101,14,26,-12,12,-8.88888835906982e-02,8.88888835906982e-02,1,0,0,0,1,-1,0,0,32,0,32,-32
Chris Cariaso,Louis Smolka,Chris Cariaso,2014-05-10,1,0,10,-10,2.125,1.888889,-15.23999,15.23999,-10,10,-10.16,10.16,128,453,25,26,-1,1,0.236111164093018,-0.236111164093018,2,1,0,0,1,-1,0,0,98,115,-17,17
Neil Seery,Louis Smolka,Louis Smolka,2015-07-11,0,1,12,-12,1.230769,1.888889,-12.7,12.7,-10,10,-10.16,10.16,34,724,29,26,3,-3,-0.658119559288025,0.658119559288025,0,0,0,0,0,0,0,0,0,427,-427,427
Paddy Holohan,Louis Smolka,Louis Smolka,2015-10-24,0,1,3,-3,6,1.888889,2.540009,-2.540009,-10,10,2.539993,-2.539993,256,177,14,26,-12,12,4.11111116409302,-4.11111116409302,2,1,0,0,1,-1,0,0,98,105,-7,7
Ben Nguyen,Louis Smolka,Louis Smolka,2016-07-13,0,1,3,-3,2,1.888889,-10.15999,10.15999,-10,10,-7.619995,7.619995,109,423,24,26,-2,2,0.111111164093018,-0.111111164093018,1,2,0,0,-1,1,0,0,431,263,168,-168
Brandon Moreno,Louis Smolka,Brandon Moreno,2016-10-01,1,0,-3,3,3,1.888889,-5.080002,5.080002,-10,10,5.080002,-5.080002,97,17,28,26,2,-2,1.11111116409302,-1.11111116409302,0,3,0,0,-3,3,0,0,0,80,-80,80
Ray Borg,Louis Smolka,Ray Borg,2016-12-30,1,0,-2,2,2.6,1.888889,-12.7,12.7,0,0,-12.7,12.7,653,45,18,26,-8,8,0.711111068725586,-0.711111068725586,0,0,0,0,0,0,0,0,328,90,238,-238
Tim Elliott,Louis Smolka,Tim Elliott,2017-04-15,1,0,5,-5,1.666667,1.888889,-5.080002,5.080002,-10,10,-5.080002,5.080002,483,159,32,26,6,-6,-0.222222208976746,0.222222208976746,0,0,0,0,0,0,0,0,133,106,27,-27
Matheus Nicolau,Louis Smolka,Matheus Nicolau,2017-12-30,1,0,-2,2,4.75,1.888889,-7.619995,7.619995,-10,10,-5.080002,5.080002,259,1,23,26,-3,3,2.86111116409302,-2.86111116409302,0,0,0,0,0,0,0,0,0,259,-259,259
Matt Schnell,Louis Smolka,Matt Schnell,2019-03-09,1,0,2,-2,2.285714,1.888889,-2.539993,2.539993,-10,10,5.080002,-5.080002,28,78,23,26,-3,3,0.396825551986694,-0.396825551986694,0,0,0,0,0,0,0,0,0,434,-434,434
Ryan MacDonald,Louis Smolka,Louis Smolka,2019-09-14,0,1,-2,2,5,1.888889,5.080002,-5.080002,0,0,7.619995,-7.619995,5,9,12,26,-14,14,3.11111116409302,-3.11111116409302,0,0,0,0,0,0,0,0,0,189,-189,189
Casey Kenney,Louis Smolka,Casey Kenney,2020-05-30,1,0,1,-1,4,1.888889,-5.080002,5.080002,0,0,0,0,9,0,20,26,-6,6,2.11111116409302,-2.11111116409302,0,1,0,0,-1,1,0,0,0,259,-259,259
Jose Quinonez,Louis Smolka,Louis Smolka,2020-12-05,0,1,1,-1,1.8,1.888889,-2.539993,2.539993,0,0,2.539993,-2.539993,31,69,14,26,-12,12,-8.88888835906982e-02,8.88888835906982e-02,0,0,0,0,0,0,0,0,630,189,441,-441
Vince Morales,Louis Smolka,Vince Morales,2021-12-04,1,0,1,-1,1.571429,1.888889,0,0,0,0,5.080002,-5.080002,0,0,18,26,-8,8,-0.317460298538208,0.317460298538208,2,1,0,0,1,-1,0,0,119,364,-245,245
Davey Grant,Louis Smolka,Davey Grant,2022-05-14,1,0,6,-6,2.142857,1.888889,-2.539993,2.539993,0,0,2.539993,-2.539993,35,35,22,26,-4,4,0.253968238830566,-0.253968238830566,0,0,0,1,0,0,-1,1,175,161,14,-14
Siyar Bahadurzada,Luan Chagas,Siyar Bahadurzada,2018-04-21,1,0,10,-10,3,5,-2.540009,2.540009,0,0,-5.080002,5.080002,100,154,32,18,14,-14,-2,2,2,0,0,0,2,-2,0,0,231,0,231,-231
"Da'Mon Blackshear",Luan Lacerda,"Da'Mon Blackshear",2023-06-03,1,0,-2,2,2.333333,4,7.62001,-7.62001,0,0,2.540009,-2.540009,134,26,20,15,5,-5,-1.66666674613953,1.66666674613953,0,0,0,0,0,0,0,0,0,0,0,0
Priscila Cachoeira,Luana Carolina,Luana Carolina,2019-05-11,0,1,5,-5,2.4,2.25,2.539993,-2.539993,0,0,-10.15999,10.15999,0,160,17,13,4,-4,0.150000095367432,-0.150000095367432,0,0,0,0,0,0,0,0,56,0,56,-56
Poliana Botelho,Luana Carolina,Luana Carolina,2021-05-01,0,1,5,-5,1.6,2.25,5.080002,-5.080002,0,0,-5.080002,5.080002,279,328,13,13,0,0,-0.649999976158142,0.649999976158142,0,1,0,0,-1,1,0,0,196,721,-525,525
Randa Markos,Luana Pinheiro,Luana Pinheiro,2021-05-01,0,1,7,-7,0.9166667,11,5.080002,-5.080002,0,0,2.540009,-2.540009,29,54,23,12,11,-11,-10.0833333134651,10.0833333134651,0,0,0,0,0,0,0,0,168,0,168,-168
Sam Hughes,Luana Pinheiro,Luana Pinheiro,2021-11-20,0,1,0,0,1.6,11,7.62001,-7.62001,0,0,5.080002,-5.080002,19,127,13,12,1,-1,-9.39999997615814,9.39999997615814,0,1,1,0,-1,1,1,-1,203,203,0,0
Juliana Miller,Luana Santos,Luana Santos,2023-08-12,0,1,4,-4,1.333333,6,2.539993,-2.539993,0,0,-2.539993,2.539993,29,26,7,7,0,0,-4.66666662693024,4.66666662693024,1,0,0,0,1,-1,0,0,371,0,371,-371
Edson Barboza,Lucas Martins,Edson Barboza,2013-01-19,1,0,2,-2,2.090909,6.333333,-2.540009,2.540009,0,0,7.619995,-7.619995,10,0,34,22,12,-12,-4.24242448806763,4.24242448806763,0,0,1,0,0,0,1,-1,238,0,238,-238
Jeremy Larsen,Lucas Martins,Lucas Martins,2013-05-18,0,1,5,-5,1.6,6.333333,-5.080002,5.080002,0,0,-5.080002,5.080002,205,4,13,22,-9,9,-4.73333346843719,4.73333346843719,0,0,1,1,0,0,0,0,351,119,232,-232
Ramiro Hernandez,Lucas Martins,Lucas Martins,2013-09-04,0,1,3,-3,2.111111,6.333333,-7.62001,7.62001,-10,10,-4.880005,4.880005,0,26,28,22,6,-6,-4.22222232818604,4.22222232818604,0,1,0,1,-1,1,-1,1,0,109,-109,109
Darren Elkins,Lucas Martins,Darren Elkins,2014-10-25,1,0,5,-5,2.454545,6.333333,-5.080002,5.080002,0,0,-2.540009,2.540009,483,26,38,22,16,-16,-3.87878799438477,3.87878799438477,0,2,1,1,-2,2,0,0,273,416,-143,143
Mirsad Bektic,Lucas Martins,Mirsad Bektic,2015-05-30,1,0,-2,2,3.25,6.333333,-10.16,10.16,0,0,-5.080002,5.080002,290,0,17,22,-5,5,-3.08333349227905,3.08333349227905,2,0,0,1,2,-2,-1,1,126,217,-91,91
Lina Lansberg,Lucie Pudilova,Lina Lansberg,2017-03-18,1,0,13,-13,1.25,1.75,-2.540009,2.540009,0,0,-5.079987,5.079987,353,66,18,22,-4,4,-0.5,0.5,0,0,0,0,0,0,0,0,0,0,0,0
Sarah Moras,Lucie Pudilova,Lucie Pudilova,2018-02-18,0,1,6,-6,0.75,1.75,-2.540009,2.540009,0,0,0,0,287,292,14,22,-8,8,-1,1,0,0,0,0,0,0,0,0,0,337,-337,337
Irene Aldana,Lucie Pudilova,Irene Aldana,2018-09-08,1,0,6,-6,2,1.75,2.539993,-2.539993,0,0,2.540009,-2.540009,2,17,21,22,-1,1,0.25,-0.25,1,1,0,0,0,0,0,0,237,202,35,-35
Liz Carmouche,Lucie Pudilova,Liz Carmouche,2019-02-23,1,0,11,-11,1.857143,1.75,-5.080002,5.080002,-10,10,-2.539993,2.539993,358,78,20,22,-2,2,0.107142806053162,-0.107142806053162,1,0,0,0,1,-1,0,0,224,168,56,-56
Justine Kish,Lucie Pudilova,Justine Kish,2020-01-25,1,0,6,-6,1.75,1.75,-7.619995,7.619995,-10,10,-7.619995,7.619995,35,9,11,22,-11,11,0,0,0,0,0,0,0,0,0,0,728,336,392,-392
Joselyne Edwards,Lucie Pudilova,Joselyne Edwards,2023-04-15,1,0,-1,1,2.6,1.75,0,0,0,0,7.62001,-7.62001,29,449,18,22,-4,4,0.849999904632568,-0.849999904632568,2,0,0,0,2,-2,0,0,259,1176,-917,917
Mason Jones,Ludovit Klein,Ludovit Klein,2022-07-23,0,1,0,0,5.5,5,7.62001,-7.62001,0,0,5.080002,-5.080002,137,401,13,24,-11,11,0.5,-0.5,1,0,0,0,1,-1,0,0,273,0,273,-273
Ignacio Bahamondes,Ludovit Klein,Ludovit Klein,2023-08-05,0,1,-3,3,2.8,5,20.32001,-20.32001,0,0,7.619995,-7.619995,7,365,19,24,-5,5,-2.20000004768372,2.20000004768372,2,1,0,0,1,-1,0,0,119,378,-259,259
Luke Cummo,Luigi Fioravanti,Luigi Fioravanti,2008-03-01,0,1,0,0,1,1.733333,10.16,-10.16,0,0,10.16,-10.16,40,635,12,41,-29,29,-0.733333349227905,0.733333349227905,2,0,0,0,2,-2,0,0,164,0,164,-164
Brodie Farber,Luigi Fioravanti,Luigi Fioravanti,2008-12-10,0,1,1,-1,2.285714,1.733333,12.7,-12.7,0,0,10.2,-10.2,30,592,23,41,-18,18,0.552381038665771,-0.552381038665771,0,1,1,0,-1,1,1,-1,144,284,-140,140
Jessin Ayari,Luigi Vendramini,Luigi Vendramini,2020-10-03,0,1,4,-4,2.666667,3,10.16,-10.16,0,0,0,0,0,2,22,12,10,-10,-0.333333253860474,0.333333253860474,0,0,0,0,0,0,0,0,707,0,707,-707
Paddy Pimblett,Luigi Vendramini,Paddy Pimblett,2021-09-04,1,0,1,-1,6.666667,3,5.080002,-5.080002,0,0,0,0,9,27,23,12,11,-11,3.66666650772095,-3.66666650772095,0,1,0,0,-1,1,0,0,0,336,-336,336
Christian Colombo,Luis Henrique,Luis Henrique,2016-11-19,0,1,13,-13,2.666667,2,7.619995,-7.619995,22,-22,10.03999,-10.03999,0,554,11,15,-4,4,0.666666746139526,-0.666666746139526,0,0,0,0,0,0,0,0,0,0,0,0
Arjan Bhullar,Luis Henrique,Arjan Bhullar,2017-09-09,1,0,7,-7,9,2,-2.540009,2.540009,2,-2,2.539993,-2.539993,245,0,10,15,-5,5,7,-7,0,1,0,0,-1,1,0,0,0,294,-294,294
Matt Frevola,Luis Pena,Matt Frevola,2019-10-12,1,0,3,-3,3.666667,3,-15.24001,15.24001,0,0,-10.16,10.16,173,65,14,12,2,-2,0.666666746139526,-0.666666746139526,1,0,1,0,1,-1,1,-1,182,0,182,-182
Steve Garcia,Luis Pena,Luis Pena,2020-02-29,0,1,1,-1,2.8,3,-7.619995,7.619995,-10,10,0,0,14,842,19,12,7,-7,-0.200000047683716,0.200000047683716,0,0,0,0,0,0,0,0,0,140,-140,140
Alexander Munoz,Luis Pena,Luis Pena,2021-04-17,0,1,4,-4,3.5,3,-15.24001,15.24001,0,0,-7.619995,7.619995,141,3,9,12,-3,3,0.5,-0.5,0,1,0,0,-1,1,0,0,0,413,-413,413
Matt Brown,Luis Ramos,Matt Brown,2012-06-22,1,0,0,0,1.368421,2,10.16,-10.16,0,0,15.5,-15.5,14,224,45,30,15,-15,-0.631578922271729,0.631578922271729,3,0,0,0,3,-3,0,0,62,0,62,-62
Jordan Griffin,Luis Saldana,Luis Saldana,2021-04-10,0,1,1,-1,2,2.285714,-2.539993,2.539993,0,0,0,0,378,138,27,23,4,-4,-0.285714387893677,0.285714387893677,0,0,0,0,0,0,0,0,287,0,287,-287
Austin Lingo,Luis Saldana,Austin Lingo,2021-08-21,1,0,-3,3,3,2.285714,-2.539993,2.539993,0,0,-7.619995,7.619995,91,19,12,23,-11,11,0.714285612106323,-0.714285612106323,0,1,0,0,-1,1,0,0,560,133,427,-427
Chris Camozzi,Luiz Cane,Chris Camozzi,2012-10-13,1,0,-6,6,1.846154,2.428571,0,0,0,0,-5.080002,5.080002,0,72,37,24,13,-13,-0.582417607307434,0.582417607307434,2,0,0,0,2,-2,0,0,113,0,113,-113
Tom Breese,Luiz Dutra,Tom Breese,2015-05-30,1,0,-10,10,4,2.166667,10.16,-10.16,15,-15,2.419998,-2.419998,58,45,15,19,-4,4,1.83333325386047,-1.83333325386047,0,0,0,0,0,0,0,0,0,0,0,0
Nick Hein,Lukasz Sajewski,Nick Hein,2015-06-20,1,0,7,-7,2.8,4.333333,-5.080002,5.080002,0,0,-12.7,12.7,56,50,19,16,3,-3,-1.53333353996277,1.53333353996277,0,0,0,0,0,0,0,0,210,0,210,-210
Gilbert Burns,Lukasz Sajewski,Gilbert Burns,2016-07-07,1,0,4,-4,3.666667,4.333333,5.080002,-5.080002,15,-15,0,0,81,47,28,16,12,-12,-0.666666746139526,0.666666746139526,0,0,0,0,0,0,0,0,243,383,-140,140
Marc Diakiese,Lukasz Sajewski,Marc Diakiese,2016-10-08,1,0,-2,2,2.285714,4.333333,5.080002,-5.080002,0,0,5.080002,-5.080002,7,215,23,16,7,-7,-2.04761910438538,2.04761910438538,0,0,0,0,0,0,0,0,0,93,-93,93
Marcus Aurelio,Luke Caudillo,Marcus Aurelio,2007-11-17,1,0,8,-8,2.2,1,7.62001,-7.62001,0,0,25.96001,-25.96001,143,15,32,34,-2,2,1.20000004768372,-1.20000004768372,0,0,0,0,0,0,0,0,84,0,84,-84
Shinsho Anzai,Luke Jumeau,Shinsho Anzai,2017-09-22,1,0,2,-2,3.333333,2.6,-10.16,10.16,0,0,-5.080002,5.080002,219,123,13,18,-5,5,0.733333349227905,-0.733333349227905,1,0,1,0,1,-1,1,-1,727,0,727,-727
Daichi Abe,Luke Jumeau,Luke Jumeau,2018-02-10,0,1,-3,3,3,2.6,0,0,0,0,-2.540009,2.540009,17,13,8,18,-10,10,0.400000095367432,-0.400000095367432,1,0,0,0,1,-1,0,0,141,141,0,0
Vitor Belfort,Luke Rockhold,Vitor Belfort,2013-05-18,1,0,8,-8,1.857143,2.666667,-7.619995,7.619995,0,0,-7.619995,7.619995,13,0,40,22,18,-18,-0.809523940086365,0.809523940086365,1,0,3,0,1,-1,3,-3,119,0,119,-119
Constantinos Philippou,Luke Rockhold,Luke Rockhold,2014-01-15,0,1,5,-5,2.6,2.666667,-10.16,10.16,0,0,-10.16,10.16,0,16,18,22,-4,4,-6.6666841506958e-02,6.6666841506958e-02,1,0,0,1,1,-1,-1,1,893,242,651,-651
Tim Boetsch,Luke Rockhold,Luke Rockhold,2014-04-26,0,1,4,-4,1.615385,2.666667,-7.619995,7.619995,0,0,-7.619995,7.619995,4,95,34,22,12,-12,-1.05128216743469,1.05128216743469,1,1,2,1,0,0,1,-1,189,101,88,-88
Michael Bisping,Luke Rockhold,Luke Rockhold,2014-11-07,0,1,5,-5,3.333333,2.666667,-5.080002,5.080002,0,0,-5.080002,5.080002,11,17,39,22,17,-17,0.666666507720947,-0.666666507720947,1,2,1,1,-1,1,0,0,76,195,-119,119
Lyoto Machida,Luke Rockhold,Luke Rockhold,2015-04-18,0,1,6,-6,3,2.666667,-5.080002,5.080002,0,0,-7.619995,7.619995,85,190,32,22,10,-10,0.333333253860474,-0.333333253860474,0,3,1,1,-3,3,0,0,287,162,125,-125
Michael Bisping,Luke Rockhold,Michael Bisping,2016-06-04,1,0,6,-6,3.333333,2.666667,-5.080002,5.080002,0,0,-5.080002,5.080002,3,0,39,22,17,-17,0.666666507720947,-0.666666507720947,3,4,1,1,-1,1,0,0,98,413,-315,315
David Branch,Luke Rockhold,Luke Rockhold,2017-09-16,0,1,3,-3,3.666667,2.666667,-5.080002,5.080002,0,0,2.539993,-2.539993,138,222,28,22,6,-6,1,-1,1,0,1,2,1,-1,-1,1,126,469,-343,343
Jan Blachowicz,Luke Rockhold,Jan Blachowicz,2019-07-06,1,0,2,-2,2.9,2.666667,-2.539993,2.539993,20,-20,2.539993,-2.539993,1,206,39,22,17,-17,0.233333349227905,-0.233333349227905,0,1,1,2,-1,1,-1,1,133,658,-525,525
Paulo Costa,Luke Rockhold,Paulo Costa,2022-08-20,1,0,-6,6,7,2.666667,-5.080002,5.080002,0,0,-12.7,12.7,328,47,16,22,-6,6,4.33333325386047,-4.33333325386047,0,0,0,3,0,0,-3,3,301,1141,-840,840
Maximo Blanco,Luke Sanders,Luke Sanders,2016-01-17,0,1,2,-2,1.5,2.6,5.080002,-5.080002,10,-10,10.16,-10.16,29,12,20,18,2,-2,-1.09999990463257,1.09999990463257,3,0,0,0,3,-3,0,0,189,0,189,-189
Iuri Alcantara,Luke Sanders,Iuri Alcantara,2017-03-04,1,0,5,-5,3.5,2.6,7.619995,-7.619995,0,0,10.16,-10.16,6,218,45,18,27,-27,0.900000095367432,-0.900000095367432,1,1,0,0,0,0,0,0,147,412,-265,265
Renan Barao,Luke Sanders,Luke Sanders,2019-02-17,0,1,-1,1,3.777778,2.6,0,0,10,-10,7.62001,-7.62001,0,17,43,18,25,-25,1.1777777671814,-1.1777777671814,0,0,2,0,0,0,2,-2,148,715,-567,567
Nate Maness,Luke Sanders,Nate Maness,2020-11-28,1,0,-5,5,4.666667,2.6,10.16,-10.16,-10,10,12.70001,-12.70001,30,40,17,18,-1,1,2.06666660308838,-2.06666660308838,1,1,0,0,0,0,0,0,119,650,-531,531
Felipe Colares,Luke Sanders,Felipe Colares,2021-05-01,1,0,-8,8,2.5,2.6,5.080002,-5.080002,10,-10,5.080002,-5.080002,174,175,14,18,-4,4,-9.99999046325684e-02,9.99999046325684e-02,0,0,0,0,0,0,0,0,462,154,308,-308
Caio Magalhaes,Luke Zachrich,Caio Magalhaes,2014-04-19,1,0,-6,6,3.333333,3.5,-2.540009,2.540009,0,0,-2.540009,2.540009,3,0,13,18,-5,5,-0.166666746139526,0.166666746139526,2,0,0,0,2,-2,0,0,134,0,134,-134
Guilherme Vasconcelos,Luke Zachrich,Luke Zachrich,2014-07-05,0,1,-4,4,2.25,3.5,-5.080002,5.080002,0,0,-2.960007,2.960007,0,1,13,18,-5,5,-1.25,1.25,0,0,0,1,0,0,-1,1,0,77,-77,77
Daniel Kelly,Luke Zachrich,Daniel Kelly,2014-11-07,1,0,5,-5,3.25,3.5,-5.080002,5.080002,0,0,-10.16,10.16,51,0,17,18,-1,1,-0.25,0.25,0,1,0,1,-1,1,-1,1,0,125,-125,125
Andrew Craig,Lyman Good,Lyman Good,2015-07-15,0,1,-1,1,2.25,3.5,2.539993,-2.539993,0,0,5.079987,-5.079987,29,26,13,27,-14,14,-1.25,1.25,0,0,0,0,0,0,0,0,382,0,382,-382
Sam Hoger,Lyoto Machida,Lyoto Machida,2007-02-03,0,1,-2,2,2.5,3,2.540009,-2.540009,20,-20,4.039993,-4.039993,25,467,14,32,-18,18,-0.5,0.5,2,0,0,0,2,-2,0,0,441,0,441,-441
David Heath,Lyoto Machida,Lyoto Machida,2007-04-21,0,1,3,-3,2.571429,3,-5.080002,5.080002,20,-20,-5.080002,5.080002,0,157,25,32,-7,7,-0.428571462631226,0.428571462631226,2,1,0,0,1,-1,0,0,129,77,52,-52
Rashad Evans,Lyoto Machida,Lyoto Machida,2009-05-23,0,1,-1,1,2.375,3,-2.539993,2.539993,20,-20,2.539993,-2.539993,0,30,27,32,-5,5,-0.625,0.625,6,2,0,0,4,-4,0,0,147,763,-616,616
Quinton Jackson,Lyoto Machida,Quinton Jackson,2010-11-20,1,0,0,0,3.083333,3,0,0,20,-20,-2.540009,2.540009,141,278,49,32,17,-17,8.33332538604736e-02,-8.33332538604736e-02,3,3,0,0,0,0,0,0,623,546,77,-77
Randy Couture,Lyoto Machida,Lyoto Machida,2011-04-30,0,1,15,-15,1.727273,3,0,0,20,-20,2.539993,-2.539993,6,2,30,32,-2,2,-1.27272725105286,1.27272725105286,2,0,4,0,2,-2,4,-4,245,161,84,-84
Jon Jones,Lyoto Machida,Jon Jones,2011-12-10,1,0,-9,9,27,3,7.619995,-7.619995,63,-63,25.39999,-25.39999,87,0,28,32,-4,4,24,-24,4,1,0,0,3,-3,0,0,266,224,42,-42
Ryan Bader,Lyoto Machida,Lyoto Machida,2012-08-04,0,1,-5,5,4.6,3,2.540009,-2.540009,20,-20,0,0,0,3,28,32,-4,4,1.59999990463257,-1.59999990463257,2,0,0,0,2,-2,0,0,161,238,-77,77
Dan Henderson,Lyoto Machida,Lyoto Machida,2013-02-23,0,1,8,-8,2.133333,3,-5.080002,5.080002,0,0,0,0,113,5,47,32,15,-15,-0.866666555404663,0.866666555404663,2,1,0,0,1,-1,0,0,462,203,259,-259
Phil Davis,Lyoto Machida,Phil Davis,2013-08-03,1,0,-7,7,4.25,3,2.540009,-2.540009,20,-20,12.7,-12.7,71,22,21,32,-11,11,1.25,-1.25,2,2,0,0,0,0,0,0,98,161,-63,63
CB Dollaway,Lyoto Machida,Lyoto Machida,2014-12-20,0,1,-5,5,1.888889,3,2.540009,-2.540009,0,0,5.079987,-5.079987,0,4,26,32,-6,6,-1.11111116409302,1.11111116409302,3,0,2,0,3,-3,2,-2,272,504,-232,232
Derek Brunson,Lyoto Machida,Derek Brunson,2017-10-28,1,0,-6,6,2.555556,3,0,0,0,0,7.619995,-7.619995,3,0,32,32,0,0,-0.444444417953491,0.444444417953491,1,1,2,0,0,0,2,-2,140,1043,-903,903
Eryk Anders,Lyoto Machida,Lyoto Machida,2018-02-03,0,1,-9,9,1.875,3,0,0,0,0,2.539993,-2.539993,227,137,23,32,-9,9,-1.125,1.125,2,0,0,1,2,-2,-1,1,56,98,-42,42
Vitor Belfort,Lyoto Machida,Lyoto Machida,2018-05-12,0,1,2,-2,1.857143,3,-2.539993,2.539993,0,0,0,0,0,0,40,32,8,-8,-1.14285719394684,1.14285719394684,1,1,6,1,0,0,5,-5,343,98,245,-245
Mark Bocek,Mac Danzig,Mac Danzig,2008-04-19,0,1,-2,2,2.4,1.75,0,0,0,0,12.7,-12.7,293,287,17,33,-16,16,0.650000095367432,-0.650000095367432,1,0,1,0,1,-1,1,-1,112,0,112,-112
Justin Buchholz,Mac Danzig,Mac Danzig,2010-02-06,0,1,-4,4,1.5,1.75,10.16,-10.16,0,0,7.619995,-7.619995,144,286,25,33,-8,8,-0.25,0.25,0,1,1,0,-1,1,1,-1,143,658,-515,515
Alex Caceres,Mackens Semerzier,Mackens Semerzier,2011-03-26,0,1,-8,8,1.5,2,2.540009,-2.540009,0,0,2.539993,-2.539993,0,172,35,12,23,-23,-0.5,0.5,0,0,0,0,0,0,0,0,0,0,0,0
Daniel Pineda,Mackens Semerzier,Daniel Pineda,2012-03-02,1,0,-5,5,1.866667,2,-5.080002,5.080002,0,0,-7.62001,7.62001,19,20,43,12,31,-31,-0.133333325386047,0.133333325386047,1,1,0,0,0,0,0,0,42,342,-300,300
Amanda Cooper,Mackenzie Dern,Mackenzie Dern,2018-05-12,0,1,1,-1,0.6,4.333333,-2.539993,2.539993,0,0,2.539993,-2.539993,0,9,8,16,-8,8,-3.73333346843719,3.73333346843719,2,0,0,0,2,-2,0,0,161,0,161,-161
Hannah Cifers,Mackenzie Dern,Mackenzie Dern,2020-05-30,0,1,0,0,1.428571,4.333333,-7.619995,7.619995,0,0,-2.540009,2.540009,24,0,17,16,1,-1,-2.90476202964783,2.90476202964783,0,1,1,0,-1,1,1,-1,126,749,-623,623
Irene Aldana,Macy Chiasson,Irene Aldana,2022-09-10,1,0,3,-3,2,3,-5.080002,5.080002,0,0,-10.16,10.16,60,208,21,12,9,-9,-1,1,1,0,0,0,1,-1,0,0,427,0,427,-427
Arnold Allen,Mads Burnell,Arnold Allen,2018-05-27,1,0,0,0,9.5,3,0,0,0,0,2.540009,-2.540009,9,464,21,12,9,-9,6.5,-6.5,3,0,0,0,3,-3,0,0,435,0,435,-435
Francis Carmont,Magnus Cedenblad,Francis Carmont,2012-04-14,1,0,0,0,2.083333,2.8,-5.080002,5.080002,20,-20,-2.540009,2.540009,218,133,37,19,18,-18,-0.716666698455811,0.716666698455811,0,0,0,0,0,0,0,0,0,0,0,0
Scott Askham,Magnus Cedenblad,Magnus Cedenblad,2014-10-04,0,1,-6,6,3.5,2.8,-5.080002,5.080002,0,0,-10.16,10.16,151,588,18,19,-1,1,0.700000047683716,-0.700000047683716,0,0,0,0,0,0,0,0,0,903,-903,903
Klidson Abreu,Magomed Ankalaev,Magomed Ankalaev,2019-02-23,0,1,0,0,3.75,18,-7.619995,7.619995,0,0,-2.539993,2.539993,28,348,19,19,0,0,-14.25,14.25,0,0,0,0,0,0,0,0,0,0,0,0
Piotr Hallmann,Magomed Mustafaev,Magomed Mustafaev,2015-06-20,0,1,1,-1,3,3.5,2.539993,-2.539993,0,0,0,0,288,86,24,18,6,-6,-0.5,0.5,0,0,0,0,0,0,0,0,280,0,280,-280
Kevin Lee,Magomed Mustafaev,Kevin Lee,2016-11-19,1,0,-4,4,2.25,3.5,2.539993,-2.539993,15,-15,15.24001,-15.24001,397,61,26,18,8,-8,-1.25,1.25,1,1,1,0,0,0,1,-1,134,518,-384,384
Rafael Fiziev,Magomed Mustafaev,Magomed Mustafaev,2019-04-20,0,1,-4,4,4,3.5,0,0,0,0,0,0,0,3,15,18,-3,3,0.5,-0.5,0,0,0,0,0,0,0,0,0,882,-882,882
Tae Hyun Bang,Mairbek Taisumov,Mairbek Taisumov,2014-01-04,0,1,5,-5,1.8,4.5,0,0,0,0,-5.080002,5.080002,8,229,28,33,-5,5,-2.70000004768372,2.70000004768372,0,0,0,0,0,0,0,0,0,0,0,0
Michel Prazeres,Mairbek Taisumov,Michel Prazeres,2014-03-23,1,0,7,-7,6.5,4.5,-7.619995,7.619995,15,-15,-15.24001,15.24001,300,80,30,33,-3,3,2,-2,1,1,0,0,0,0,0,0,183,78,105,-105
Marcin Bandel,Mairbek Taisumov,Mairbek Taisumov,2014-10-04,0,1,-2,2,2.142857,4.5,2.540009,-2.540009,0,0,8.889999,-8.889999,0,5,22,33,-11,11,-2.35714292526245,2.35714292526245,0,0,0,0,0,0,0,0,0,195,-195,195
Anthony Christodoulou,Mairbek Taisumov,Mairbek Taisumov,2015-01-24,0,1,1,-1,1.714286,4.5,0,0,0,0,-23.42,23.42,0,61,19,33,-14,14,-2.78571426868439,2.78571426868439,0,1,0,0,-1,1,0,0,0,112,-112,112
Alan Patrick,Mairbek Taisumov,Mairbek Taisumov,2015-06-20,0,1,5,-5,3.75,4.5,5.080002,-5.080002,0,0,2.540009,-2.540009,23,15,19,33,-14,14,-0.75,0.75,1,2,0,0,-1,1,0,0,619,147,472,-472
Damir Hadzovic,Mairbek Taisumov,Mairbek Taisumov,2016-04-10,0,1,2,-2,2,4.5,0,0,0,0,-7.619995,7.619995,0,1,21,33,-12,12,-2.5,2.5,0,3,0,0,-3,3,0,0,0,295,-295,295
Felipe Silva,Mairbek Taisumov,Mairbek Taisumov,2017-09-02,0,1,4,-4,4,4.5,7.62001,-7.62001,0,0,10.16,-10.16,0,1,10,33,-23,23,-0.5,0.5,0,4,0,0,-4,4,0,0,0,510,-510,510
Desmond Green,Mairbek Taisumov,Mairbek Taisumov,2018-09-15,0,1,-2,2,2.875,4.5,2.540009,-2.540009,0,0,0,0,0,4,31,33,-2,2,-1.625,1.625,1,5,0,0,-4,4,0,0,106,378,-272,272
Diego Ferreira,Mairbek Taisumov,Diego Ferreira,2019-09-07,1,0,3,-3,3.6,4.5,0,0,0,0,2.540009,-2.540009,19,1,23,33,-10,10,-0.900000095367432,0.900000095367432,3,6,1,0,-3,3,1,-1,196,357,-161,161
Alessio Di Chirico,Makhmud Muradov,Makhmud Muradov,2019-09-28,0,1,0,0,1.857143,3.25,-5.080002,5.080002,0,0,-2.539993,2.539993,43,38,20,34,-14,14,-1.39285719394684,1.39285719394684,0,0,0,0,0,0,0,0,98,0,98,-98
Gerald Meerschaert,Makhmud Muradov,Gerald Meerschaert,2021-08-28,1,0,2,-2,2.058824,3.25,-2.540009,2.540009,0,0,5.080002,-5.080002,55,16,52,34,18,-18,-1.19117641448975,1.19117641448975,3,1,1,0,2,-2,1,-1,539,700,-161,161
Caio Borralho,Makhmud Muradov,Caio Borralho,2022-10-22,1,0,-3,3,14,3.25,-10.16,10.16,0,0,0,0,332,284,15,34,-19,19,10.75,-10.75,2,0,0,0,2,-2,0,0,105,420,-315,315
Bryan Barberena,Makhmud Muradov,Makhmud Muradov,2023-07-22,0,1,1,-1,1.636364,3.25,-5.080002,5.080002,-15,15,-7.619995,7.619995,2,310,29,34,-5,5,-1.61363637447357,1.61363637447357,0,0,2,0,0,0,2,-2,126,273,-147,147
Charles Byrd,Maki Pitolo,Maki Pitolo,2020-06-06,0,1,7,-7,1.428571,1.444444,0,0,0,0,-5.080002,5.080002,174,112,17,22,-5,5,-1.58729553222656e-02,1.58729553222656e-02,0,0,2,0,0,0,2,-2,462,0,462,-462
Impa Kasanganay,Maki Pitolo,Impa Kasanganay,2020-08-29,1,0,-3,3,4.5,1.444444,2.539993,-2.539993,-15,15,0,0,15,16,11,22,-11,11,3.05555558204651,-3.05555558204651,0,1,0,0,-1,1,0,0,0,84,-84,84
Julian Marquez,Maki Pitolo,Julian Marquez,2021-02-13,1,0,0,0,2.25,1.444444,10.16,-10.16,0,0,-7.619995,7.619995,114,547,13,22,-9,9,0.805555582046509,-0.805555582046509,1,0,0,0,1,-1,0,0,1155,168,987,-987
Arnold Allen,Makwan Amirkhani,Arnold Allen,2017-03-18,1,0,-5,5,9.5,1.888889,-5.080002,5.080002,0,0,-5.080002,5.080002,333,338,21,26,-5,5,7.61111116409302,-7.61111116409302,2,0,0,0,2,-2,0,0,385,0,385,-385
Amir Albazi,Malcolm Gordon,Amir Albazi,2020-07-18,1,0,-4,4,17,2,-5.079987,5.079987,0,0,-7.619995,7.619995,141,22,18,21,-3,3,15,-15,0,0,0,0,0,0,0,0,0,0,0,0
Francisco Figueiredo,Malcolm Gordon,Malcolm Gordon,2021-07-17,0,1,0,0,2.6,2,-2.539993,2.539993,0,0,-7.619995,7.619995,255,361,18,21,-3,3,0.599999904632568,-0.599999904632568,1,0,0,0,1,-1,0,0,178,364,-186,186
Denys Bondar,Malcolm Gordon,Malcolm Gordon,2022-02-05,0,1,-2,2,3.2,2,-2.539993,2.539993,0,0,-5.080002,5.080002,37,15,21,21,0,0,1.20000004768372,-1.20000004768372,0,1,0,0,-1,1,0,0,0,203,-203,203
Virna Jandiroba,Mallory Martin,Virna Jandiroba,2019-12-07,1,0,6,-6,6.333333,1.4,-2.539993,2.539993,0,0,2.539993,-2.539993,222,30,22,12,10,-10,4.93333351612091,-4.93333351612091,0,0,0,0,0,0,0,0,0,0,0,0
Hannah Cifers,Mallory Martin,Mallory Martin,2020-08-29,0,1,2,-2,1.428571,1.4,-7.619995,7.619995,0,0,-2.540009,2.540009,86,74,17,12,5,-5,2.85714864730835e-02,-2.85714864730835e-02,0,0,1,0,0,0,1,-1,91,266,-175,175
Guido Cannetti,Mana Martinez,Mana Martinez,2021-08-28,0,1,16,-16,1.25,2.5,-10.16,10.16,0,0,-5.080002,5.080002,28,67,18,14,4,-4,-1.25,1.25,0,0,1,0,0,0,1,-1,539,0,539,-539
Ronnie Lawrence,Mana Martinez,Ronnie Lawrence,2022-02-12,1,0,4,-4,4,2.5,-5.080002,5.080002,0,0,-5.080002,5.080002,489,8,10,14,-4,4,1.5,-1.5,0,1,0,0,-1,1,0,0,0,168,-168,168
Brandon Davis,Mana Martinez,Mana Martinez,2022-10-15,0,1,6,-6,1.4,2.5,0,0,0,0,5.080002,-5.080002,91,45,24,14,10,-10,-1.10000002384186,1.10000002384186,0,0,0,0,0,0,0,0,1155,245,910,-910
David Dvorak,Manel Kape,Manel Kape,2022-12-17,0,1,1,-1,3.333333,3.166667,0,0,0,0,0,0,162,57,26,25,1,-1,0.166666507720947,-0.166666507720947,0,0,0,0,0,0,0,0,266,0,266,-266
Felipe dos Santos,Manel Kape,Manel Kape,2023-09-09,0,1,-7,7,7,3.166667,5.079987,-5.079987,0,0,5.080002,-5.080002,8,45,8,25,-17,17,3.83333325386047,-3.83333325386047,0,1,0,0,-1,1,0,0,0,266,-266,266
Morgan Charriere,Manolo Zecchini,Morgan Charriere,2023-09-02,1,0,1,-1,2.111111,2.75,0,0,0,0,2.539993,-2.539993,3,0,28,15,13,-13,-0.638888835906982,0.638888835906982,0,0,0,0,0,0,0,0,0,0,0,0
Mayra Bueno Silva,Manon Fiorot,Manon Fiorot,2021-10-16,0,1,-1,1,5.5,11,-2.539993,2.539993,10,-10,2.539993,-2.539993,4,245,13,12,1,-1,-5.5,5.5,1,0,0,0,1,-1,0,0,392,0,392,-392
Katlyn Chookagian,Manon Fiorot,Manon Fiorot,2022-10-22,0,1,1,-1,3.6,11,5.080002,-5.080002,0,0,7.619995,-7.619995,0,14,23,12,11,-11,-7.40000009536743,7.40000009536743,3,1,1,0,2,-2,1,-1,161,371,-210,210
Ben Alloway,Manuel Rodriguez,Ben Alloway,2012-12-14,1,0,4,-4,2.25,2.2,5.080002,-5.080002,0,0,2.039993,-2.039993,28,219,26,16,10,-10,4.99999523162842e-02,-4.99999523162842e-02,0,0,0,0,0,0,0,0,0,0,0,0
Frank Camacho,Manuel Torres,Manuel Torres,2022-05-14,0,1,5,-5,2.2,7,0,0,0,0,0,0,14,16,32,16,16,-16,-4.79999995231628,4.79999995231628,0,0,2,0,0,0,2,-2,693,0,693,-693
Nikolas Motta,Manuel Torres,Manuel Torres,2023-06-17,0,1,2,-2,2.6,7,-2.540009,2.540009,0,0,-7.619995,7.619995,0,1,18,16,2,-2,-4.40000009536743,4.40000009536743,1,1,0,0,0,0,0,0,273,399,-126,126
Nate Diaz,Manvel Gamburyan,Nate Diaz,2007-06-23,1,0,-4,4,1.692308,1.5,17.78,-17.78,35,-35,22.86,-22.86,25,255,35,25,10,-10,0.192307710647583,-0.192307710647583,0,0,0,0,0,0,0,0,0,0,0,0
Jeff Cox,Manvel Gamburyan,Manvel Gamburyan,2008-04-02,0,1,13,-13,1.428571,1.5,12.7,-12.7,20,-20,9.820007,-9.820007,73,14,17,25,-8,8,-7.14285373687744e-02,7.14285373687744e-02,0,0,0,0,0,0,0,0,295,284,11,-11
Rob Emerson,Manvel Gamburyan,Rob Emerson,2008-08-09,1,0,0,0,1.5,1.5,10.15999,-10.15999,20,-20,7.62001,-7.62001,3,0,30,25,5,-5,0,0,1,1,0,0,0,0,0,0,189,129,60,-60
John Dodson,Manvel Gamburyan,John Dodson,2016-04-16,1,0,-3,3,1.833333,1.5,-5.080002,5.080002,0,0,-2.539993,2.539993,4,0,34,25,9,-9,0.333333373069763,-0.333333373069763,0,0,0,1,0,0,-1,1,224,2807,-2583,2583
Johnny Eduardo,Manvel Gamburyan,Johnny Eduardo,2016-11-19,1,0,3,-3,2.153846,1.5,5.079987,-5.079987,0,0,10.16,-10.16,31,0,41,25,16,-16,0.653846263885498,-0.653846263885498,0,0,0,2,0,0,-2,2,345,217,128,-128
Kalindra Faria,Mara Romero Borella,Mara Romero Borella,2017-10-07,0,1,0,0,2.25,1.333333,2.539993,-2.539993,0,0,-2.259995,2.259995,0,162,26,21,5,-5,0.916666626930237,-0.916666626930237,0,0,0,0,0,0,0,0,0,0,0,0
Katlyn Chookagian,Mara Romero Borella,Katlyn Chookagian,2018-01-27,1,0,-2,2,3.6,1.333333,7.619995,-7.619995,0,0,-2.539993,2.539993,0,35,23,21,2,-2,2.26666653156281,-2.26666653156281,1,1,0,0,0,0,0,0,563,112,451,-451
Lauren Murphy,Mara Romero Borella,Lauren Murphy,2019-08-03,1,0,3,-3,2.666667,1.333333,-2.539993,2.539993,0,0,-5.080002,5.080002,136,46,22,21,1,-1,1.33333337306976,-1.33333337306976,0,0,0,0,0,0,0,0,0,553,-553,553
Montana De La Rosa,Mara Romero Borella,Montana De La Rosa,2020-02-15,1,0,-8,8,1.5,1.333333,2.539993,-2.539993,0,0,-2.539993,2.539993,510,108,20,21,-1,1,0.166666626930237,-0.166666626930237,0,0,0,1,0,0,-1,1,238,196,42,-42
Cortney Casey,Mara Romero Borella,Cortney Casey,2020-05-16,1,0,0,0,1,1.333333,2.539993,-2.539993,0,0,-5.080002,5.080002,0,175,20,21,-1,1,-0.333333373069763,0.333333373069763,1,0,0,1,1,-1,-1,1,630,91,539,-539
Mayra Bueno Silva,Mara Romero Borella,Mayra Bueno Silva,2020-09-19,1,0,-5,5,5.5,1.333333,0,0,10,-10,-7.619995,7.619995,0,120,13,21,-8,8,4.16666662693024,-4.16666662693024,0,0,0,1,0,0,-1,1,189,126,63,-63
Rafael Alves,Marc Diakiese,Rafael Alves,2021-11-13,1,0,2,-2,1.666667,2.285714,-5.080002,5.080002,0,0,-12.7,12.7,0,3,32,23,9,-9,-0.61904776096344,0.61904776096344,0,0,0,0,0,0,0,0,175,0,175,-175
Viacheslav Borshchev,Marc Diakiese,Marc Diakiese,2022-03-26,0,1,1,-1,2.333333,2.285714,2.539993,-2.539993,0,0,-10.16,10.16,35,744,10,23,-13,13,4.76188659667969e-02,-4.76188659667969e-02,1,0,0,0,1,-1,0,0,70,133,-63,63
Joel Alvarez,Marc Diakiese,Joel Alvarez,2023-07-22,1,0,0,0,6.666667,2.285714,12.7,-12.7,0,0,10.16,-10.16,86,189,23,23,0,0,4.38095211982727,-4.38095211982727,0,1,1,0,-1,1,1,-1,511,483,28,-28
Abu Azaitar,Marc-Andre Barriault,Marc-Andre Barriault,2021-03-27,0,1,4,-4,4.666667,2.666667,-10.16,10.16,0,0,5.079987,-5.079987,123,360,17,22,-5,5,1.99999976158142,-1.99999976158142,1,0,0,0,1,-1,0,0,979,0,979,-979
Eryk Anders,Marc-Andre Barriault,Marc-Andre Barriault,2023-06-10,0,1,3,-3,1.875,2.666667,0,0,0,0,2.539993,-2.539993,198,40,23,22,1,-1,-0.791666746139526,0.791666746139526,1,1,1,0,0,0,1,-1,189,805,-616,616
Jake Collier,Marcel Fortuna,Jake Collier,2017-11-11,1,0,-3,3,1.3,3,5.080002,-5.080002,25,-25,10.15999,-10.15999,71,67,23,12,11,-11,-1.70000004768372,1.70000004768372,1,0,2,0,1,-1,2,-2,531,0,531,-531
Christian Colombo,Marcelo Golm,Marcelo Golm,2017-10-28,0,1,12,-12,2.666667,2,5.080002,-5.080002,16,-16,7.5,-7.5,0,82,11,9,2,-2,0.666666746139526,-0.666666746139526,0,0,0,0,0,0,0,0,343,0,343,-343
Arjan Bhullar,Marcelo Golm,Arjan Bhullar,2018-10-27,1,0,6,-6,9,2,-5.080002,5.080002,-4,4,0,0,417,28,10,9,1,-1,7,-7,0,1,0,0,-1,1,0,0,196,364,-168,168
Andy Enz,Marcelo Guimaraes,Marcelo Guimaraes,2014-06-28,0,1,-9,9,2.5,4.5,7.619995,-7.619995,0,0,12.7,-12.7,0,178,14,11,3,-3,-2,2,0,0,0,0,0,0,0,0,147,0,147,-147
Charles Jourdain,Marcelo Rojo,Charles Jourdain,2021-03-13,1,0,-7,7,2.5,1.6,2.539993,-2.539993,0,0,-5.080002,5.080002,177,28,21,26,-5,5,0.899999976158142,-0.899999976158142,0,0,0,0,0,0,0,0,0,0,0,0
Kyler Phillips,Marcelo Rojo,Kyler Phillips,2022-02-12,1,0,-7,7,5.5,1.6,0,0,-10,10,2.540009,-2.540009,153,30,13,26,-13,13,3.89999997615814,-3.89999997615814,2,0,0,1,2,-2,-1,1,343,336,7,-7
Francis Marshall,Marcelo Rojo,Francis Marshall,2022-12-03,1,0,-11,11,3.5,1.6,2.539993,-2.539993,0,0,2.540009,-2.540009,167,0,9,26,-17,17,1.89999997615814,-1.89999997615814,0,0,0,1,0,0,-1,1,0,294,-294,294
Damir Hadzovic,Marcin Held,Damir Hadzovic,2017-05-28,1,0,5,-5,2,3.285714,0,0,0,0,-2.539993,2.539993,22,440,21,30,-9,9,-1.28571438789368,1.28571438789368,0,0,1,0,0,0,1,-1,413,0,413,-413
Nasrat Haqparast,Marcin Held,Marcin Held,2017-10-21,0,1,-3,3,3,3.285714,2.540009,-2.540009,0,0,2.540009,-2.540009,81,445,20,30,-10,10,-0.285714387893677,0.285714387893677,0,0,0,1,0,0,-1,1,0,146,-146,146
Sam Alvey,Marcin Prachnio,Sam Alvey,2018-02-24,1,0,2,-2,1.833333,2.285714,-2.539993,2.539993,-20,20,2.539993,-2.539993,101,14,51,23,28,-28,-0.452381014823914,0.452381014823914,0,0,1,0,0,0,1,-1,126,0,126,-126
Magomed Ankalaev,Marcin Prachnio,Magomed Ankalaev,2018-09-15,1,0,-4,4,18,2.285714,0,0,0,0,2.539993,-2.539993,2,0,19,23,-4,4,15.7142856121063,-15.7142856121063,0,0,0,1,0,0,-1,1,182,203,-21,21
Philipe Lins,Marcin Prachnio,Philipe Lins,2022-04-23,1,0,3,-3,3.4,2.285714,-2.539993,2.539993,0,0,10.15999,-10.15999,328,113,22,23,-1,1,1.11428570747375,-1.11428570747375,0,0,0,2,0,0,-2,2,0,1316,-1316,1316
William Knight,Marcin Prachnio,Marcin Prachnio,2023-02-18,0,1,0,0,2.2,2.285714,-12.7,12.7,0,0,-2.540009,2.540009,0,0,16,23,-7,7,-8.57143402099609e-02,8.57143402099609e-02,1,0,0,2,1,-1,-2,2,441,301,140,-140
Vitor Petrino,Marcin Prachnio,Vitor Petrino,2023-07-08,1,0,-9,9,9,2.285714,-2.539993,2.539993,0,0,7.619995,-7.619995,519,18,9,23,-14,14,6.71428561210632,-6.71428561210632,1,1,0,2,0,0,-2,2,119,140,-21,21
Timothy Johnson,Marcin Tybura,Timothy Johnson,2016-04-10,1,0,1,-1,3,3,0,0,16,-16,-2.539993,2.539993,224,77,16,32,-16,16,0,0,0,0,0,0,0,0,0,0,246,0,246,-246
Viktor Pesta,Marcin Tybura,Marcin Tybura,2016-08-06,0,1,-4,4,2.5,3,0,0,-9,9,-2.539993,2.539993,29,15,14,32,-18,18,-0.5,0.5,0,0,0,0,0,0,0,0,0,118,-118,118
Luis Henrique,Marcin Tybura,Marcin Tybura,2017-03-04,0,1,-8,8,2,3,-2.539993,2.539993,-6,6,-10.15999,10.15999,503,173,15,32,-17,17,-1,1,1,1,1,0,0,0,1,-1,224,210,14,-14
Andrei Arlovski,Marcin Tybura,Marcin Tybura,2017-06-17,0,1,7,-7,1.545455,3,0,0,-9,9,-2.539993,2.539993,240,517,56,32,24,-24,-1.45454549789429,1.45454549789429,0,2,6,0,-2,2,6,-6,140,105,35,-35
Derrick Lewis,Marcin Tybura,Derrick Lewis,2018-02-18,1,0,1,-1,2.454545,3,0,0,11,-11,2.540009,-2.540009,136,433,38,32,6,-6,-0.545454502105713,0.545454502105713,3,3,1,0,0,0,1,-1,591,246,345,-345
Stefan Struve,Marcin Tybura,Marcin Tybura,2018-07-22,0,1,-2,2,2.538461,3,20.32001,-20.32001,16,-16,15.24001,-15.24001,5,463,46,32,14,-14,-0.461538553237915,0.461538553237915,0,0,1,1,0,0,0,0,323,154,169,-169
Shamil Abdurakhimov,Marcin Tybura,Shamil Abdurakhimov,2019-04-20,1,0,4,-4,2.5,3,0,0,-14,14,-5.080002,5.080002,0,0,28,32,-4,4,-0.5,0.5,2,1,2,1,1,-1,1,-1,217,272,-55,55
Augusto Sakai,Marcin Tybura,Augusto Sakai,2019-09-14,1,0,-5,5,3.2,3,0,0,16,-16,-2.539993,2.539993,3,0,21,32,-11,11,0.200000047683716,-0.200000047683716,1,0,0,2,1,-1,-2,2,357,147,210,-210
Serghei Spivac,Marcin Tybura,Marcin Tybura,2020-02-29,0,1,-9,9,4,3,0,0,11,-11,0,0,0,502,20,32,-12,12,1,-1,1,0,0,3,1,-1,-3,3,147,168,-21,21
Maxim Grishin,Marcin Tybura,Marcin Tybura,2020-07-11,0,1,2,-2,3.2,3,0,0,-44,44,0,0,16,565,42,32,10,-10,0.200000047683716,-0.200000047683716,0,1,0,3,-1,1,-3,3,0,133,-133,133
Ben Rothwell,Marcin Tybura,Marcin Tybura,2020-10-10,0,1,4,-4,2.785714,3,2.539993,-2.539993,16,-16,0,0,19,188,53,32,21,-21,-0.214285612106323,0.214285612106323,5,2,1,3,3,-3,-2,2,150,91,59,-59
Greg Hardy,Marcin Tybura,Marcin Tybura,2020-12-19,0,1,-3,3,1.4,3,5.080002,-5.080002,16,-16,5.080002,-5.080002,2,87,12,32,-20,20,-1.60000002384186,1.60000002384186,0,3,0,3,-3,3,-3,3,406,70,336,-336
Walt Harris,Marcin Tybura,Marcin Tybura,2021-06-05,0,1,2,-2,1.3,3,5.080002,-5.080002,1,-1,-2.539993,2.539993,6,138,23,32,-9,9,-1.70000004768372,1.70000004768372,0,4,4,3,-4,4,1,-1,224,168,56,-56
Alexandr Romanov,Marcin Tybura,Marcin Tybura,2022-08-20,0,1,-5,5,8.5,3,-2.539993,2.539993,13,-13,-7.619995,7.619995,302,108,19,32,-13,13,5.5,-5.5,2,5,0,3,-3,3,-3,3,112,441,-329,329
Blagoy Ivanov,Marcin Tybura,Marcin Tybura,2023-02-04,0,1,-1,1,3.166667,3,-10.16,10.16,1,-1,-12.7,12.7,0,295,25,32,-7,7,0.166666746139526,-0.166666746139526,1,6,0,3,-5,5,-3,3,273,168,105,-105
Tom Aspinall,Marcin Tybura,Tom Aspinall,2023-07-22,1,0,-7,7,4.333333,3,5.080002,-5.080002,7,-7,0,0,5,0,16,32,-16,16,1.33333349227905,-1.33333349227905,0,7,1,3,-7,7,-2,2,364,168,196,-196
Julian Erosa,Marcin Wrzosek,Julian Erosa,2015-12-11,1,0,-2,2,2.333333,3,10.16,-10.16,-10,10,9.960007,-9.960007,279,279,40,16,24,-24,-0.666666746139526,0.666666746139526,0,0,0,0,0,0,0,0,0,0,0,0
Andrei Arlovski,Marcio Cruz,Andrei Arlovski,2006-12-30,1,0,-1,1,1.545455,2.666667,-2.539993,2.539993,8,-8,-0.4199982,0.4199982,83,51,56,11,45,-45,-1.12121224403381,1.12121224403381,0,0,3,0,0,0,3,-3,175,0,175,-175
Cesar Arzamendia,Marco Polo Reyes,Marco Polo Reyes,2015-11-21,0,1,-7,7,2.666667,1.142857,0,0,0,0,3.610001,-3.610001,72,2,11,15,-4,4,1.52380955219269,-1.52380955219269,0,0,0,0,0,0,0,0,0,0,0,0
Dong Hyun Ma,Marco Polo Reyes,Marco Polo Reyes,2016-06-04,0,1,-4,4,1.454545,1.142857,0,0,0,0,-2.539993,2.539993,88,84,27,15,12,-12,0.311688303947449,-0.311688303947449,0,1,1,0,-1,1,1,-1,189,196,-7,7
Jason Novelli,Marco Polo Reyes,Marco Polo Reyes,2016-11-05,0,1,6,-6,3.666667,1.142857,2.540009,-2.540009,0,0,5.660004,-5.660004,64,153,14,15,-1,1,2.52380955219269,-2.52380955219269,0,2,1,0,-2,2,1,-1,91,154,-63,63
Matt Frevola,Marco Polo Reyes,Marco Polo Reyes,2018-01-14,0,1,-6,6,3.666667,1.142857,-5.080002,5.080002,0,0,0,0,0,0,14,15,-1,1,2.52380955219269,-2.52380955219269,0,3,0,0,-3,3,0,0,0,435,-435,435
Damir Hadzovic,Marco Polo Reyes,Damir Hadzovic,2019-02-23,1,0,-2,2,2,1.142857,-5.080002,5.080002,0,0,-2.539993,2.539993,139,0,21,15,6,-6,0.857142806053162,-0.857142806053162,1,4,1,0,-3,3,1,-1,216,405,-189,189
Drew Dober,Marco Polo Reyes,Drew Dober,2019-06-29,1,0,-4,4,2.166667,1.142857,-7.619995,7.619995,0,0,-2.539993,2.539993,5,0,38,15,23,-23,1.02380955219269,-1.02380955219269,3,0,0,1,3,-3,-1,1,308,126,182,-182
Kyle Nelson,Marco Polo Reyes,Kyle Nelson,2019-09-21,1,0,-6,6,3,1.142857,0,0,-10,10,0,0,50,0,20,15,5,-5,1.85714280605316,-1.85714280605316,0,0,0,2,0,0,-2,2,140,84,56,-56
Remco Pardoel,Marco Ruas,Marco Ruas,1995-09-08,0,1,,,1.5,2.25,5.080002,-5.080002,50,-50,10,-10,0,0,15,13,2,-2,-0.75,0.75,2,0,0,0,2,-2,0,0,0,0,0,0
Larry Cureton,Marco Ruas,Marco Ruas,1995-09-08,0,1,,,0,2.25,2.540009,-2.540009,30,-30,-10,10,0,0,2,13,-11,11,-2.25,2.25,0,1,0,0,-1,1,0,0,154,0,154,-154
Keith Hackney,Marco Ruas,Marco Ruas,1995-12-16,0,1,,,1,2.25,-5.080002,5.080002,-10,10,-3,3,0,0,4,13,-9,9,-1.25,1.25,2,2,0,0,0,0,0,0,365,99,266,-266
Richardson Moreira,Marcos Rogerio de Lima,Marcos Rogerio de Lima,2014-05-31,0,1,2,-2,1.75,2.1,2.540009,-2.540009,-68,68,-2.5,2.5,0,3,11,31,-20,20,-0.349999904632568,0.349999904632568,0,0,0,0,0,0,0,0,0,0,0,0
Igor Pokrajac,Marcos Rogerio de Lima,Marcos Rogerio de Lima,2014-12-20,0,1,6,-6,2.153846,2.1,-2.539993,2.539993,-48,48,-2.539993,2.539993,0,98,41,31,10,-10,5.38463592529297e-02,-5.38463592529297e-02,1,1,1,0,0,0,1,-1,1106,203,903,-903
Nikita Krylov,Marcos Rogerio de Lima,Nikita Krylov,2015-08-23,1,0,-7,7,3.333333,2.1,5.080002,-5.080002,-48,48,5.080002,-5.080002,118,0,39,31,8,-8,1.23333334922791,-1.23333334922791,1,2,1,0,-1,1,1,-1,211,246,-35,35
Clint Hester,Marcos Rogerio de Lima,Marcos Rogerio de Lima,2016-04-23,0,1,-1,1,1.833333,2.1,2.540009,-2.540009,-48,48,5.080002,-5.080002,0,238,17,31,-14,14,-0.266666531562805,0.266666531562805,0,0,2,0,0,0,2,-2,266,244,22,-22
Gadzhimurad Antigulov,Marcos Rogerio de Lima,Gadzhimurad Antigulov,2016-11-19,1,0,-2,2,2.5,2.1,-5.080002,5.080002,-48,48,-12.7,12.7,29,21,28,31,-3,3,0.400000095367432,-0.400000095367432,0,1,0,0,-1,1,0,0,0,210,-210,210
Jeremy Kimball,Marcos Rogerio de Lima,Marcos Rogerio de Lima,2017-01-28,0,1,-5,5,1.875,2.1,-2.539993,2.539993,-48,48,-7.619995,7.619995,18,4,23,31,-8,8,-0.224999904632568,0.224999904632568,0,0,0,0,0,0,0,0,0,70,-70,70
Maurice Greene,Marcos Rogerio de Lima,Marcos Rogerio de Lima,2021-05-08,0,1,-1,1,1.285714,2.1,15.24001,-15.24001,5,-5,12.7,-12.7,0,846,16,31,-15,15,-0.814285635948181,0.814285635948181,0,1,2,0,-1,1,2,-2,189,1561,-1372,1372
Blagoy Ivanov,Marcos Rogerio de Lima,Blagoy Ivanov,2022-05-07,1,0,-1,1,3.166667,2.1,-5.080002,5.080002,-3,3,-5.080002,5.080002,232,124,25,31,-6,6,1.06666684150696,-1.06666684150696,0,2,0,0,-2,2,0,0,707,364,343,-343
Andrei Arlovski,Marcos Rogerio de Lima,Marcos Rogerio de Lima,2022-10-29,0,1,6,-6,1.545455,2.1,5.080002,-5.080002,-13,13,5.080002,-5.080002,0,90,56,31,25,-25,-0.554545402526855,0.554545402526855,4,0,7,0,4,-4,7,-7,182,175,7,-7
Waldo Cortes-Acosta,Marcos Rogerio de Lima,Marcos Rogerio de Lima,2023-04-29,0,1,-6,6,10,2.1,7.619995,-7.619995,7,-7,7.619995,-7.619995,34,301,11,31,-20,20,7.90000009536743,-7.90000009536743,2,1,0,0,1,-1,0,0,161,182,-21,21
Derrick Lewis,Marcos Rogerio de Lima,Derrick Lewis,2023-07-29,1,0,0,0,2.454545,2.1,5.080002,-5.080002,7,-7,10.16,-10.16,29,0,38,31,7,-7,0.354545593261719,-0.354545593261719,0,2,3,0,-2,2,3,-3,175,91,84,-84
Wagner Campos,Marcos Vinicius,Marcos Vinicius,2012-06-23,0,1,-2,2,1.2,2.090909,-7.619995,7.619995,20,-20,-18,18,392,2,22,34,-12,12,-0.89090895652771,0.89090895652771,0,0,0,0,0,0,0,0,0,0,0,0
Johnny Bedford,Marcos Vinicius,Johnny Bedford,2012-12-15,1,0,-4,4,1.615385,2.090909,2.540009,-2.540009,10,-10,-7.660004,7.660004,197,0,34,34,0,0,-0.475524425506592,0.475524425506592,1,1,0,0,0,0,0,0,378,175,203,-203
Ali Bagautinov,Marcos Vinicius,Ali Bagautinov,2013-09-04,1,0,-5,5,2.5,2.090909,-12.7,12.7,0,0,-22.89999,22.89999,246,161,21,34,-13,13,0.409090995788574,-0.409090995788574,0,0,0,1,0,0,-1,1,0,263,-263,263
Stephen Bass,Marcus Brimage,Marcus Brimage,2011-12-03,0,1,3,-3,5.5,1,12.7,-12.7,10,-10,-3.569992,3.569992,24,42,13,14,-1,1,4.5,-4.5,0,0,0,0,0,0,0,0,0,0,0,0
Maximo Blanco,Marcus Brimage,Marcus Brimage,2012-04-21,0,1,1,-1,1.5,1,10.16,-10.16,10,-10,0,0,1,1,20,14,6,-6,0.5,-0.5,0,1,0,0,-1,1,0,0,0,140,-140,140
Shonie Carter,Marcus Davis,Marcus Davis,2006-12-13,0,1,1,-1,1.645161,2,0,0,0,0,0.1999969,-0.1999969,92,170,82,33,49,-49,-0.354838728904724,0.354838728904724,0,0,2,0,0,0,2,-2,557,0,557,-557
JP Buys,Marcus McGhee,Marcus McGhee,2023-08-12,0,1,-6,6,1.5,8,-7.619995,7.619995,0,0,-5.080002,5.080002,0,5,15,9,6,-6,-6.5,6.5,0,0,2,0,0,0,2,-2,413,0,413,-413
Kazushi Sakuraba,Marcus Silveira,Kazushi Sakuraba,1997-12-21,1,0,,,1.529412,1.5,-7.619995,7.619995,-57,57,-8,8,0,0,43,10,33,-33,2.9411792755127e-02,-2.9411792755127e-02,0,0,0,0,0,0,0,0,0,0,0,0
Gloria de Paula,Maria Oliveira,Maria Oliveira,2022-06-18,0,1,2,-2,1.2,1.857143,-2.539993,2.539993,0,0,-5.080002,5.080002,49,95,11,20,-9,9,-0.657142758369446,0.657142758369446,0,0,1,0,0,0,1,-1,322,0,322,-322
Vanessa Demopoulos,Maria Oliveira,Vanessa Demopoulos,2022-11-19,1,0,9,-9,1.8,1.857143,-10.16,10.16,0,0,-25.39999,25.39999,479,1,14,20,-6,6,-5.71428537368774e-02,5.71428537368774e-02,2,1,0,0,1,-1,0,0,147,154,-7,7
Diana Belbita,Maria Oliveira,Diana Belbita,2023-06-10,1,0,0,0,2.142857,1.857143,2.539993,-2.539993,0,0,-2.539993,2.539993,124,246,22,20,2,-2,0.285714268684387,-0.285714268684387,0,0,0,0,0,0,0,0,476,203,273,-273
Jessica Aguilar,Marina Rodriguez,Marina Rodriguez,2019-03-30,0,1,5,-5,2.5,5.666667,-7.619995,7.619995,0,0,-5.080002,5.080002,100,181,28,20,8,-8,-3.16666650772095,3.16666650772095,0,0,0,0,0,0,0,0,126,0,126,-126
Carla Esparza,Marina Rodriguez,Carla Esparza,2020-07-25,1,0,-1,1,2.857143,5.666667,-12.7,12.7,0,0,-5.080002,5.080002,534,64,27,20,7,-7,-2.8095235824585,2.8095235824585,3,1,2,0,2,-2,2,-2,77,483,-406,406
Amanda Ribas,Marina Rodriguez,Marina Rodriguez,2021-01-23,0,1,-6,6,2.75,5.666667,-7.619995,7.619995,10,-10,2.539993,-2.539993,219,7,15,20,-5,5,-2.91666650772095,2.91666650772095,2,0,0,0,2,-2,0,0,196,182,14,-14
Mackenzie Dern,Marina Rodriguez,Marina Rodriguez,2021-10-09,0,1,-6,6,4.333333,5.666667,-5.080002,5.080002,0,0,-5.080002,5.080002,441,10,16,20,-4,4,-1.33333301544189,1.33333301544189,3,1,0,0,2,-2,0,0,182,259,-77,77
Amanda Lemos,Marina Rodriguez,Amanda Lemos,2022-11-05,1,0,0,0,4.333333,5.666667,-5.080002,5.080002,0,0,0,0,186,15,16,20,-4,4,-1.33333301544189,1.33333301544189,2,2,1,0,0,0,1,-1,112,392,-280,280
Virna Jandiroba,Marina Rodriguez,Virna Jandiroba,2023-05-06,1,0,-2,2,6.333333,5.666667,-7.619995,7.619995,0,0,-2.540009,2.540009,722,5,22,20,2,-2,0.666666984558105,-0.666666984558105,0,0,0,1,0,0,-1,1,553,182,371,-371
Gerald Harris,Mario Miranda,Gerald Harris,2010-03-31,1,0,0,0,4.6,2,-10.16,10.16,0,0,7.619995,-7.619995,7,40,28,21,7,-7,2.59999990463257,-2.59999990463257,1,0,0,0,1,-1,0,0,79,0,79,-79
David Loiseau,Mario Miranda,Mario Miranda,2010-06-12,0,1,0,0,2.090909,2,-7.619995,7.619995,0,0,5.079987,-5.079987,40,441,34,21,13,-13,9.09090042114258e-02,-9.09090042114258e-02,0,0,0,1,0,0,-1,1,1358,73,1285,-1285
Demian Maia,Mario Miranda,Demian Maia,2010-08-28,1,0,1,-1,2.545455,2,-5.080002,5.080002,-15,15,-5.080002,5.080002,592,81,39,21,18,-18,0.545454502105713,-0.545454502105713,0,1,1,1,-1,1,0,0,140,77,63,-63
Alexis Dufresne,Marion Reneau,Marion Reneau,2015-01-03,0,1,-13,13,2,1.125,7.619995,-7.619995,0,0,5.279999,-5.279999,14,16,9,17,-8,8,0.875,-0.875,0,0,0,0,0,0,0,0,181,0,181,-181
Jessica Andrade,Marion Reneau,Marion Reneau,2015-02-22,0,1,-14,14,2,1.125,-12.7,12.7,-20,20,-15.24001,15.24001,62,0,36,17,19,-19,0.875,-0.875,3,1,1,0,2,-2,1,-1,162,50,112,-112
Holly Holm,Marion Reneau,Holly Holm,2015-07-15,1,0,-5,5,2.142857,1.125,5.080002,-5.080002,0,0,2.539993,-2.539993,50,0,22,17,5,-5,1.01785707473755,-1.01785707473755,1,2,0,0,-1,1,0,0,137,143,-6,6
Ashlee Evans-Smith,Marion Reneau,Ashlee Evans-Smith,2016-02-21,1,0,-10,10,1,1.125,5.080002,-5.080002,0,0,-2.540009,2.540009,49,11,12,17,-5,5,-0.125,0.125,0,0,0,0,0,0,0,0,442,221,221,-221
Milana Dudieva,Marion Reneau,Marion Reneau,2016-11-19,0,1,-12,12,1.833333,1.125,-7.619995,7.619995,0,0,-9.720001,9.720001,149,261,17,17,0,0,0.708333373069763,-0.708333373069763,0,0,1,0,0,0,1,-1,595,272,323,-323
Talita Bernardo,Marion Reneau,Marion Reneau,2017-09-02,0,1,-10,10,1.5,1.125,-5.080002,5.080002,0,0,0,0,385,208,10,17,-7,7,0.375,-0.375,0,1,0,0,-1,1,0,0,0,287,-287,287
Sara McMann,Marion Reneau,Marion Reneau,2018-02-24,0,1,-3,3,2.166667,1.125,0,0,0,0,-5.080002,5.080002,311,7,19,17,2,-2,1.04166674613953,-1.04166674613953,0,2,1,0,-2,2,1,-1,168,175,-7,7
Raquel Pennington,Marion Reneau,Raquel Pennington,2020-06-20,1,0,-12,12,1.666667,1.125,2.539993,-2.539993,0,0,-2.540009,2.540009,329,228,24,17,7,-7,0.541666626930237,-0.541666626930237,2,3,0,0,-1,1,0,0,1316,847,469,-469
Macy Chiasson,Marion Reneau,Macy Chiasson,2021-03-20,1,0,-14,14,3,1.125,12.7,-12.7,0,0,10.16,-10.16,228,135,12,17,-5,5,1.875,-1.875,1,0,0,0,1,-1,0,0,399,273,126,-126
David Bielkheden,Mark Bocek,Mark Bocek,2009-04-18,0,1,2,-2,2,2.4,5.080002,-5.080002,0,0,-10.16,10.16,22,240,36,17,19,-19,-0.400000095367432,0.400000095367432,1,0,1,0,1,-1,1,-1,182,0,182,-182
John Alessio,Mark Bocek,Mark Bocek,2012-04-21,0,1,2,-2,2.058824,2.4,5.080002,-5.080002,0,0,-7.619995,7.619995,12,584,52,17,35,-35,-0.341176509857178,0.341176509857178,0,1,0,0,-1,1,0,0,2020,1099,921,-921
Stephan Bonnar,Mark Coleman,Mark Coleman,2009-07-11,0,1,-12,12,1.666667,1.6,7.619995,-7.619995,0,0,10.16,-10.16,161,589,24,26,-2,2,6.66666030883789e-02,-6.66666030883789e-02,0,0,0,0,0,0,0,0,161,0,161,-161
Don Frye,Mark Hall,Don Frye,1996-07-12,1,0,,,2.222222,0.8333333,2.539993,-2.539993,29,-29,0,0,0,0,29,11,18,-18,1.38888901472092,-1.38888901472092,2,0,0,0,2,-2,0,0,0,0,0,0
Don Frye,Mark Hall,Don Frye,1996-12-07,1,0,,,2.222222,0.8333333,2.539993,-2.539993,29,-29,0,0,0,0,29,11,18,-18,1.38888901472092,-1.38888901472092,5,0,0,1,5,-5,-1,1,0,148,-148,148
John Gunderson,Mark Holst,John Gunderson,2010-06-19,1,0,7,-7,2.1875,2,-7.62001,7.62001,0,0,-11.74001,11.74001,750,56,51,18,33,-33,0.1875,-0.1875,0,0,0,0,0,0,0,0,168,0,168,-168
Yves Edwards,Mark Hominick,Mark Hominick,2006-03-04,0,1,6,-6,1.909091,1.666667,2.539993,-2.539993,10,-10,12.7,-12.7,70,22,64,32,32,-32,0.242424249649048,-0.242424249649048,4,0,0,0,4,-4,0,0,560,0,560,-560
Jorge Gurgel,Mark Hominick,Mark Hominick,2006-06-28,0,1,6,-6,1.4,1.666667,-2.540009,2.540009,10,-10,2.539993,-2.539993,0,12,24,32,-8,8,-0.266666650772095,0.266666650772095,0,1,0,0,-1,1,0,0,0,116,-116,116
Jose Aldo,Mark Hominick,Jose Aldo,2011-04-30,1,0,-4,4,3.875,1.666667,-2.540009,2.540009,-10,10,5.080002,-5.080002,553,258,39,32,7,-7,2.20833337306976,-2.20833337306976,0,2,0,0,-2,2,0,0,0,1767,-1767,1767
Pablo Garza,Mark Hominick,Pablo Garza,2012-11-17,1,0,-1,1,3,1.666667,12.7,-12.7,0,0,12.7,-12.7,504,60,16,32,-16,16,1.33333337306976,-1.33333337306976,0,0,0,0,0,0,0,0,371,567,-196,196
Junior Dos Santos,Mark Hunt,Junior Dos Santos,2013-05-25,1,0,-10,10,2.333333,0.9285714,15.23999,-15.23999,-27,27,12.7,-12.7,87,0,30,27,3,-3,1.40476185083389,-1.40476185083389,0,0,0,0,0,0,0,0,147,0,147,-147
Curtis Blaydes,Mark Hunt,Curtis Blaydes,2018-02-10,1,0,-17,17,4.25,0.9285714,15.23999,-15.23999,0,0,20.31999,-20.31999,575,7,21,27,-6,6,3.32142859697342,-3.32142859697342,3,0,1,1,3,-3,0,0,98,1722,-1624,1624
Dan Bobish,Mark Kerr,Mark Kerr,1997-07-27,0,1,-1,1,1.888889,1.363636,-2.539993,2.539993,79,-79,-5,5,0,0,26,26,0,0,0.525252461433411,-0.525252461433411,0,0,0,0,0,0,0,0,0,0,0,0
Moti Horenstein,Mark Kerr,Mark Kerr,1997-07-27,0,1,,,0.1666667,1.363636,2.539993,-2.539993,-36,36,1,-1,0,0,7,26,-19,19,-1.19696970283985,1.19696970283985,0,1,0,0,-1,1,0,0,0,0,0,0
Dwayne Cason,Mark Kerr,Mark Kerr,1997-10-17,0,1,,,1,1.363636,-12.7,12.7,-54,54,-13,13,0,0,2,26,-24,24,-0.363636374473572,0.363636374473572,0,2,0,0,-2,2,0,0,0,82,-82,82
Danilo Belluardo,Mark Madsen,Mark Madsen,2019-09-28,0,1,-10,10,2.4,12,10.16,-10.16,0,0,5.080002,-5.080002,0,51,17,13,4,-4,-9.59999990463257,9.59999990463257,0,0,0,0,0,0,0,0,0,0,0,0
Austin Hubbard,Mark Madsen,Mark Madsen,2020-03-07,0,1,-7,7,2.285714,12,5.080002,-5.080002,0,0,-2.540009,2.540009,0,481,23,13,10,-10,-9.71428561210632,9.71428561210632,1,1,0,0,0,0,0,0,175,161,14,-14
Clay Guida,Mark Madsen,Mark Madsen,2021-08-21,0,1,3,-3,1.9,12,-2.540009,2.540009,0,0,-5.080002,5.080002,0,54,58,13,45,-45,-10.1000000238419,10.1000000238419,1,2,2,0,-1,1,2,-2,196,532,-336,336
Grant Dawson,Mark Madsen,Grant Dawson,2022-11-05,1,0,-10,10,20,12,5.080002,-5.080002,0,0,0,0,571,24,21,13,8,-8,8,-8,6,3,0,0,3,-3,0,0,189,441,-252,252
Matt Hamill,Mark Munoz,Matt Hamill,2009-03-07,1,0,1,-1,1.5,2.333333,2.539993,-2.539993,20,-20,12.7,-12.7,19,1,20,20,0,0,-0.833333253860474,0.833333253860474,2,0,0,0,2,-2,0,0,735,0,735,-735
Nick Catone,Mark Munoz,Mark Munoz,2009-08-29,0,1,-4,4,2.5,2.333333,0,0,0,0,2.540009,-2.540009,190,248,14,20,-6,6,0.166666746139526,-0.166666746139526,0,0,0,1,0,0,-1,1,150,175,-25,25
Ryan Jensen,Mark Munoz,Mark Munoz,2010-01-02,0,1,1,-1,2.625,2.333333,2.539993,-2.539993,0,0,12.7,-12.7,21,83,29,20,9,-9,0.291666746139526,-0.291666746139526,1,1,0,1,0,0,-1,1,108,126,-18,18
Kendall Grove,Mark Munoz,Mark Munoz,2010-04-10,0,1,-5,5,1.352941,2.333333,15.23999,-15.23999,0,0,20.32001,-20.32001,107,222,40,20,20,-20,-0.980392098426819,0.980392098426819,2,2,1,1,0,0,0,0,140,98,42,-42
CB Dollaway,Mark Munoz,Mark Munoz,2011-03-03,0,1,-6,6,1.888889,2.333333,5.080002,-5.080002,0,0,12.7,-12.7,12,5,26,20,6,-6,-0.444444417953491,0.444444417953491,2,3,0,1,-1,1,-1,1,376,327,49,-49
Demian Maia,Mark Munoz,Mark Munoz,2011-06-11,0,1,0,0,2.545455,2.333333,2.539993,-2.539993,-15,15,2.540009,-2.540009,113,322,39,20,19,-19,0.212121248245239,-0.212121248245239,1,4,1,1,-3,3,0,0,287,100,187,-187
Chris Leben,Mark Munoz,Mark Munoz,2011-11-05,0,1,-2,2,2,2.333333,-2.540009,2.540009,0,0,5.080002,-5.080002,86,376,33,20,13,-13,-0.333333253860474,0.333333253860474,1,5,2,1,-4,4,1,-1,126,147,-21,21
Tim Boetsch,Mark Munoz,Mark Munoz,2013-07-06,0,1,-3,3,1.615385,2.333333,0,0,0,0,7.62001,-7.62001,179,566,34,20,14,-14,-0.71794867515564,0.71794867515564,0,6,2,1,-6,6,1,-1,189,609,-420,420
Lyoto Machida,Mark Munoz,Lyoto Machida,2013-10-26,1,0,0,0,3,2.333333,2.539993,-2.539993,0,0,7.62001,-7.62001,1,0,32,20,12,-12,0.666666746139526,-0.666666746139526,0,7,1,1,-7,7,0,0,1267,112,1155,-1155
Gegard Mousasi,Mark Munoz,Gegard Mousasi,2014-05-31,1,0,-8,8,7,2.333333,5.080002,-5.080002,0,0,12.7,-12.7,92,12,48,20,28,-28,4.66666674613953,-4.66666674613953,0,0,0,2,0,0,-2,2,0,217,-217,217
Roan Carneiro,Mark Munoz,Roan Carneiro,2015-02-28,1,0,-1,1,1.909091,2.333333,-2.540009,2.540009,-15,15,12.7,-12.7,53,0,32,20,12,-12,-0.424242377281189,0.424242377281189,0,0,0,2,0,0,-2,2,2366,273,2093,-2093
Luke Barnatt,Mark Munoz,Mark Munoz,2015-05-16,0,1,-10,10,3.25,2.333333,15.23999,-15.23999,0,0,15.24001,-15.24001,5,475,17,20,-3,3,0.916666746139526,-0.916666746139526,0,0,0,2,0,0,-2,2,175,77,98,-98
Pascal Krauss,Mark Scanlon,Pascal Krauss,2010-11-13,1,0,,,5.5,4.5,10.16,-10.16,0,0,7,-7,488,197,13,11,2,-2,1,-1,0,0,0,0,0,0,0,0,0,0,0,0
Gary Goodridge,Mark Schultz,Mark Schultz,1996-05-17,0,1,,,1.045455,1,15.24001,-15.24001,49,-49,15,-15,0,0,45,2,43,-43,4.54545021057129e-02,-4.54545021057129e-02,1,0,0,0,1,-1,0,0,91,0,91,-91
Said Nurmagomedov,Mark Striegl,Said Nurmagomedov,2020-10-17,1,0,-4,4,5.666667,4.5,0,0,-10,10,0,0,5,0,20,22,-2,2,1.16666650772095,-1.16666650772095,2,0,0,0,2,-2,0,0,623,0,623,-623
Chas Skelly,Mark Striegl,Chas Skelly,2022-02-19,1,0,3,-3,6.333333,4.5,7.619995,-7.619995,0,0,5.080002,-5.080002,223,82,22,22,0,0,1.83333349227905,-1.83333349227905,2,0,0,1,2,-2,-1,1,2296,490,1806,-1806
Eugene Jackson,Mark Weir,Mark Weir,2002-07-13,0,1,1,-1,1.666667,1.166667,-15.24001,15.24001,0,0,-13,13,0,1,24,39,-15,15,0.5,-0.5,1,0,0,0,1,-1,0,0,183,0,183,-183
Phillip Miller,Mark Weir,Phillip Miller,2002-11-22,1,0,-12,12,16,1.166667,-7.62001,7.62001,0,0,-8,8,393,163,16,39,-23,23,14.8333333730698,-14.8333333730698,1,1,0,0,0,0,0,0,132,132,0,0
David Loiseau,Mark Weir,David Loiseau,2003-04-25,1,0,-12,12,2.090909,1.166667,-5.080002,5.080002,0,0,2.039993,-2.039993,212,0,34,39,-5,5,0.924242377281189,-0.924242377281189,0,0,0,0,0,0,0,0,0,154,-154,154
Eryk Anders,Markus Perez,Eryk Anders,2017-12-09,1,0,1,-1,1.875,2.4,0,0,0,0,5.080002,-5.080002,472,49,23,17,6,-6,-0.525000095367432,0.525000095367432,1,0,0,0,1,-1,0,0,140,0,140,-140
James Bochnovic,Markus Perez,Markus Perez,2018-05-12,0,1,0,0,2.666667,2.4,7.619995,-7.619995,20,-20,20.32001,-20.32001,59,197,11,17,-6,6,0.266666650772095,-0.266666650772095,0,0,1,0,0,0,1,-1,308,154,154,-154
Anthony Hernandez,Markus Perez,Markus Perez,2019-02-02,0,1,-5,5,5.5,2.4,-2.539993,2.539993,0,0,5.080002,-5.080002,38,159,13,17,-4,4,3.09999990463257,-3.09999990463257,0,1,0,0,-1,1,0,0,0,266,-266,266
Dricus Du Plessis,Markus Perez,Dricus Du Plessis,2020-10-10,1,0,-6,6,10,2.4,0,0,0,0,7.619995,-7.619995,2,0,22,17,5,-5,7.59999990463257,-7.59999990463257,0,2,0,0,-2,2,0,0,0,616,-616,616
Dalcha Lungiambula,Markus Perez,Dalcha Lungiambula,2021-01-20,1,0,1,-1,1.833333,2.4,-12.7,12.7,0,0,7.619995,-7.619995,406,261,17,17,0,0,-0.566666722297668,0.566666722297668,1,0,0,1,1,-1,-1,1,571,102,469,-469
Raphael Assuncao,Marlon Moraes,Raphael Assuncao,2017-06-03,1,0,5,-5,2.8,2.3,-2.539993,2.539993,0,0,-2.539993,2.539993,0,0,38,33,5,-5,0.5,-0.5,1,0,1,0,1,-1,1,-1,126,0,126,-126
John Dodson,Marlon Moraes,Marlon Moraes,2017-11-11,0,1,4,-4,1.833333,2.3,-7.619995,7.619995,0,0,-2.539993,2.539993,27,65,34,33,1,-1,-0.466666579246521,0.466666579246521,1,0,0,0,1,-1,0,0,203,161,42,-42
Raphael Assuncao,Marlon Moraes,Marlon Moraes,2019-02-02,0,1,6,-6,2.8,2.3,-2.539993,2.539993,0,0,-2.539993,2.539993,0,75,38,33,5,-5,0.5,-0.5,4,1,1,0,3,-3,1,-1,210,448,-238,238
Henry Cejudo,Marlon Moraes,Henry Cejudo,2019-06-08,1,0,1,-1,5.333333,2.3,-5.080002,5.080002,0,0,-7.619995,7.619995,160,0,19,33,-14,14,3.03333353996277,-3.03333353996277,4,2,1,0,2,-2,1,-1,140,126,14,-14
Jose Aldo,Marlon Moraes,Marlon Moraes,2019-12-14,0,1,2,-2,3.875,2.3,2.539993,-2.539993,0,0,7.62001,-7.62001,0,21,39,33,6,-6,1.57500004768372,-1.57500004768372,0,0,3,1,0,0,2,-2,217,189,28,-28
Rob Font,Marlon Moraes,Rob Font,2020-12-19,1,0,1,-1,2.857143,2.3,5.080002,-5.080002,0,0,10.16,-10.16,38,151,27,33,-6,6,0.557142972946167,-0.557142972946167,2,1,0,1,1,-1,-1,1,378,371,7,-7
Merab Dvalishvili,Marlon Moraes,Merab Dvalishvili,2021-09-25,1,0,-3,3,4,2.3,0,0,0,0,2.540009,-2.540009,360,30,20,33,-13,13,1.70000004768372,-1.70000004768372,5,0,0,2,5,-5,-2,2,147,280,-133,133
Marco Beltran,Marlon Vera,Marco Beltran,2014-11-15,1,0,7,-7,1.333333,2.625,0,0,-10,10,-2.540009,2.540009,348,360,14,29,-15,15,-1.29166662693024,1.29166662693024,0,0,0,0,0,0,0,0,0,0,0,0
Roman Salazar,Marlon Vera,Marlon Vera,2015-08-08,0,1,5,-5,1.666667,2.625,-2.540009,2.540009,0,0,-4.800003,4.800003,307,6,16,29,-13,13,-0.958333373069763,0.958333373069763,0,0,0,0,0,0,0,0,0,266,-266,266
Davey Grant,Marlon Vera,Davey Grant,2016-02-27,1,0,7,-7,2.142857,2.625,0,0,0,0,-2.540009,2.540009,517,83,22,29,-7,7,-0.482142925262451,0.482142925262451,0,1,0,0,-1,1,0,0,819,203,616,-616
Guangyou Ning,Marlon Vera,Marlon Vera,2016-11-26,0,1,11,-11,1.25,2.625,-10.16,10.16,10,-10,-15.24001,15.24001,168,163,9,29,-20,20,-1.375,1.375,2,0,0,0,2,-2,0,0,560,273,287,-287
Brad Pickett,Marlon Vera,Marlon Vera,2017-03-18,0,1,14,-14,1.785714,2.625,-5.080002,5.080002,0,0,-5.080002,5.080002,211,4,39,29,10,-10,-0.839285731315613,0.839285731315613,2,1,0,0,1,-1,0,0,385,112,273,-273
Brian Kelleher,Marlon Vera,Marlon Vera,2017-07-22,0,1,6,-6,1.714286,2.625,-5.080002,5.080002,0,0,-10.16,10.16,64,7,38,29,9,-9,-0.910714268684387,0.910714268684387,0,2,0,0,-2,2,0,0,0,126,-126,126
John Lineker,Marlon Vera,John Lineker,2017-10-28,1,0,3,-3,3.444444,2.625,-12.7,12.7,0,0,-7.62001,7.62001,95,0,40,29,11,-11,0.819444417953491,-0.819444417953491,6,3,0,0,3,-3,0,0,472,98,374,-374
Douglas Silva de Andrade,Marlon Vera,Douglas Silva de Andrade,2018-02-03,1,0,7,-7,5.8,2.625,-2.540009,2.540009,0,0,-5.080002,5.080002,35,1,34,29,5,-5,3.17500019073486,-3.17500019073486,0,0,0,0,0,0,0,0,1449,98,1351,-1351
Guido Cannetti,Marlon Vera,Marlon Vera,2018-11-17,0,1,13,-13,1.25,2.625,-5.080002,5.080002,0,0,-5.080002,5.080002,166,81,18,29,-11,11,-1.375,1.375,1,0,0,0,1,-1,0,0,182,287,-105,105
Frankie Saenz,Marlon Vera,Marlon Vera,2019-03-23,0,1,12,-12,1.857143,2.625,-5.080002,5.080002,0,0,-10.16,10.16,0,3,20,29,-9,9,-0.767857193946838,0.767857193946838,0,1,1,0,-1,1,1,-1,973,126,847,-847
Nohelin Hernandez,Marlon Vera,Marlon Vera,2019-07-06,0,1,-1,1,2.25,2.625,5.080002,-5.080002,0,0,2.539993,-2.539993,176,143,13,29,-16,16,-0.375,0.375,0,2,0,0,-2,2,0,0,0,105,-105,105
Andre Ewell,Marlon Vera,Marlon Vera,2019-10-12,0,1,5,-5,1.888889,2.625,0,0,10,-10,12.7,-12.7,153,72,26,29,-3,3,-0.736111164093018,0.736111164093018,0,3,0,0,-3,3,0,0,287,98,189,-189
"Sean O'Malley",Marlon Vera,Marlon Vera,2020-08-15,0,1,-2,2,17,2.625,7.619995,-7.619995,0,0,5.080002,-5.080002,0,11,18,29,-11,11,14.375,-14.375,4,4,0,0,0,0,0,0,70,308,-238,238
Jose Aldo,Marlon Vera,Jose Aldo,2020-12-19,1,0,6,-6,3.875,2.625,-2.540009,2.540009,0,0,0,0,297,171,39,29,10,-10,1.25,-1.25,0,5,4,0,-5,5,4,-4,161,126,35,-35
Davey Grant,Marlon Vera,Marlon Vera,2021-06-19,0,1,7,-7,2.142857,2.625,0,0,0,0,-2.540009,2.540009,114,315,22,29,-7,7,-0.482142925262451,0.482142925262451,2,0,0,0,2,-2,0,0,98,182,-84,84
Frankie Edgar,Marlon Vera,Marlon Vera,2021-11-06,0,1,12,-12,2.090909,2.625,-5.080002,5.080002,0,0,-5.080002,5.080002,265,1,34,29,5,-5,-0.534090995788574,0.534090995788574,0,1,3,0,-1,1,3,-3,273,140,133,-133
Rob Font,Marlon Vera,Marlon Vera,2022-04-30,0,1,5,-5,2.857143,2.625,0,0,0,0,2.539993,-2.539993,18,125,27,29,-2,2,0.232142925262451,-0.232142925262451,4,2,0,0,2,-2,0,0,343,175,168,-168
Dominick Cruz,Marlon Vera,Marlon Vera,2022-08-13,0,1,8,-8,6,2.625,0,0,0,0,-5.080002,5.080002,65,10,28,29,-1,1,3.375,-3.375,2,3,0,0,-1,1,0,0,245,105,140,-140
Cory Sandhagen,Marlon Vera,Cory Sandhagen,2023-03-25,1,0,0,0,4.25,2.625,7.619995,-7.619995,0,0,0,0,428,9,21,29,-8,8,1.625,-1.625,1,4,0,0,-3,3,0,0,189,224,-35,35
Pedro Munhoz,Marlon Vera,Marlon Vera,2023-08-19,0,1,6,-6,2.5,2.625,-5.080002,5.080002,0,0,-12.7,12.7,0,0,28,29,-1,1,-0.125,0.125,1,0,0,0,1,-1,0,0,903,147,756,-756
Josefine Knutsson,Marnic Mann,Josefine Knutsson,2023-09-16,1,0,-3,3,7,3,7.62001,-7.62001,0,0,-10.16,10.16,649,33,7,8,-1,1,4,-4,0,0,0,0,0,0,0,0,0,0,0,0
Humberto Bandenay,Martin Bravo,Humberto Bandenay,2017-08-05,1,0,-1,1,2,3.666667,7.619995,-7.619995,0,0,0,0,2,0,21,14,7,-7,-1.66666674613953,1.66666674613953,0,0,0,0,0,0,0,0,0,0,0,0
Chris Barnett,Martin Buday,Martin Buday,2022-04-16,0,1,5,-5,2.875,13,-17.78,17.78,0,0,-5.080002,5.080002,17,464,31,14,17,-17,-10.125,10.125,1,0,0,0,1,-1,0,0,161,0,161,-161
Lukasz Brzeski,Martin Buday,Martin Buday,2022-08-13,0,1,0,0,2,13,0,0,-29,29,2.539993,-2.539993,0,6,12,14,-2,2,-11,11,0,1,0,0,-1,1,0,0,0,119,-119,119
Alexandre Barros,Martin Kampmann,Martin Kampmann,2009-01-17,0,1,6,-6,2,2.857143,-7.62001,7.62001,0,0,-4.110001,4.110001,135,186,33,27,6,-6,-0.857142925262451,0.857142925262451,0,0,0,0,0,0,0,0,0,0,0,0
Carlos Condit,Martin Kampmann,Martin Kampmann,2009-04-01,0,1,-2,2,2.285714,2.857143,5.080002,-5.080002,0,0,7.619995,-7.619995,190,468,46,27,19,-19,-0.571428537368774,0.571428537368774,0,1,0,0,-1,1,0,0,0,74,-74,74
Paul Daley,Martin Kampmann,Paul Daley,2009-09-19,1,0,-1,1,2.6,2.857143,-7.62001,7.62001,0,0,10.15999,-10.15999,0,20,54,27,27,-27,-0.257143020629883,0.257143020629883,0,2,0,0,-2,2,0,0,0,171,-171,171
Thiago Alves,Martin Kampmann,Martin Kampmann,2012-03-02,0,1,-1,1,1.533333,2.857143,-7.62001,7.62001,0,0,-5.080002,5.080002,151,149,38,27,11,-11,-1.32380962371826,1.32380962371826,0,0,1,1,0,0,0,0,279,895,-616,616
Jake Ellenberger,Martin Kampmann,Martin Kampmann,2012-06-01,0,1,-3,3,2.066667,2.857143,-7.62001,7.62001,0,0,-2.540009,2.540009,248,29,46,27,19,-19,-0.790476322174072,0.790476322174072,5,1,0,1,4,-4,-1,1,107,91,16,-16
Johny Hendricks,Martin Kampmann,Johny Hendricks,2012-11-17,1,0,-1,1,2.25,2.857143,-7.62001,7.62001,15,-15,-7.62001,7.62001,2,0,26,27,-1,1,-0.607142925262451,0.607142925262451,3,2,0,1,1,-1,-1,1,196,169,27,-27
Carlos Condit,Martin Kampmann,Carlos Condit,2013-08-28,1,0,-2,2,2.285714,2.857143,5.080002,-5.080002,0,0,7.619995,-7.619995,76,323,46,27,19,-19,-0.571428537368774,0.571428537368774,0,0,0,2,0,0,-2,2,165,284,-119,119
Vitor Belfort,Marvin Eastman,Vitor Belfort,2003-06-06,1,0,-5,5,1.857143,1.2,7.62001,-7.62001,0,0,2.540009,-2.540009,3,0,40,33,7,-7,0.657142758369446,-0.657142758369446,0,0,1,0,0,0,1,-1,349,0,349,-349
Alberto Uda,Marvin Vettori,Marvin Vettori,2016-08-20,0,1,10,-10,6,2.714286,7.619995,-7.619995,0,0,5.039993,-5.039993,212,26,14,26,-12,12,3.28571438789368,-3.28571438789368,0,0,0,0,0,0,0,0,0,0,0,0
Antonio Carlos Junior,Marvin Vettori,Antonio Carlos Junior,2016-12-30,1,0,3,-3,2.2,2.714286,5.080002,-5.080002,0,0,12.7,-12.7,334,179,16,26,-10,10,-0.514285564422607,0.514285564422607,1,1,1,0,0,0,1,-1,104,132,-28,28
Vitor Miranda,Marvin Vettori,Marvin Vettori,2017-06-25,0,1,15,-15,2.4,2.714286,2.539993,-2.539993,0,0,7.619995,-7.619995,13,225,17,26,-9,9,-0.314285516738892,0.314285516738892,0,0,0,0,0,0,0,0,0,177,-177,177
Israel Adesanya,Marvin Vettori,Israel Adesanya,2018-04-14,1,0,4,-4,8,2.714286,10.15999,-10.15999,0,0,15.23999,-15.23999,0,198,27,26,1,-1,5.28571438789368,-5.28571438789368,1,1,0,0,0,0,0,0,63,293,-230,230
Cezar Ferreira,Marvin Vettori,Marvin Vettori,2019-07-13,0,1,9,-9,1.625,2.714286,2.539993,-2.539993,0,0,10.15999,-10.15999,9,154,21,26,-5,5,-1.08928561210632,1.08928561210632,0,0,1,0,0,0,1,-1,238,455,-217,217
Andrew Sanchez,Marvin Vettori,Marvin Vettori,2019-10-12,0,1,5,-5,1.857143,2.714286,2.539993,-2.539993,0,0,0,0,0,20,20,26,-6,6,-0.857142806053162,0.857142806053162,0,1,1,0,-1,1,1,-1,910,91,819,-819
Karl Roberson,Marvin Vettori,Marvin Vettori,2020-06-13,0,1,3,-3,1.5,2.714286,2.539993,-2.539993,20,-20,0,0,19,125,15,26,-11,11,-1.21428561210632,1.21428561210632,1,2,0,0,-1,1,0,0,336,245,91,-91
Jack Hermansson,Marvin Vettori,Marvin Vettori,2020-12-05,0,1,5,-5,2.875,2.714286,2.539993,-2.539993,0,0,7.619995,-7.619995,28,347,31,26,5,-5,0.160714387893677,-0.160714387893677,3,3,1,0,0,0,1,-1,588,175,413,-413
Kevin Holland,Marvin Vettori,Marvin Vettori,2021-04-10,0,1,1,-1,2.5,2.714286,7.619995,-7.619995,-15,15,17.78,-17.78,3,1201,35,26,9,-9,-0.214285612106323,0.214285612106323,5,4,0,0,1,-1,0,0,119,126,-7,7
Israel Adesanya,Marvin Vettori,Israel Adesanya,2021-06-12,1,0,4,-4,8,2.714286,10.15999,-10.15999,0,0,15.23999,-15.23999,36,415,27,26,1,-1,5.28571438789368,-5.28571438789368,0,5,0,0,-5,5,0,0,98,63,35,-35
Paulo Costa,Marvin Vettori,Marvin Vettori,2021-10-23,0,1,2,-2,7,2.714286,2.539993,-2.539993,0,0,-5.080002,5.080002,47,207,16,26,-10,10,4.28571438789368,-4.28571438789368,4,0,0,0,4,-4,0,0,798,133,665,-665
Roman Dolidze,Marvin Vettori,Marvin Vettori,2023-03-18,0,1,5,-5,6,2.714286,5.080002,-5.080002,0,0,5.079987,-5.079987,14,0,14,26,-12,12,3.28571438789368,-3.28571438789368,3,1,0,0,2,-2,0,0,105,511,-406,406
Jared Cannonier,Marvin Vettori,Jared Cannonier,2023-06-17,1,0,10,-10,2.833333,2.714286,-2.540009,2.540009,0,0,7.619995,-7.619995,187,28,23,26,-3,3,0.11904764175415,-0.11904764175415,2,2,2,0,0,0,2,-2,182,91,91,-91
Valerie Letourneau,Maryna Moroz,Valerie Letourneau,2015-08-23,1,0,9,-9,1.333333,2.2,0,0,-10,10,2.540009,-2.540009,398,0,14,16,-2,2,-0.866666674613953,0.866666674613953,2,0,0,0,2,-2,0,0,120,0,120,-120
Carla Esparza,Maryna Moroz,Carla Esparza,2017-06-25,1,0,4,-4,2.857143,2.2,-15.23999,15.23999,-10,10,-10.15999,10.15999,383,0,27,16,11,-11,0.657142877578735,-0.657142877578735,0,0,1,0,0,0,1,-1,126,672,-546,546
Angela Hill,Maryna Moroz,Angela Hill,2018-02-24,1,0,7,-7,1.153846,2.2,-10.15999,10.15999,-10,10,-7.619995,7.619995,121,31,28,16,12,-12,-1.04615390300751,1.04615390300751,0,0,0,0,0,0,0,0,105,244,-139,139
Sabina Mazo,Maryna Moroz,Maryna Moroz,2019-03-30,0,1,-5,5,2.25,2.2,0,0,0,0,7.62001,-7.62001,0,423,13,16,-3,3,4.99999523162842e-02,-4.99999523162842e-02,0,0,0,0,0,0,0,0,0,399,-399,399
Mayra Bueno Silva,Maryna Moroz,Maryna Moroz,2020-03-14,0,1,0,0,5.5,2.2,-2.539993,2.539993,10,-10,-2.539993,2.539993,45,269,13,16,-3,3,3.29999995231628,-3.29999995231628,1,1,0,0,0,0,0,0,539,350,189,-189
Mariya Agapova,Maryna Moroz,Maryna Moroz,2022-03-05,0,1,-6,6,2.5,2.2,-2.539993,2.539993,0,0,2.540009,-2.540009,40,403,14,16,-2,2,0.299999952316284,-0.299999952316284,1,2,1,0,-1,1,1,-1,147,721,-574,574
Jennifer Maia,Maryna Moroz,Jennifer Maia,2022-11-19,1,0,3,-3,2.333333,2.2,-7.619995,7.619995,0,0,-7.619995,7.619995,104,0,30,16,14,-14,0.133333206176758,-0.133333206176758,0,3,0,0,-3,3,0,0,728,259,469,-469
Alex Caceres,Masanori Kanehara,Masanori Kanehara,2014-09-20,0,1,-5,5,1.5,2.166667,7.62001,-7.62001,10,-10,15.24001,-15.24001,36,452,35,38,-3,3,-0.666666746139526,0.666666746139526,0,0,0,0,0,0,0,0,77,0,77,-77
Makwan Amirkhani,Masio Fullen,Makwan Amirkhani,2015-06-20,1,0,-2,2,1.888889,1.571429,0,0,0,0,5.080002,-5.080002,79,0,26,18,8,-8,0.317460298538208,-0.317460298538208,1,0,0,0,1,-1,0,0,147,0,147,-147
Alex Caceres,Masio Fullen,Alex Caceres,2016-01-30,1,0,-2,2,1.5,1.571429,0,0,0,0,7.619995,-7.619995,107,5,35,18,17,-17,-7.14285373687744e-02,7.14285373687744e-02,0,0,1,0,0,0,1,-1,238,224,14,-14
Mike Davis,Mason Jones,Mike Davis,2021-01-20,1,0,3,-3,5,5.5,5.080002,-5.080002,0,0,-5.080002,5.080002,50,51,12,13,-1,1,-0.5,0.5,1,0,0,0,1,-1,0,0,466,0,466,-466
Katsuhisa Fujii,Masutatsu Yano,Katsuhisa Fujii,1999-11-19,1,0,3,-3,0.5,0.5,7.62001,-7.62001,7,-7,8,-8,3,122,27,6,21,-21,0,0,0,0,0,0,0,0,0,0,0,0,0,0
Javid Basharat,Mateus Mendonca,Javid Basharat,2023-01-14,1,0,4,-4,14,10,7.619995,-7.619995,10,-10,-5.080002,5.080002,319,139,14,11,3,-3,4,-4,2,0,0,0,2,-2,0,0,119,0,119,-119
Diego Ferreira,Mateusz Gamrot,Mateusz Gamrot,2021-12-18,0,1,5,-5,3.6,11.5,-2.540009,2.540009,0,0,10.16,-10.16,0,65,23,25,-2,2,-7.90000009536743,7.90000009536743,0,0,2,0,0,0,2,-2,224,0,224,-224
Beneil Dariush,Mateusz Gamrot,Beneil Dariush,2022-10-22,1,0,2,-2,4.4,11.5,0,0,0,0,5.080002,-5.080002,34,127,27,25,2,-2,-7.09999990463257,7.09999990463257,6,1,2,0,5,-5,2,-2,525,308,217,-217
Rafael Fiziev,Mateusz Gamrot,Mateusz Gamrot,2023-09-23,0,1,-2,2,4,11.5,-5.080002,5.080002,0,0,2.539993,-2.539993,0,88,15,25,-10,10,-7.5,7.5,0,0,1,0,0,0,1,-1,189,336,-147,147
Nick Fiore,Mateusz Rebecki,Mateusz Rebecki,2023-01-14,0,1,-5,5,3,18,7.62001,-7.62001,0,0,15.24001,-15.24001,34,507,8,19,-11,11,-15,15,0,0,0,0,0,0,0,0,0,0,0,0
Loik Radzhabov,Mateusz Rebecki,Mateusz Rebecki,2023-06-24,0,1,2,-2,3.4,18,10.16,-10.16,0,0,7.619995,-7.619995,3,117,22,19,3,-3,-14.5999999046326,14.5999999046326,1,1,0,0,0,0,0,0,112,161,-49,49
Bruno Korea,Matheus Nicolau,Matheus Nicolau,2015-11-07,0,1,2,-2,2.333333,4.75,0,0,10,-10,-2.539993,2.539993,0,397,10,23,-13,13,-2.41666674613953,2.41666674613953,0,0,0,0,0,0,0,0,0,0,0,0
John Moraga,Matheus Nicolau,Matheus Nicolau,2016-07-08,0,1,9,-9,2.714286,4.75,0,0,0,0,0,0,0,43,26,23,3,-3,-2.03571438789368,2.03571438789368,2,1,0,0,1,-1,0,0,672,244,428,-428
Manel Kape,Matheus Nicolau,Matheus Nicolau,2021-03-13,0,1,-1,1,3.166667,4.75,-2.539993,2.539993,0,0,5.080002,-5.080002,38,151,25,23,2,-2,-1.58333325386047,1.58333325386047,0,2,0,0,-2,2,0,0,35,1709,-1674,1674
Tim Elliott,Matheus Nicolau,Matheus Nicolau,2021-10-09,0,1,6,-6,1.666667,4.75,2.539993,-2.539993,0,0,0,0,148,128,32,23,9,-9,-3.08333337306976,3.08333337306976,1,3,0,0,-2,2,0,0,217,210,7,-7
David Dvorak,Matheus Nicolau,Matheus Nicolau,2022-03-26,0,1,0,0,3.333333,4.75,-2.539993,2.539993,0,0,5.080002,-5.080002,85,48,26,23,3,-3,-1.41666674613953,1.41666674613953,3,4,0,0,-1,1,0,0,308,168,140,-140
Luke Barnatt,Mats Nilsson,Luke Barnatt,2014-03-08,1,0,-5,5,3.25,2.75,12.7,-12.7,15,-15,7.580002,-7.580002,1,2,17,15,2,-2,0.5,-0.5,2,0,0,0,2,-2,0,0,133,0,133,-133
Omari Akhmedov,Mats Nilsson,Omari Akhmedov,2015-01-03,1,0,-4,4,3.5,2.75,-2.539993,2.539993,15,-15,-2.580002,2.580002,281,176,27,15,12,-12,0.75,-0.75,0,0,0,1,0,0,-1,1,301,301,0,0
Enrique Barzola,Matt Bessette,Enrique Barzola,2018-01-20,1,0,-5,5,3.4,2.444444,-7.62001,7.62001,0,0,0,0,274,0,22,31,-9,9,0.95555567741394,-0.95555567741394,1,0,0,0,1,-1,0,0,252,0,252,-252
Matt Arroyo,Matt Brown,Matt Brown,2008-06-21,0,1,-2,2,1,1.368421,-5.080002,5.080002,0,0,-7.619995,7.619995,108,208,6,45,-39,39,-0.368421077728271,0.368421077728271,1,0,0,0,1,-1,0,0,196,0,196,-196
Ricardo Almeida,Matt Brown,Ricardo Almeida,2010-03-27,1,0,4,-4,2.6,1.368421,0,0,0,0,-2.539993,2.539993,426,16,18,45,-27,27,1.2315788269043,-1.2315788269043,2,1,1,0,1,-1,1,-1,231,644,-413,413
Seth Baczynski,Matt Brown,Seth Baczynski,2011-11-19,1,0,0,0,1.428571,1.368421,7.619995,-7.619995,0,0,0,0,163,56,34,45,-11,11,6.01503849029541e-02,-6.01503849029541e-02,1,0,0,0,1,-1,0,0,63,602,-539,539
Miguel Baeza,Matt Brown,Miguel Baeza,2020-05-16,1,0,-12,12,3.333333,1.368421,5.080002,-5.080002,0,0,-2.539993,2.539993,57,10,13,45,-32,32,1.9649121761322,-1.9649121761322,0,0,0,0,0,0,0,0,0,3101,-3101,3101
Bryan Barberena,Matt Brown,Bryan Barberena,2022-03-26,1,0,-9,9,1.636364,1.368421,0,0,0,0,-7.619995,7.619995,57,301,29,45,-16,16,0.267942547798157,-0.267942547798157,1,0,2,1,1,-1,1,-1,112,679,-567,567
Randy Brown,Matt Dwyer,Randy Brown,2016-01-30,1,0,-1,1,3.4,2.25,-2.539993,2.539993,0,0,5.080002,-5.080002,209,172,22,13,9,-9,1.15000009536743,-1.15000009536743,0,0,0,0,0,0,0,0,0,0,0,0
Ottman Azaitar,Matt Frevola,Matt Frevola,2022-11-12,0,1,0,0,6.5,3.666667,-2.539993,2.539993,0,0,0,0,0,2,15,14,1,-1,2.83333325386047,-2.83333325386047,2,0,0,0,2,-2,0,0,791,0,791,-791
Drew Dober,Matt Frevola,Matt Frevola,2023-05-06,0,1,2,-2,2.166667,3.666667,-2.539993,2.539993,0,0,-2.539993,2.539993,0,8,38,14,24,-24,-1.5,1.5,2,1,0,0,1,-1,0,0,140,175,-35,35
Terry Etim,Matt Grice,Terry Etim,2007-04-21,1,0,-4,4,3.2,3,12.7,-12.7,10,-10,7.619995,-7.619995,29,227,21,20,1,-1,0.200000047683716,-0.200000047683716,0,0,0,0,0,0,0,0,0,0,0,0
Jason Black,Matt Grice,Matt Grice,2007-10-20,0,1,9,-9,5.75,3,0,0,10,-10,-2.800003,2.800003,36,764,27,20,7,-7,2.75,-2.75,0,0,0,0,0,0,0,0,130,182,-52,52
Leonard Garcia,Matt Grice,Matt Grice,2012-06-08,0,1,2,-2,1.384615,3,5.080002,-5.080002,0,0,-5.080002,5.080002,0,579,31,20,11,-11,-1.61538457870483,1.61538457870483,0,1,0,0,-1,1,0,0,244,1693,-1449,1449
Dennis Bermudez,Matt Grice,Dennis Bermudez,2013-02-23,1,0,-5,5,1.888889,3,-5.080002,5.080002,10,-10,-10.16,10.16,324,135,26,20,6,-6,-1.11111116409302,1.11111116409302,2,2,0,0,0,0,0,0,196,260,-64,64
Jesse Forbes,Matt Hamill,Matt Hamill,2006-06-24,0,1,-8,8,3,1.5,2.540009,-2.540009,-20,20,-2.539993,2.539993,0,175,20,20,0,0,1.5,-1.5,0,0,0,0,0,0,0,0,0,0,0,0
Michael Bisping,Matt Hamill,Michael Bisping,2007-09-08,1,0,-2,2,3.333333,1.5,0,0,-20,20,-2.539993,2.539993,1,248,39,20,19,-19,1.83333325386047,-1.83333325386047,3,1,0,0,2,-2,0,0,140,441,-301,301
Tim Boetsch,Matt Hamill,Matt Hamill,2008-04-02,0,1,-4,4,1.615385,1.5,-2.539993,2.539993,-20,20,-5.079987,5.079987,2,157,34,20,14,-14,0.115384578704834,-0.115384578704834,1,0,0,0,1,-1,0,0,60,207,-147,147
Rich Franklin,Matt Hamill,Rich Franklin,2008-09-06,1,0,2,-2,4.142857,1.5,0,0,-20,20,0,0,4,32,36,20,16,-16,2.64285707473755,-2.64285707473755,1,1,2,0,0,0,2,-2,140,157,-17,17
Reese Andy,Matt Hamill,Matt Hamill,2008-12-27,0,1,3,-3,2.333333,1.5,-2.539993,2.539993,0,0,-6.5,6.5,0,25,10,20,-10,10,0.833333253860474,-0.833333253860474,0,0,0,1,0,0,-1,1,161,112,49,-49
Alexander Gustafsson,Matt Hamill,Alexander Gustafsson,2011-08-06,1,0,-10,10,2.25,1.5,10.16,-10.16,0,0,7.62001,-7.62001,22,0,26,20,6,-6,0.75,-0.75,2,1,0,1,1,-1,-1,1,161,952,-791,791
Ricardo Almeida,Matt Horwich,Ricardo Almeida,2009-04-01,1,0,2,-2,2.6,1.2,-2.539993,2.539993,-15,15,-3.039993,3.039993,501,124,18,55,-37,37,1.39999985694885,-1.39999985694885,0,0,1,0,0,0,1,-1,270,0,270,-270
Marcelo Aguiar,Matt Hughes,Matt Hughes,2000-06-09,0,1,,,0.6666667,5,2.540009,-2.540009,0,0,-5.419998,5.419998,0,248,5,54,-49,49,-4.33333331346512,4.33333331346512,0,0,0,0,0,0,0,0,0,0,0,0
Dennis Hallman,Matt Hughes,Dennis Hallman,2000-12-16,1,0,-2,2,2.65,5,0,0,-15,15,-2.539993,2.539993,0,11,73,54,19,-19,-2.34999990463257,2.34999990463257,0,1,0,0,-1,1,0,0,0,190,-190,190
Gil Castillo,Matt Hughes,Matt Hughes,2002-11-22,0,1,8,-8,1.6,5,0,0,0,0,-5.419998,5.419998,0,244,13,54,-41,41,-3.39999997615814,3.39999997615814,0,0,0,0,0,0,0,0,420,706,-286,286
Royce Gracie,Matt Hughes,Matt Hughes,2006-05-27,0,1,7,-7,7.5,5,10.16,-10.16,5,-5,8.580002,-8.580002,0,206,17,54,-37,37,2.5,-2.5,7,1,0,0,6,-6,0,0,4180,1282,2898,-2898
Thiago Alves,Matt Hughes,Thiago Alves,2008-06-07,1,0,-10,10,1.533333,5,0,0,0,0,-7.619995,7.619995,87,183,38,54,-16,16,-3.46666669845581,3.46666669845581,4,2,1,0,2,-2,1,-1,66,742,-676,676
Renzo Gracie,Matt Hughes,Matt Hughes,2010-04-10,0,1,7,-7,1.857143,5,2.540009,-2.540009,15,-15,-5.419998,5.419998,0,104,20,54,-34,34,-3.14285719394684,3.14285719394684,0,0,0,1,0,0,-1,1,0,672,-672,672
Ricardo Almeida,Matt Hughes,Matt Hughes,2010-08-07,0,1,-3,3,2.6,5,7.62001,-7.62001,0,0,2.540009,-2.540009,0,13,18,54,-36,36,-2.40000009536743,2.40000009536743,3,1,1,1,2,-2,0,0,133,119,14,-14
Yoji Anjo,Matt Lindland,Matt Lindland,2000-12-16,0,1,3,-3,0,2.444444,-2.540009,2.540009,20,-20,-4.01001,4.01001,12,126,5,31,-26,26,-2.44444441795349,2.44444441795349,0,0,0,0,0,0,0,0,246,0,246,-246
Ricardo Almeida,Matt Lindland,Matt Lindland,2001-05-04,0,1,-6,6,2.6,2.444444,0,0,-15,15,0,0,0,734,18,31,-13,13,0.155555486679077,-0.155555486679077,0,1,0,0,-1,1,0,0,0,139,-139,139
Phil Baroni,Matt Lindland,Matt Lindland,2001-11-02,0,1,-6,6,0.8333333,2.444444,-7.62001,7.62001,-15,15,-5.080002,5.080002,148,623,33,31,2,-2,-1.61111110448837,1.61111110448837,1,2,0,0,-1,1,0,0,252,182,70,-70
Murilo Bustamante,Matt Lindland,Murilo Bustamante,2002-05-10,1,0,4,-4,1.875,2.444444,5.080002,-5.080002,-2,2,3.039993,-3.039993,191,297,23,31,-8,8,-0.569444417953491,0.569444417953491,1,3,0,0,-2,2,0,0,119,189,-70,70
Phil Baroni,Matt Lindland,Matt Lindland,2003-02-28,0,1,-6,6,0.8333333,2.444444,-7.62001,7.62001,-15,15,-5.080002,5.080002,48,612,33,31,2,-2,-1.61111110448837,1.61111110448837,2,0,0,0,2,-2,0,0,154,294,-140,140
Joe Doerksen,Matt Lindland,Matt Lindland,2005-08-20,0,1,-8,8,3.1875,2.444444,0,0,0,0,2.539993,-2.539993,82,724,67,31,36,-36,0.743055582046509,-0.743055582046509,0,1,1,0,-1,1,1,-1,364,904,-540,540
Marcus Jones,Matt Mitrione,Matt Mitrione,2009-12-05,0,1,5,-5,2,2.4,7.619995,-7.619995,0,0,-7.279999,7.279999,161,63,6,17,-11,11,-0.400000095367432,0.400000095367432,0,0,0,0,0,0,0,0,0,0,0,0
Kevin Ferguson,Matt Mitrione,Matt Mitrione,2010-05-08,0,1,5,-5,2.5,2.4,-2.539993,2.539993,-30,30,-12.7,12.7,212,197,7,17,-10,10,9.99999046325684e-02,-9.99999046325684e-02,0,1,0,0,-1,1,0,0,0,154,-154,154
Joey Beltran,Matt Mitrione,Matt Mitrione,2010-09-25,0,1,-4,4,1.214286,2.4,-5.080002,5.080002,-80,80,-17.78,17.78,301,0,31,17,14,-14,-1.18571436405182,1.18571436405182,2,2,0,0,0,0,0,0,140,140,0,0
Tim Hague,Matt Mitrione,Matt Mitrione,2011-01-22,0,1,-5,5,1.615385,2.4,2.539993,-2.539993,-5,5,-15.24001,15.24001,33,14,34,17,17,-17,-0.784615516662598,0.784615516662598,0,3,0,0,-3,3,0,0,350,119,231,-231
Cheick Kongo,Matt Mitrione,Cheick Kongo,2011-10-29,1,0,3,-3,2.7,2.4,2.539993,-2.539993,-25,25,0,0,330,2,37,17,20,-20,0.299999952316284,-0.299999952316284,0,4,0,0,-4,4,0,0,686,280,406,-406
Philip De Fries,Matt Mitrione,Matt Mitrione,2013-04-06,0,1,-8,8,2,2.4,5.080002,-5.080002,-15,15,-7.619995,7.619995,0,3,18,17,1,-1,-0.400000095367432,0.400000095367432,0,0,2,0,0,0,2,-2,98,525,-427,427
Shawn Jordan,Matt Mitrione,Matt Mitrione,2014-03-01,0,1,-6,6,2.375,2.4,-7.619995,7.619995,-5,5,-17.78,17.78,27,21,27,17,10,-10,-2.50000953674316e-02,2.50000953674316e-02,1,1,0,0,0,0,0,0,399,329,70,-70
Derrick Lewis,Matt Mitrione,Matt Mitrione,2014-09-05,0,1,-7,7,2.454545,2.4,0,0,-5,5,-7.619995,7.619995,0,7,38,17,21,-21,5.45454025268555e-02,-5.45454025268555e-02,1,2,0,0,-1,1,0,0,139,188,-49,49
Gabriel Gonzaga,Matt Mitrione,Matt Mitrione,2014-12-13,0,1,-1,1,1.545455,2.4,-2.539993,2.539993,-23,23,-15.24001,15.24001,0,7,28,17,11,-11,-0.854545593261719,0.854545593261719,0,3,1,0,-3,3,1,-1,322,99,223,-223
Travis Browne,Matt Mitrione,Travis Browne,2016-01-17,1,0,-4,4,2.571429,2.4,7.619995,-7.619995,-10,10,-7.619995,7.619995,166,0,25,17,8,-8,0.171428442001343,-0.171428442001343,1,4,1,0,-3,3,1,-1,407,400,7,-7
Sheymon Moraes,Matt Sayles,Sheymon Moraes,2018-08-04,1,0,3,-3,2.75,2,2.540009,-2.540009,-10,10,10.16,-10.16,3,67,15,12,3,-3,0.75,-0.75,0,0,0,0,0,0,0,0,0,0,0,0
Kyle Nelson,Matt Sayles,Matt Sayles,2019-05-04,0,1,3,-3,3,2,10.16,-10.16,-10,10,7.619995,-7.619995,227,167,20,12,8,-8,1,-1,0,0,0,0,0,0,0,0,0,273,-273,273
Bryce Mitchell,Matt Sayles,Bryce Mitchell,2019-12-07,1,0,0,0,8,2,7.62001,-7.62001,-10,10,5.080002,-5.080002,240,0,18,12,6,-6,6,-6,1,1,0,0,0,0,0,0,259,217,42,-42
Jordan Leavitt,Matt Sayles,Jordan Leavitt,2021-12-18,1,0,-1,1,5.5,2,5.080002,-5.080002,0,0,7.619995,-7.619995,168,74,13,12,1,-1,3.5,-3.5,0,0,0,0,0,0,0,0,196,742,-546,546
Rob Font,Matt Schnell,Rob Font,2016-12-03,1,0,3,-3,2.857143,2.285714,0,0,10,-10,2.539993,-2.539993,130,0,27,23,4,-4,0.571428537368774,-0.571428537368774,0,0,0,0,0,0,0,0,203,0,203,-203
Hector Sandoval,Matt Schnell,Hector Sandoval,2017-04-22,1,0,3,-3,3.5,2.285714,-15.24001,15.24001,0,0,-15.24001,15.24001,58,6,18,23,-5,5,1.21428561210632,-1.21428561210632,1,0,0,1,1,-1,-1,1,126,140,-14,14
Marco Beltran,Matt Schnell,Matt Schnell,2017-10-07,0,1,4,-4,1.333333,2.285714,0,0,0,0,-2.540009,2.540009,12,16,14,23,-9,9,-0.952381014823914,0.952381014823914,0,0,1,2,0,0,-1,1,126,168,-42,42
Naoki Inoue,Matt Schnell,Matt Schnell,2018-06-23,0,1,-7,7,11,2.285714,2.539993,-2.539993,0,0,2.539993,-2.539993,37,0,12,23,-11,11,8.71428561210632,-8.71428561210632,1,1,0,2,0,0,-2,2,371,259,112,-112
Jordan Espinosa,Matt Schnell,Matt Schnell,2019-08-03,0,1,0,0,1.666667,2.285714,-5.080002,5.080002,0,0,-2.540009,2.540009,25,0,24,23,1,-1,-0.61904776096344,0.61904776096344,1,2,0,2,-1,1,-2,2,133,406,-273,273
Alexandre Pantoja,Matt Schnell,Alexandre Pantoja,2019-12-21,1,0,0,0,5.2,2.285714,-7.619995,7.619995,0,0,-7.62001,7.62001,74,0,31,23,8,-8,2.91428542137146,-2.91428542137146,4,3,0,2,1,-1,-2,2,252,140,112,-112
Tyson Nam,Matt Schnell,Matt Schnell,2021-01-20,0,1,6,-6,1.5,2.285714,-2.540009,2.540009,0,0,-5.080002,5.080002,0,0,35,23,12,-12,-0.785714387893677,0.785714387893677,1,0,0,3,1,-1,-3,3,123,396,-273,273
Brandon Royval,Matt Schnell,Brandon Royval,2022-05-07,1,0,-3,3,2.5,2.285714,2.539993,-2.539993,0,0,-5.080002,5.080002,13,54,21,23,-2,2,0.214285612106323,-0.214285612106323,0,1,0,3,-1,1,-3,3,0,472,-472,472
Matheus Nicolau,Matt Schnell,Matheus Nicolau,2022-12-03,1,0,-3,3,4.75,2.285714,-5.080002,5.080002,0,0,-10.16,10.16,47,0,23,23,0,0,2.46428561210632,-2.46428561210632,0,0,1,3,0,0,-2,2,1589,210,1379,-1379
Shonie Carter,Matt Serra,Shonie Carter,2001-05-04,1,0,3,-3,1.645161,1.571429,10.16,-10.16,0,0,5.279999,-5.279999,363,271,82,18,64,-64,7.37327337265015e-02,-7.37327337265015e-02,2,0,0,0,2,-2,0,0,329,0,329,-329
Yves Edwards,Matt Serra,Matt Serra,2001-09-28,0,1,-3,3,1.909091,1.571429,7.619995,-7.619995,-15,15,12.7,-12.7,123,509,64,18,46,-46,0.33766233921051,-0.33766233921051,0,0,0,1,0,0,-1,1,0,147,-147,147
Kelly Dullanty,Matt Serra,Matt Serra,2002-03-22,0,1,-3,3,2,1.571429,5.080002,-5.080002,-15,15,2.279999,-2.279999,11,142,6,18,-12,12,0.428571462631226,-0.428571462631226,0,1,0,1,-1,1,-1,1,0,175,-175,175
BJ Penn,Matt Serra,BJ Penn,2002-09-27,1,0,-5,5,1.142857,1.571429,7.619995,-7.619995,-15,15,5.080002,-5.080002,55,258,30,18,12,-12,-0.428571343421936,0.428571343421936,0,2,0,1,-2,2,-1,1,259,189,70,-70
Jeff Curran,Matt Serra,Matt Serra,2004-01-31,0,1,-3,3,2,1.571429,0,0,-35,35,2.539993,-2.539993,20,790,54,18,36,-36,0.428571462631226,-0.428571462631226,0,0,0,1,0,0,-1,1,0,491,-491,491
Ivan Menjivar,Matt Serra,Matt Serra,2004-06-19,0,1,-8,8,2.083333,1.571429,0,0,-25,25,-10.16,10.16,7,798,37,18,19,-19,0.511904716491699,-0.511904716491699,0,1,0,1,-1,1,-1,1,0,140,-140,140
Karo Parisyan,Matt Serra,Karo Parisyan,2005-06-04,1,0,-9,9,2.181818,1.571429,10.16,-10.16,0,0,10.16,-10.16,362,56,35,18,17,-17,0.610389709472656,-0.610389709472656,0,2,0,1,-2,2,-1,1,490,350,140,-140
Chris Lytle,Matt Serra,Matt Serra,2006-11-11,0,1,0,0,1.722222,1.571429,12.7,-12.7,0,0,0,0,84,493,49,18,31,-31,0.150793671607971,-0.150793671607971,0,0,1,1,0,0,0,0,400,525,-125,125
Matt Hughes,Matt Serra,Matt Hughes,2009-05-23,1,0,1,-1,5,1.571429,7.619995,-7.619995,0,0,12.7,-12.7,495,53,54,18,36,-36,3.42857146263123,-3.42857146263123,0,1,1,1,-1,1,0,0,511,924,-413,413
Chris Lytle,Matt Serra,Chris Lytle,2010-09-25,1,0,0,0,1.722222,1.571429,12.7,-12.7,0,0,0,0,0,0,49,18,31,-31,0.150793671607971,-0.150793671607971,1,0,1,1,1,-1,0,0,707,490,217,-217
Corey Anderson,Matt Van Buren,Corey Anderson,2014-07-06,1,0,-4,4,2.8,1.166667,-5.080002,5.080002,0,0,2.660004,-2.660004,19,0,19,13,6,-6,1.63333332538605,-1.63333332538605,0,0,0,0,0,0,0,0,0,0,0,0
"Sean O'Connell",Matt Van Buren,"Sean O'Connell",2015-01-18,1,0,3,-3,1.888889,1.166667,-10.16,10.16,0,0,-10.03999,10.03999,209,26,26,13,13,-13,0.722222208976746,-0.722222208976746,0,0,0,1,0,0,-1,1,204,196,8,-8
Matt Grice,Matt Veach,Matt Veach,2009-02-07,0,1,0,0,3,3.4,-7.619995,7.619995,-10,10,-5.199997,5.199997,101,84,20,22,-2,2,-0.400000095367432,0.400000095367432,0,0,0,0,0,0,0,0,0,0,0,0
Frankie Edgar,Matt Veach,Frankie Edgar,2009-12-05,1,0,0,0,2.090909,3.4,-12.7,12.7,-20,20,-10.28,10.28,37,120,34,22,12,-12,-1.30909109115601,1.30909109115601,2,1,0,0,1,-1,0,0,196,301,-105,105
Paul Kelly,Matt Veach,Paul Kelly,2010-04-10,1,0,-3,3,2.8,3.4,-5.080002,5.080002,0,0,-5.199997,5.199997,325,146,19,22,-3,3,-0.600000143051147,0.600000143051147,0,0,1,0,0,0,1,-1,147,126,21,-21
Spencer Fisher,Matt Wiman,Spencer Fisher,2006-05-27,1,0,8,-8,2.666667,1.6,-7.62001,7.62001,0,0,0,0,118,204,33,26,7,-7,1.06666672229767,-1.06666672229767,0,0,0,0,0,0,0,0,84,0,84,-84
Brian Geraghty,Matt Wiman,Matt Wiman,2007-06-23,0,1,3,-3,1.444444,1.6,-7.62001,7.62001,0,0,0.2799988,-0.2799988,0,104,44,26,18,-18,-0.155555605888367,0.155555605888367,0,0,0,1,0,0,-1,1,0,392,-392,392
Michihiro Omigawa,Matt Wiman,Matt Wiman,2007-09-22,0,1,7,-7,1.214286,1.6,-10.16,10.16,-10,10,0,0,111,686,31,26,5,-5,-0.385714292526245,0.385714292526245,0,1,0,1,-1,1,-1,1,0,91,-91,91
Justin Buchholz,Matt Wiman,Matt Wiman,2008-01-23,0,1,0,0,1.5,1.6,5.080002,-5.080002,0,0,12.7,-12.7,0,160,25,26,-1,1,-0.100000023841858,0.100000023841858,0,2,0,1,-2,2,-1,1,0,123,-123,123
Thiago Tavares,Matt Wiman,Matt Wiman,2008-06-07,0,1,-1,1,3,1.6,-7.62001,7.62001,-10,10,5.080002,-5.080002,261,73,28,26,2,-2,1.39999997615814,-1.39999997615814,0,3,0,1,-3,3,-1,1,0,136,-136,136
Jim Miller,Matt Wiman,Jim Miller,2008-12-10,1,0,0,0,2.117647,1.6,-5.080002,5.080002,0,0,7.619995,-7.619995,638,50,53,26,27,-27,0.51764714717865,-0.51764714717865,0,4,0,1,-4,4,-1,1,0,186,-186,186
Sam Stout,Matt Wiman,Sam Stout,2009-04-18,1,0,-1,1,1.666667,1.6,-2.540009,2.540009,0,0,5.080002,-5.080002,161,267,32,26,6,-6,6.66666030883789e-02,-6.66666030883789e-02,0,0,0,1,0,0,-1,1,0,129,-129,129
Shane Nelson,Matt Wiman,Matt Wiman,2009-12-12,0,1,-1,1,2.285714,1.6,-2.540009,2.540009,0,0,5.080002,-5.080002,78,338,23,26,-3,3,0.685714364051819,-0.685714364051819,0,0,0,1,0,0,-1,1,126,238,-112,112
Mac Danzig,Matt Wiman,Matt Wiman,2010-06-12,0,1,4,-4,1.75,1.6,-5.080002,5.080002,0,0,5.080002,-5.080002,57,24,33,26,7,-7,0.149999976158142,-0.149999976158142,0,1,0,1,-1,1,-1,1,336,182,154,-154
Cole Miller,Matt Wiman,Matt Wiman,2011-01-22,0,1,-1,1,1.909091,1.6,7.619995,-7.619995,-10,10,12.7,-12.7,3,660,32,26,6,-6,0.309090852737427,-0.309090852737427,1,2,1,1,-1,1,0,0,129,224,-95,95
Dennis Siver,Matt Wiman,Dennis Siver,2011-07-02,1,0,5,-5,2.090909,1.6,-10.16,10.16,-10,10,5.080002,-5.080002,88,454,34,26,8,-8,0.490908980369568,-0.490908980369568,2,3,0,1,-1,1,-1,1,126,161,-35,35
Mac Danzig,Matt Wiman,Matt Wiman,2011-10-01,0,1,3,-3,1.75,1.6,-5.080002,5.080002,0,0,5.080002,-5.080002,297,245,33,26,7,-7,0.149999976158142,-0.149999976158142,1,0,0,1,1,-1,-1,1,294,91,203,-203
Paul Sass,Matt Wiman,Matt Wiman,2012-09-29,0,1,-5,5,7,1.6,5.080002,-5.080002,0,0,12.7,-12.7,175,40,16,26,-10,10,5.39999997615814,-5.39999997615814,1,1,0,1,0,0,-1,1,126,364,-238,238
TJ Grant,Matt Wiman,TJ Grant,2013-01-26,1,0,-1,1,4.2,1.6,0,0,0,0,10.16,-10.16,70,0,26,26,0,0,2.59999978542328,-2.59999978542328,3,2,0,1,1,-1,-1,1,256,119,137,-137
Isaac Vallie-Flagg,Matt Wiman,Matt Wiman,2014-11-22,0,1,5,-5,2.285714,1.6,-5.080002,5.080002,0,0,5.080002,-5.080002,336,305,23,26,-3,3,0.685714364051819,-0.685714364051819,0,0,0,2,0,0,-2,2,0,665,-665,665
Luis Pena,Matt Wiman,Luis Pena,2019-06-22,1,0,-10,10,3,1.6,12.7,-12.7,0,0,17.78,-17.78,453,14,12,26,-14,14,1.39999997615814,-1.39999997615814,1,1,0,2,0,0,-2,2,91,1673,-1582,1582
Joe Solecki,Matt Wiman,Joe Solecki,2019-12-07,1,0,-10,10,4.333333,1.6,-2.540009,2.540009,0,0,5.080002,-5.080002,749,6,16,26,-10,10,2.73333346843719,-2.73333346843719,0,0,0,3,0,0,-3,3,0,168,-168,168
Jordan Leavitt,Matt Wiman,Jordan Leavitt,2020-12-05,1,0,-12,12,5.5,1.6,-2.540009,2.540009,0,0,7.619995,-7.619995,0,0,13,26,-13,13,3.89999997615814,-3.89999997615814,0,0,0,3,0,0,-3,3,0,364,-364,364
Mitch Gagnon,Matthew Lopez,Matthew Lopez,2016-12-10,0,1,3,-3,2.4,2.5,-5.079987,5.079987,0,0,-10.15999,10.15999,124,557,17,14,3,-3,-9.99999046325684e-02,9.99999046325684e-02,4,0,0,0,4,-4,0,0,798,0,798,-798
Johnny Eduardo,Matthew Lopez,Matthew Lopez,2017-06-03,0,1,8,-8,2.153846,2.5,0,0,0,0,5.080002,-5.080002,0,76,41,14,27,-27,-0.346153736114502,0.346153736114502,1,1,0,0,0,0,0,0,196,175,21,-21
Raphael Assuncao,Matthew Lopez,Raphael Assuncao,2017-11-11,1,0,5,-5,2.8,2.5,-5.079987,5.079987,0,0,-7.619995,7.619995,1,29,38,14,24,-24,0.299999952316284,-0.299999952316284,2,2,1,0,0,0,1,-1,161,161,0,0
Brad Katona,Matthew Lopez,Brad Katona,2018-12-08,1,0,-5,5,7.5,2.5,-2.539993,2.539993,0,0,-12.7,12.7,13,55,17,14,3,-3,5,-5,0,0,0,1,0,0,-1,1,0,392,-392,392
Steve Bruno,Matthew Riddle,Matthew Riddle,2009-02-07,0,1,4,-4,2.5,2.666667,-7.619995,7.619995,0,0,-13.03999,13.03999,23,671,21,11,10,-10,-0.166666746139526,0.166666746139526,1,0,0,0,1,-1,0,0,59,0,59,-59
Dan Cramer,Matthew Riddle,Matthew Riddle,2009-08-08,0,1,0,0,2.75,2.666667,2.540009,-2.540009,0,0,-2.039993,2.039993,97,726,15,11,4,-4,8.33332538604736e-02,-8.33332538604736e-02,0,1,0,0,-1,1,0,0,0,182,-182,182
Nick Osipczak,Matthew Riddle,Nick Osipczak,2009-11-14,1,0,1,-1,2,2.666667,2.540009,-2.540009,0,0,0,0,246,345,9,11,-2,2,-0.666666746139526,0.666666746139526,0,2,0,0,-2,2,0,0,0,98,-98,98
DaMarques Johnson,Matthew Riddle,Matthew Riddle,2010-08-01,0,1,4,-4,1,2.666667,0,0,0,0,-2.539993,2.539993,47,403,30,11,19,-19,-1.66666674613953,1.66666674613953,0,0,0,1,0,0,-1,1,407,260,147,-147
Sean Pierson,Matthew Riddle,Sean Pierson,2010-12-11,1,0,10,-10,2.333333,2.666667,-2.539993,2.539993,0,0,0,0,222,44,20,11,9,-9,-0.333333492279053,0.333333492279053,0,1,0,1,-1,1,-1,1,0,132,-132,132
Lance Benoist,Matthew Riddle,Lance Benoist,2011-09-17,1,0,-2,2,3.5,2.666667,-5.080002,5.080002,0,0,-10.15999,10.15999,294,417,9,11,-2,2,0.833333253860474,-0.833333253860474,0,0,0,1,0,0,-1,1,0,280,-280,280
Henry Martinez,Matthew Riddle,Matthew Riddle,2012-02-04,0,1,2,-2,2.25,2.666667,-15.24001,15.24001,-15,15,-17.78,17.78,0,140,13,11,2,-2,-0.416666746139526,0.416666746139526,0,0,0,1,0,0,-1,1,0,140,-140,140
John Maguire,Matthew Riddle,Matthew Riddle,2012-11-17,0,1,3,-3,2.666667,2.666667,-10.16,10.16,-15,15,-17.78,17.78,28,192,33,11,22,-22,0,0,0,1,0,1,-1,1,-1,1,0,287,-287,287
Carlton Minus,Matthew Semelsberger,Matthew Semelsberger,2020-08-22,0,1,0,0,3.333333,1.833333,-7.619995,7.619995,0,0,0,0,0,166,13,17,-4,4,1.49999988079071,-1.49999988079071,0,0,0,0,0,0,0,0,0,0,0,0
Martin Sano,Matthew Semelsberger,Matthew Semelsberger,2021-09-25,0,1,2,-2,1.333333,1.833333,-5.080002,5.080002,0,0,0,0,0,1,7,17,-10,10,-0.5,0.5,0,1,0,0,-1,1,0,0,0,399,-399,399
AJ Fletcher,Matthew Semelsberger,Matthew Semelsberger,2022-03-12,0,1,-4,4,3.333333,1.833333,-7.619995,7.619995,0,0,-20.32001,20.32001,342,295,13,17,-4,4,1.49999988079071,-1.49999988079071,0,2,0,0,-2,2,0,0,0,168,-168,168
Alex Morono,Matthew Semelsberger,Alex Morono,2022-07-30,1,0,2,-2,2.875,1.833333,-5.080002,5.080002,0,0,-7.619995,7.619995,24,158,31,17,14,-14,1.04166662693024,-1.04166662693024,1,3,1,0,-2,2,1,-1,329,140,189,-189
Jake Matthews,Matthew Semelsberger,Matthew Semelsberger,2022-12-17,0,1,-2,2,3.166667,1.833333,-5.080002,5.080002,0,0,-5.080002,5.080002,102,256,25,17,8,-8,1.33333337306976,-1.33333337306976,2,0,0,0,2,-2,0,0,812,140,672,-672
Uros Medic,Matthew Semelsberger,Uros Medic,2023-07-29,1,0,0,0,9,1.833333,0,0,0,0,-10.16,10.16,22,73,10,17,-7,7,7.16666662693024,-7.16666662693024,1,1,0,0,0,0,0,0,434,224,210,-210
Michel Batista,Maurice Greene,Maurice Greene,2018-11-30,0,1,2,-2,4,1.285714,-10.16,10.16,2,-2,-8.199997,8.199997,72,0,5,16,-11,11,2.71428573131561,-2.71428573131561,0,0,0,0,0,0,0,0,0,0,0,0
Junior Albini,Maurice Greene,Maurice Greene,2019-06-29,0,1,-4,4,2.333333,1.285714,-10.16,10.16,6,-6,-15.23999,15.23999,31,36,20,16,4,-4,1.04761898517609,-1.04761898517609,0,1,1,0,-1,1,1,-1,147,211,-64,64
Mark Coleman,Maurice Smith,Maurice Smith,1997-07-27,0,1,-3,3,1.6,0.8571429,-2.540009,2.540009,-16,16,-0.5,0.5,0,0,26,26,0,0,0.742857158184052,-0.742857158184052,6,0,0,0,6,-6,0,0,170,0,170,-170
David Abbott,Maurice Smith,Maurice Smith,1997-10-17,0,1,,,0.6666667,0.8571429,-5.080002,5.080002,44,-44,-8.5,8.5,0,0,25,26,-1,1,-0.190476179122925,0.190476179122925,0,1,1,0,-1,1,1,-1,140,82,58,-58
Randy Couture,Maurice Smith,Randy Couture,1997-12-21,1,0,-2,2,1.727273,0.8571429,-2.540009,2.540009,-16,16,-0.5,0.5,0,0,30,26,4,-4,0.870129883289337,-0.870129883289337,2,2,0,0,0,0,0,0,205,65,140,-140
Kevin Randleman,Maurice Smith,Kevin Randleman,1999-03-05,1,0,-10,10,1.0625,0.8571429,-10.16,10.16,-16,16,-11,11,0,0,33,26,7,-7,0.205357134342194,-0.205357134342194,0,0,0,0,0,0,0,0,0,439,-439,439
Marco Ruas,Maurice Smith,Maurice Smith,1999-07-16,0,1,1,-1,2.25,0.8571429,-2.540009,2.540009,-11,11,-3,3,221,34,13,26,-13,13,1.39285713434219,-1.39285713434219,0,0,0,0,0,0,0,0,1308,133,1175,-1175
Bobby Hoffman,Maurice Smith,Maurice Smith,2000-09-22,0,1,-7,7,3.6,0.8571429,0,0,24,-24,1,-1,492,326,46,26,20,-20,2.74285703897476,-2.74285703897476,0,1,0,0,-1,1,0,0,0,434,-434,434
Forrest Griffin,Mauricio Rua,Forrest Griffin,2007-09-22,1,0,3,-3,2.714286,1.928571,5.080002,-5.080002,0,0,2.540009,-2.540009,337,291,26,41,-15,15,0.785714149475098,-0.785714149475098,1,0,1,0,1,-1,1,-1,98,0,98,-98
Mark Coleman,Mauricio Rua,Mauricio Rua,2009-01-17,0,1,17,-17,1.6,1.928571,0,0,0,0,-2.539993,2.539993,370,209,26,41,-15,15,-0.328571438789368,0.328571438789368,0,0,1,0,0,0,1,-1,3662,483,3179,-3179
Chuck Liddell,Mauricio Rua,Mauricio Rua,2009-04-18,0,1,12,-12,2.625,1.928571,2.540009,-2.540009,0,0,0,0,21,26,29,41,-12,12,0.696428537368774,-0.696428537368774,9,1,0,0,8,-8,0,0,476,91,385,-385
Lyoto Machida,Mauricio Rua,Lyoto Machida,2009-10-24,1,0,4,-4,3,1.928571,0,0,-20,20,-5.079987,5.079987,23,162,32,41,-9,9,1.07142853736877,-1.07142853736877,4,2,0,0,2,-2,0,0,266,189,77,-77
Lyoto Machida,Mauricio Rua,Mauricio Rua,2010-05-08,0,1,3,-3,3,1.928571,0,0,-20,20,-5.079987,5.079987,53,34,32,41,-9,9,1.07142853736877,-1.07142853736877,5,0,0,0,5,-5,0,0,196,196,0,0
Jon Jones,Mauricio Rua,Jon Jones,2011-03-19,1,0,-6,6,27,1.928571,7.619995,-7.619995,43,-43,20.32001,-20.32001,470,5,28,41,-13,13,25.0714285373688,-25.0714285373688,3,1,0,0,2,-2,0,0,230,315,-85,85
Forrest Griffin,Mauricio Rua,Mauricio Rua,2011-08-27,0,1,3,-3,2.714286,1.928571,5.080002,-5.080002,0,0,2.540009,-2.540009,0,7,26,41,-15,15,0.785714149475098,-0.785714149475098,1,0,2,1,1,-1,1,-1,644,161,483,-483
Dan Henderson,Mauricio Rua,Dan Henderson,2011-11-19,1,0,12,-12,2.133333,1.928571,-5.080002,5.080002,-20,20,-5.079987,5.079987,265,546,47,41,6,-6,0.204761981964111,-0.204761981964111,1,1,0,1,0,0,-1,1,1169,84,1085,-1085
Alexander Gustafsson,Mauricio Rua,Alexander Gustafsson,2012-12-08,1,0,-6,6,2.25,1.928571,10.16,-10.16,0,0,7.62001,-7.62001,232,88,26,41,-15,15,0.321428537368774,-0.321428537368774,5,0,0,1,5,-5,-1,1,238,385,-147,147
Dan Henderson,Mauricio Rua,Dan Henderson,2014-03-23,1,0,11,-11,2.133333,1.928571,-5.080002,5.080002,-20,20,-5.079987,5.079987,8,205,47,41,6,-6,0.204761981964111,-0.204761981964111,0,0,0,1,0,0,-1,1,393,470,-77,77
Rogerio Nogueira,Mauricio Rua,Mauricio Rua,2015-08-01,0,1,6,-6,2.3,1.928571,2.540009,-2.540009,0,0,-2.539993,2.539993,13,259,33,41,-8,8,0.371428489685059,-0.371428489685059,1,0,0,2,1,-1,-2,2,1330,496,834,-834
Corey Anderson,Mauricio Rua,Mauricio Rua,2016-05-14,0,1,-8,8,2.8,1.928571,5.080002,-5.080002,0,0,7.62001,-7.62001,340,13,19,41,-22,22,0.871428489685059,-0.871428489685059,3,1,1,2,2,-2,-1,1,70,287,-217,217
Tyson Pedro,Mauricio Rua,Mauricio Rua,2018-12-01,0,1,-10,10,2.5,1.928571,5.080002,-5.080002,0,0,7.62001,-7.62001,41,318,14,41,-27,27,0.571428537368774,-0.571428537368774,0,2,0,2,-2,2,-2,2,161,931,-770,770
Rogerio Nogueira,Mauricio Rua,Mauricio Rua,2020-07-25,0,1,6,-6,2.3,1.928571,2.540009,-2.540009,0,0,-2.539993,2.539993,81,177,33,41,-8,8,0.371428489685059,-0.371428489685059,0,3,1,2,-3,3,-1,1,441,602,-161,161
Paul Craig,Mauricio Rua,Paul Craig,2020-11-21,1,0,-6,6,2.833333,1.928571,5.080002,-5.080002,-20,20,0,0,226,104,23,41,-18,18,0.904761791229248,-0.904761791229248,1,4,3,2,-3,3,1,-1,427,119,308,-308
Ihor Potieria,Mauricio Rua,Ihor Potieria,2023-01-21,1,0,-15,15,4.75,1.928571,5.080002,-5.080002,0,0,-2.539993,2.539993,38,1,23,41,-18,18,2.82142853736877,-2.82142853736877,0,0,0,3,0,0,-3,3,0,791,-791,791
Colby Covington,Max Griffin,Colby Covington,2016-08-20,1,0,-2,2,5.666667,1.9,0,0,0,0,-10.15999,10.15999,610,7,20,29,-9,9,3.76666653156281,-3.76666653156281,4,0,0,0,4,-4,0,0,63,0,63,-63
Thiago Alves,Max Griffin,Thiago Alves,2019-02-02,1,0,2,-2,1.533333,1.9,-5.080002,5.080002,0,0,-15.23999,15.23999,73,218,38,29,9,-9,-0.366666674613953,0.366666674613953,0,0,3,1,0,0,2,-2,140,896,-756,756
Ramiz Brahimaj,Max Griffin,Max Griffin,2020-11-07,0,1,-7,7,2.5,1.9,-2.539993,2.539993,0,0,-10.15999,10.15999,13,32,14,29,-15,15,0.600000023841858,-0.600000023841858,0,0,0,1,0,0,-1,1,0,644,-644,644
Carlos Condit,Max Griffin,Max Griffin,2021-07-10,0,1,2,-2,2.285714,1.9,7.62001,-7.62001,0,0,-2.539993,2.539993,0,71,46,29,17,-17,0.385714411735535,-0.385714411735535,1,1,1,1,0,0,0,0,280,245,35,-35
Leonard Garcia,Max Holloway,Max Holloway,2012-12-29,0,1,12,-12,1.384615,3.571429,-2.539993,2.539993,0,0,-2.539993,2.539993,98,8,31,32,-1,1,-2.18681311607361,2.18681311607361,0,0,0,0,0,0,0,0,204,0,204,-204
Dennis Bermudez,Max Holloway,Dennis Bermudez,2013-05-25,1,0,5,-5,1.888889,3.571429,-12.7,12.7,10,-10,-7.619995,7.619995,208,8,26,32,-6,6,-1.68253970146179,1.68253970146179,3,1,0,0,2,-2,0,0,91,147,-56,56
Will Chope,Max Holloway,Max Holloway,2014-01-04,0,1,1,-1,2.615385,3.571429,12.7,-12.7,0,0,4.740005,-4.740005,61,16,47,32,15,-15,-0.95604395866394,0.95604395866394,0,0,0,0,0,0,0,0,0,224,-224,224
Andre Fili,Max Holloway,Max Holloway,2014-04-26,0,1,1,-1,2.2,3.571429,0,0,0,0,12.70001,-12.70001,192,0,32,32,0,0,-1.37142848968506,1.37142848968506,1,1,0,0,0,0,0,0,189,112,77,-77
Clay Collard,Max Holloway,Max Holloway,2014-08-23,0,1,-1,1,2,3.571429,0,0,0,0,10.16,-10.16,109,154,21,32,-11,11,-1.57142853736877,1.57142853736877,0,2,0,0,-2,2,0,0,0,119,-119,119
Akira Corassani,Max Holloway,Max Holloway,2014-10-04,0,1,10,-10,2,3.571429,-7.619995,7.619995,0,0,-2.539993,2.539993,10,11,18,32,-14,14,-1.57142853736877,1.57142853736877,0,3,1,0,-3,3,1,-1,171,42,129,-129
Jose Aldo,Max Holloway,Max Holloway,2017-06-03,0,1,5,-5,3.875,3.571429,-10.16,10.16,-10,10,2.540009,-2.540009,0,124,39,32,7,-7,0.303571462631226,-0.303571462631226,1,4,1,0,-3,3,1,-1,329,973,-644,644
Jose Aldo,Max Holloway,Max Holloway,2017-12-02,0,1,6,-6,3.875,3.571429,-10.16,10.16,-10,10,2.540009,-2.540009,2,47,39,32,7,-7,0.303571462631226,-0.303571462631226,0,5,2,0,-5,5,2,-2,182,182,0,0
Frankie Edgar,Max Holloway,Max Holloway,2019-07-27,0,1,10,-10,2.090909,3.571429,-12.7,12.7,-10,10,-2.539993,2.539993,106,0,34,32,2,-2,-1.48051953315735,1.48051953315735,1,6,1,0,-5,5,1,-1,462,602,-140,140
Arnold Allen,Max Holloway,Max Holloway,2023-04-15,0,1,-2,2,9.5,3.571429,-7.619995,7.619995,0,0,2.540009,-2.540009,42,3,21,32,-11,11,5.92857146263123,-5.92857146263123,10,7,0,0,3,-3,0,0,168,1358,-1190,1190
Austin Hubbard,Max Rohskopf,Austin Hubbard,2020-06-20,1,0,3,-3,2.285714,5,-7.619995,7.619995,0,0,0,0,0,67,23,6,17,-17,-2.71428561210632,2.71428561210632,0,0,0,0,0,0,0,0,105,0,105,-105
Gadzhimurad Antigulov,Maxim Grishin,Maxim Grishin,2020-10-17,0,1,-3,3,2.5,3.2,-10.16,10.16,0,0,-20.31999,20.31999,159,141,28,42,-14,14,-0.700000047683716,0.700000047683716,0,0,2,0,0,0,2,-2,84,0,84,-84
Felipe Arantes,Maximo Blanco,Felipe Arantes,2014-02-15,1,0,-4,4,1.8,1.5,0,0,-10,10,5.080002,-5.080002,177,211,28,20,8,-8,0.299999952316284,-0.299999952316284,0,0,0,0,0,0,0,0,164,0,164,-164
JJ Aldrich,Maycee Barber,Maycee Barber,2019-03-23,0,1,6,-6,2,6.5,0,0,0,0,5.079987,-5.079987,39,2,18,15,3,-3,-4.5,4.5,3,0,0,0,3,-3,0,0,231,0,231,-231
Sijara Eubanks,Melissa Gatto,Melissa Gatto,2021-12-18,0,1,11,-11,1.142857,4,-2.540009,2.540009,0,0,-5.080002,5.080002,365,181,15,10,5,-5,-2.85714280605316,2.85714280605316,1,0,0,0,1,-1,0,0,147,0,147,-147
Tracy Cortez,Melissa Gatto,Tracy Cortez,2022-05-07,1,0,2,-2,11,4,0,0,0,0,-10.15999,10.15999,474,197,12,10,2,-2,7,-7,3,1,0,0,2,-2,0,0,385,140,245,-245
Collin Anglin,Melsik Baghdasaryan,Melsik Baghdasaryan,2021-07-31,0,1,-1,1,2.666667,4,0,0,0,0,2.539993,-2.539993,18,71,11,10,1,-1,-1.33333325386047,1.33333325386047,0,0,0,0,0,0,0,0,0,0,0,0
Marcus Davis,Melvin Guillard,Melvin Guillard,2005-11-05,0,1,10,-10,2,1.777778,2.540009,-2.540009,15,-15,-2.539993,2.539993,139,195,33,50,-17,17,0.222222208976746,-0.222222208976746,0,0,0,0,0,0,0,0,0,0,0,0
Rick Davis,Melvin Guillard,Melvin Guillard,2006-05-27,0,1,,,3,1.777778,0,0,0,0,-2.339996,2.339996,0,2,4,50,-46,46,1.22222220897675,-1.22222220897675,0,1,0,0,-1,1,0,0,0,203,-203,203
Rich Clementi,Melvin Guillard,Rich Clementi,2007-12-29,1,0,7,-7,1.956522,1.777778,0,0,0,0,2.540009,-2.540009,108,28,68,50,18,-18,0.178743958473206,-0.178743958473206,2,2,0,0,0,0,0,0,98,581,-483,483
Nate Diaz,Melvin Guillard,Nate Diaz,2009-09-16,1,0,-2,2,1.692308,1.777778,7.62001,-7.62001,15,-15,12.7,-12.7,83,43,35,50,-15,15,-8.54700803756714e-02,8.54700803756714e-02,0,0,0,0,0,0,0,0,88,627,-539,539
Evan Dunham,Melvin Guillard,Melvin Guillard,2011-01-22,0,1,2,-2,2,1.777778,2.540009,-2.540009,0,0,-2.539993,2.539993,58,5,27,50,-23,23,0.222222208976746,-0.222222208976746,0,0,0,0,0,0,0,0,119,493,-374,374
Fabricio Camoes,Melvin Guillard,Melvin Guillard,2012-07-07,0,1,4,-4,1.555556,1.777778,2.540009,-2.540009,0,0,0,0,126,83,23,50,-27,27,-0.222222208976746,0.222222208976746,1,1,0,0,0,0,0,0,169,532,-363,363
Donald Cerrone,Melvin Guillard,Donald Cerrone,2012-08-11,1,0,0,0,2.117647,1.777778,10.16,-10.16,0,0,5.080002,-5.080002,2,4,53,50,3,-3,0.339869379997253,-0.339869379997253,1,2,0,0,-1,1,0,0,88,35,53,-53
Mac Danzig,Melvin Guillard,Melvin Guillard,2013-07-27,0,1,3,-3,1.75,1.777778,-2.539993,2.539993,0,0,-2.539993,2.539993,13,40,33,50,-17,17,-2.77777910232544e-02,2.77777910232544e-02,0,0,0,1,0,0,-1,1,259,350,-91,91
John Dodson,Merab Dvalishvili,Merab Dvalishvili,2020-08-15,0,1,6,-6,1.833333,4,-7.619995,7.619995,0,0,-5.080002,5.080002,4,224,34,20,14,-14,-2.16666662693024,2.16666662693024,1,0,0,0,1,-1,0,0,182,0,182,-182
Jose Aldo,Merab Dvalishvili,Merab Dvalishvili,2022-08-20,0,1,4,-4,3.875,4,2.539993,-2.539993,0,0,5.080002,-5.080002,0,306,39,20,19,-19,-0.125,0.125,3,1,4,0,2,-2,4,-4,259,735,-476,476
Yoshihiro Akiyama,Michael Bisping,Michael Bisping,2010-10-16,0,1,4,-4,2.333333,3.333333,-7.619995,7.619995,-15,15,0,0,0,2,20,39,-19,19,-1,1,0,0,0,0,0,0,0,0,105,0,105,-105
Vitor Belfort,Michael Bisping,Vitor Belfort,2013-01-19,1,0,2,-2,1.857143,3.333333,-2.539993,2.539993,0,0,-2.539993,2.539993,6,0,40,39,1,-1,-1.47619044780731,1.47619044780731,0,1,3,0,-1,1,3,-3,119,826,-707,707
Alan Belcher,Michael Bisping,Michael Bisping,2013-04-27,0,1,-5,5,2.25,3.333333,2.540009,-2.540009,0,0,0,0,0,8,26,39,-13,13,-1.08333325386047,1.08333325386047,0,0,1,1,0,0,0,0,119,98,21,-21
Sean Brady,Michael Chiesa,Sean Brady,2021-11-20,1,0,-5,5,15,2.571429,-7.619995,7.619995,0,0,-7.619995,7.619995,465,53,16,25,-9,9,12.4285714626312,-12.4285714626312,3,0,0,0,3,-3,0,0,259,0,259,-259
Randy Brown,Michael Graves,Michael Graves,2016-04-16,0,1,0,0,3.4,6,12.7,-12.7,0,0,17.78,-17.78,62,329,22,6,16,-16,-2.59999990463257,2.59999990463257,1,0,0,0,1,-1,0,0,77,0,77,-77
Jonathan Brookins,Michael Johnson,Jonathan Brookins,2010-12-04,1,0,1,-1,1.6,1.157895,5.080002,-5.080002,-10,10,2.540009,-2.540009,586,74,26,41,-15,15,0.442105293273926,-0.442105293273926,0,0,0,0,0,0,0,0,0,0,0,0
Edward Faaloloto,Michael Johnson,Michael Johnson,2011-06-26,0,1,1,-1,0.4,1.157895,,,0,0,-7.619995,7.619995,11,65,7,41,-34,34,-0.757894724607468,0.757894724607468,0,0,0,0,0,0,0,0,0,204,-204,204
Tony Ferguson,Michael Johnson,Michael Johnson,2012-05-05,0,1,3,-3,2.888889,1.157895,2.539993,-2.539993,0,0,7.619995,-7.619995,0,1,35,41,-6,6,1.73099410533905,-1.73099410533905,2,1,0,0,1,-1,0,0,224,314,-90,90
Danny Castillo,Michael Johnson,Michael Johnson,2012-10-05,0,1,7,-7,1.7,1.157895,-2.540009,2.540009,0,0,-5.080002,5.080002,242,3,27,41,-14,14,0.542105317115784,-0.542105317115784,2,2,0,0,0,0,0,0,153,153,0,0
Melvin Guillard,Michael Johnson,Michael Johnson,2014-03-08,0,1,3,-3,1.777778,1.157895,-2.540009,2.540009,0,0,-5.080002,5.080002,0,74,50,41,9,-9,0.619883060455322,-0.619883060455322,0,3,0,0,-3,3,0,0,434,519,-85,85
Edson Barboza,Michael Johnson,Michael Johnson,2015-02-22,0,1,1,-1,2.090909,1.157895,2.539993,-2.539993,-10,10,5.080002,-5.080002,0,61,34,41,-7,7,0.933014273643494,-0.933014273643494,2,4,1,0,-2,2,1,-1,92,351,-259,259
Beneil Dariush,Michael Johnson,Beneil Dariush,2015-08-08,1,0,-3,3,4.4,1.157895,0,0,0,0,-2.539993,2.539993,0,0,27,41,-14,14,3.2421053647995,-3.2421053647995,3,5,1,0,-2,2,1,-1,112,167,-55,55
Nate Diaz,Michael Johnson,Nate Diaz,2015-12-19,1,0,1,-1,1.692308,1.157895,5.080002,-5.080002,15,-15,7.619995,-7.619995,0,19,35,41,-6,6,0.534412980079651,-0.534412980079651,0,0,1,0,0,0,1,-1,371,133,238,-238
Justin Gaethje,Michael Johnson,Justin Gaethje,2017-07-07,1,0,-3,3,6.25,1.157895,2.539993,-2.539993,0,0,-7.619995,7.619995,6,34,29,41,-12,12,5.09210526943207,-5.09210526943207,0,0,0,0,0,0,0,0,0,566,-566,566
Darren Elkins,Michael Johnson,Darren Elkins,2018-01-14,1,0,2,-2,2.454545,1.157895,0,0,-10,10,-5.080002,5.080002,121,0,38,41,-3,3,1.29665076732635,-1.29665076732635,4,0,1,1,4,-4,0,0,540,191,349,-349
Andre Fili,Michael Johnson,Michael Johnson,2018-08-25,0,1,-4,4,2.2,1.157895,2.539993,-2.539993,-10,10,2.540009,-2.540009,201,90,32,41,-9,9,1.04210531711578,-1.04210531711578,1,0,1,1,1,-1,0,0,308,223,85,-85
Josh Emmett,Michael Johnson,Josh Emmett,2019-03-30,1,0,2,-2,4.5,1.157895,-10.16,10.16,-10,10,-7.619995,7.619995,2,0,22,41,-19,19,3.34210526943207,-3.34210526943207,0,1,1,1,-1,1,0,0,399,217,182,-182
Clay Guida,Michael Johnson,Clay Guida,2021-02-06,1,0,5,-5,1.9,1.157895,-7.62001,7.62001,0,0,-7.619995,7.619995,413,183,58,41,17,-17,0.74210524559021,-0.74210524559021,0,0,2,2,0,0,0,0,553,679,-126,126
Marc Diakiese,Michael Johnson,Michael Johnson,2022-12-03,0,1,-7,7,2.285714,1.157895,0,0,0,0,0,0,0,30,23,41,-18,18,1.12781965732574,-1.12781965732574,1,0,0,2,1,-1,-2,2,133,665,-532,532
Diego Ferreira,Michael Johnson,Diego Ferreira,2023-05-20,1,0,2,-2,3.6,1.157895,-2.540009,2.540009,0,0,2.540009,-2.540009,1,0,23,41,-18,18,2.44210517406464,-2.44210517406464,0,1,3,2,-1,1,1,-1,518,168,350,-350
Jared Hamman,Michael Kuiper,Michael Kuiper,2012-08-11,0,1,7,-7,2.333333,3,7.619995,-7.619995,0,0,5.080002,-5.080002,6,75,20,20,0,0,-0.666666746139526,0.666666746139526,0,0,1,0,0,0,1,-1,245,0,245,-245
Nik Lentz,Michael McBride,Nik Lentz,2016-09-10,1,0,2,-2,2.5,2.666667,-12.7,12.7,-10,10,-5.279999,5.279999,438,32,42,11,31,-31,-0.166666746139526,0.166666746139526,0,0,0,0,0,0,0,0,469,0,469,-469
Scott Holtzman,Michael McBride,Scott Holtzman,2017-04-22,1,0,2,-2,2.333333,2.666667,-10.16,10.16,0,0,-2.740005,2.740005,401,56,20,11,9,-9,-0.333333492279053,0.333333492279053,1,0,0,1,1,-1,-1,1,283,224,59,-59
Edwin Figueroa,Michael McDonald,Michael McDonald,2011-03-26,0,1,6,-6,1.8,4.25,-5.080002,5.080002,0,0,-2.540009,2.540009,235,240,14,21,-7,7,-2.45000004768372,2.45000004768372,0,0,0,0,0,0,0,0,0,0,0,0
Chris Cariaso,Michael McDonald,Michael McDonald,2011-05-28,0,1,10,-10,2.125,4.25,-15.23999,15.23999,-10,10,-15.24001,15.24001,98,129,25,21,4,-4,-2.125,2.125,0,1,0,0,-1,1,0,0,0,63,-63,63
Renan Barao,Michael McDonald,Renan Barao,2013-02-16,1,0,4,-4,3.777778,4.25,-7.619995,7.619995,10,-10,0,0,238,0,43,21,22,-22,-0.472222328186035,0.472222328186035,4,2,0,0,2,-2,0,0,210,630,-420,420
Urijah Faber,Michael McDonald,Urijah Faber,2013-12-14,1,0,12,-12,3.181818,4.25,-7.619995,7.619995,0,0,-7.62001,7.62001,175,3,46,21,25,-25,-1.06818175315857,1.06818175315857,3,0,0,0,3,-3,0,0,245,301,-56,56
Masanori Kanehara,Michael McDonald,Michael McDonald,2016-01-02,0,1,9,-9,2.166667,4.25,-5.080002,5.080002,0,0,-7.62001,7.62001,350,12,38,21,17,-17,-2.08333325386047,2.08333325386047,0,0,0,0,0,0,0,0,171,749,-578,578
John Lineker,Michael McDonald,John Lineker,2016-07-13,1,0,1,-1,3.444444,4.25,-15.23999,15.23999,0,0,-7.62001,7.62001,8,0,40,21,19,-19,-0.805555582046509,0.805555582046509,5,1,0,0,4,-4,0,0,312,193,119,-119
Trevin Giles,Michael Morales,Michael Morales,2022-01-22,0,1,7,-7,3.2,15,0,0,0,0,-12.7,12.7,72,65,21,15,6,-6,-11.7999999523163,11.7999999523163,2,0,0,0,2,-2,0,0,441,0,441,-441
Adam Fugitt,Michael Morales,Michael Morales,2022-07-30,0,1,10,-10,2.25,15,2.539993,-2.539993,0,0,-5.080002,5.080002,111,12,13,15,-2,2,-12.75,12.75,0,1,0,0,-1,1,0,0,0,189,-189,189
Max Griffin,Michael Morales,Michael Morales,2023-07-01,0,1,13,-13,1.9,15,-2.540009,2.540009,0,0,-7.62001,7.62001,130,27,29,15,14,-14,-13.1000000238419,13.1000000238419,1,2,0,0,-1,1,0,0,245,336,-91,91
Tim Boetsch,Michael Patt,Tim Boetsch,2008-09-06,1,0,,,1.615385,3,0,0,-20,20,2.960007,-2.960007,5,0,34,16,18,-18,-1.38461542129517,1.38461542129517,0,0,1,0,0,0,1,-1,157,0,157,-157
Joe Giannetti,Michael Trizano,Michael Trizano,2018-07-06,0,1,-3,3,6,3.666667,2.540009,-2.540009,10,-10,7.62001,-7.62001,171,339,7,14,-7,7,2.33333325386047,-2.33333325386047,0,0,0,0,0,0,0,0,0,0,0,0
Luis Pena,Michael Trizano,Michael Trizano,2018-11-10,0,1,-1,1,3,3.666667,10.16,-10.16,10,-10,10.16,-10.16,326,134,12,14,-2,2,-0.666666746139526,0.666666746139526,1,1,0,0,0,0,0,0,127,127,0,0
Grant Dawson,Michael Trizano,Grant Dawson,2019-05-18,1,0,-2,2,20,3.666667,-2.539993,2.539993,10,-10,2.540009,-2.540009,253,34,21,14,7,-7,16.3333332538605,-16.3333332538605,1,2,0,0,-1,1,0,0,70,189,-119,119
Ludovit Klein,Michael Trizano,Michael Trizano,2021-05-08,0,1,-3,3,5,3.666667,-10.16,10.16,10,-10,2.540009,-2.540009,208,0,24,14,10,-10,1.33333325386047,-1.33333325386047,1,0,0,0,1,-1,0,0,224,721,-497,497
Hakeem Dawodu,Michael Trizano,Hakeem Dawodu,2022-02-05,1,0,0,0,3.25,3.666667,-7.619995,7.619995,0,0,5.080002,-5.080002,226,33,17,14,3,-3,-0.416666746139526,0.416666746139526,0,1,0,0,-1,1,0,0,238,273,-35,35
Lucas Almeida,Michael Trizano,Lucas Almeida,2022-06-04,1,0,1,-1,7,3.666667,0,0,0,0,0,0,133,103,16,14,2,-2,3.33333325386047,-3.33333325386047,0,0,0,0,0,0,0,0,0,119,-119,119
SeungWoo Choi,Michael Trizano,Michael Trizano,2022-11-12,0,1,0,0,1.833333,3.666667,2.540009,-2.540009,0,0,7.62001,-7.62001,12,14,17,14,3,-3,-1.83333337306976,1.83333337306976,0,0,0,1,0,0,-1,1,154,161,-7,7
Gadzhimurad Antigulov,Michal Oleksiejczuk,Michal Oleksiejczuk,2019-04-20,0,1,8,-8,2.5,3.166667,-2.540009,2.540009,20,-20,-10.16,10.16,0,8,28,25,3,-3,-0.666666746139526,0.666666746139526,0,0,1,0,0,0,1,-1,266,0,266,-266
Jimmy Crute,Michal Oleksiejczuk,Jimmy Crute,2020-02-22,1,0,-2,2,3,3.166667,5.080002,-5.080002,20,-20,0,0,183,0,16,25,-9,9,-0.166666746139526,0.166666746139526,0,1,0,0,-1,1,0,0,0,308,-308,308
Modestas Bukauskas,Michal Oleksiejczuk,Michal Oleksiejczuk,2021-03-27,0,1,1,-1,3,3.166667,7.619995,-7.619995,20,-20,10.15999,-10.15999,4,69,20,25,-5,5,-0.166666746139526,0.166666746139526,0,0,1,0,0,0,1,-1,161,399,-238,238
Shamil Gamzatov,Michal Oleksiejczuk,Michal Oleksiejczuk,2021-10-30,0,1,5,-5,14,3.166667,5.080002,-5.080002,20,-20,5.079987,-5.079987,0,3,15,25,-10,10,10.8333332538605,-10.8333332538605,0,1,0,0,-1,1,0,0,0,217,-217,217
Dustin Jacoby,Michal Oleksiejczuk,Dustin Jacoby,2022-03-05,1,0,6,-6,2.714286,3.166667,7.619995,-7.619995,20,-20,5.079987,-5.079987,190,17,26,25,1,-1,-0.452381134033203,0.452381134033203,2,2,0,0,0,0,0,0,189,126,63,-63
Sam Alvey,Michal Oleksiejczuk,Michal Oleksiejczuk,2022-08-06,0,1,9,-9,1.833333,3.166667,5.080002,-5.080002,0,0,2.539993,-2.539993,0,57,51,25,26,-26,-1.33333337306976,1.33333337306976,0,0,3,0,0,0,3,-3,343,154,189,-189
Cody Brundage,Michal Oleksiejczuk,Michal Oleksiejczuk,2022-12-17,0,1,1,-1,1.8,3.166667,0,0,0,0,-5.080002,5.080002,113,72,14,25,-11,11,-1.36666679382324,1.36666679382324,2,1,0,0,1,-1,0,0,161,133,28,-28
Caio Borralho,Michal Oleksiejczuk,Caio Borralho,2023-04-29,1,0,2,-2,14,3.166667,-5.080002,5.080002,0,0,2.539993,-2.539993,159,13,15,25,-10,10,10.8333332538605,-10.8333332538605,3,2,0,0,1,-1,0,0,189,133,56,-56
Chidi Njokuani,Michal Oleksiejczuk,Michal Oleksiejczuk,2023-08-26,0,1,6,-6,2.2,3.166667,7.619995,-7.619995,0,0,15.23999,-15.23999,9,96,32,25,7,-7,-0.966666698455811,0.966666698455811,0,0,1,0,0,0,1,-1,343,119,224,-224
Ramiz Brahimaj,Micheal Gillmore,Ramiz Brahimaj,2022-02-26,1,0,-5,5,2.5,1.2,-2.539993,2.539993,0,0,0,0,93,0,14,11,3,-3,1.29999995231628,-1.29999995231628,0,0,1,0,0,0,1,-1,42,0,42,-42
Tristan Connelly,Michel Pereira,Tristan Connelly,2019-09-14,1,0,8,-8,1.75,2.545455,-7.619995,7.619995,-40,40,-12.7,12.7,343,183,22,39,-17,17,-0.795454502105713,0.795454502105713,0,0,0,0,0,0,0,0,0,0,0,0
Zelim Imadaev,Michel Pereira,Michel Pereira,2020-09-05,0,1,-1,1,2.666667,2.545455,-2.539993,2.539993,-15,15,7.619995,-7.619995,8,11,11,39,-28,28,0.121212244033813,-0.121212244033813,0,0,1,0,0,0,1,-1,301,357,-56,56
Andre Fialho,Michel Pereira,Michel Pereira,2022-01-22,0,1,-1,1,2,2.545455,-2.539993,2.539993,-15,15,2.540009,-2.540009,45,44,24,39,-15,15,-0.545454502105713,0.545454502105713,0,1,0,0,-1,1,0,0,0,504,-504,504
Kevin Lee,Michel Prazeres,Kevin Lee,2015-02-14,1,0,-11,11,2.25,6.5,7.619995,-7.619995,0,0,25.40001,-25.40001,284,194,26,30,-4,4,-4.25,4.25,2,0,0,0,2,-2,0,0,140,0,140,-140
Valmir Lazaro,Michel Prazeres,Michel Prazeres,2015-11-21,0,1,-4,4,3,6.5,15.24001,-15.24001,-15,15,15.24001,-15.24001,209,121,20,30,-10,10,-3.5,3.5,0,0,0,0,0,0,0,0,455,280,175,-175
JC Cottrell,Michel Prazeres,Michel Prazeres,2016-07-23,0,1,-8,8,3.4,6.5,7.619995,-7.619995,-15,15,7.820007,-7.820007,86,403,22,30,-8,8,-3.09999990463257,3.09999990463257,0,1,0,0,-1,1,0,0,0,245,-245,245
Gilbert Burns,Michel Prazeres,Michel Prazeres,2016-09-24,0,1,-5,5,3.666667,6.5,10.16,-10.16,0,0,10.16,-10.16,0,69,28,30,-2,2,-2.83333325386047,2.83333325386047,1,2,0,0,-1,1,0,0,79,63,16,-16
Joshua Burkman,Michel Prazeres,Michel Prazeres,2017-03-11,0,1,1,-1,1.75,6.5,10.16,-10.16,0,0,12.70001,-12.70001,0,72,44,30,14,-14,-4.75,4.75,0,3,1,0,-3,3,1,-1,161,168,-7,7
Mads Burnell,Michel Prazeres,Michel Prazeres,2017-09-02,0,1,-13,13,3,6.5,5.080002,-5.080002,-25,25,5.080002,-5.080002,20,531,12,30,-18,18,-3.5,3.5,0,4,0,0,-4,4,0,0,0,175,-175,175
Desmond Green,Michel Prazeres,Michel Prazeres,2018-02-03,0,1,-8,8,2.875,6.5,10.16,-10.16,-15,15,15.24001,-15.24001,165,235,31,30,1,-1,-3.625,3.625,0,5,0,0,-5,5,0,0,154,154,0,0
Zak Cummings,Michel Prazeres,Michel Prazeres,2018-05-19,0,1,-3,3,3.571429,6.5,15.24001,-15.24001,35,-35,20.32001,-20.32001,133,164,32,30,2,-2,-2.92857146263123,2.92857146263123,1,6,0,0,-5,5,0,0,546,105,441,-441
Bartosz Fabinski,Michel Prazeres,Michel Prazeres,2018-11-17,0,1,-5,5,3,6.5,15.24001,-15.24001,0,0,20.32001,-20.32001,0,46,20,30,-10,10,-3.5,3.5,3,7,0,0,-4,4,0,0,118,182,-64,64
Ismail Naurdiev,Michel Prazeres,Ismail Naurdiev,2019-02-23,1,0,-15,15,4.75,6.5,10.16,-10.16,0,0,17.78001,-17.78001,229,359,23,30,-7,7,-1.75,1.75,0,8,0,0,-8,8,0,0,0,98,-98,98
Jared Gordon,Michel Quinones,Jared Gordon,2017-06-25,1,0,-4,4,3.166667,2.666667,-2.540009,2.540009,0,0,-12.7,12.7,279,0,25,11,14,-14,0.5,-0.5,0,0,0,0,0,0,0,0,0,0,0,0
Sage Northcutt,Michel Quinones,Sage Northcutt,2017-11-11,1,0,-11,11,5.5,2.666667,5.080002,-5.080002,15,-15,-5.080002,5.080002,43,0,13,11,2,-2,2.83333325386047,-2.83333325386047,2,0,0,1,2,-2,-1,1,702,139,563,-563
Angela Magana,Michelle Waterson-Gomez,Michelle Waterson-Gomez,2015-07-12,0,1,2,-2,1.222222,1.5,-5.080002,5.080002,0,0,7.62001,-7.62001,475,117,20,30,-10,10,-0.277777791023254,0.277777791023254,0,0,0,0,0,0,0,0,212,0,212,-212
Paige VanZant,Michelle Waterson-Gomez,Michelle Waterson-Gomez,2016-12-17,0,1,-8,8,1.6,1.5,2.539993,-2.539993,0,0,7.62001,-7.62001,0,107,13,30,-17,17,0.100000023841858,-0.100000023841858,0,1,0,0,-1,1,0,0,0,524,-524,524
Rose Namajunas,Michelle Waterson-Gomez,Rose Namajunas,2017-04-15,1,0,-7,7,2,1.5,5.080002,-5.080002,10,-10,7.62001,-7.62001,273,50,18,30,-12,12,0.5,-0.5,2,2,0,0,0,0,0,0,364,119,245,-245
Tecia Torres,Michelle Waterson-Gomez,Tecia Torres,2017-12-02,1,0,-3,3,2.166667,1.5,-5.080002,5.080002,0,0,-5.080002,5.080002,237,270,19,30,-11,11,0.666666746139526,-0.666666746139526,0,0,0,0,0,0,0,0,0,231,-231,231
Cortney Casey,Michelle Waterson-Gomez,Michelle Waterson-Gomez,2018-04-14,0,1,-2,2,1,1.5,10.15999,-10.15999,10,-10,12.7,-12.7,102,363,20,30,-10,10,-0.5,0.5,0,0,0,0,0,0,0,0,133,133,0,0
Felice Herrig,Michelle Waterson-Gomez,Michelle Waterson-Gomez,2018-10-06,0,1,2,-2,1.4,1.5,2.539993,-2.539993,0,0,7.62001,-7.62001,358,169,24,30,-6,6,-0.100000023841858,0.100000023841858,0,1,0,0,-1,1,0,0,182,175,7,-7
Karolina Kowalkiewicz,Michelle Waterson-Gomez,Michelle Waterson-Gomez,2019-03-30,0,1,0,0,2.142857,1.5,0,0,0,0,5.080002,-5.080002,55,214,22,30,-8,8,0.642857074737549,-0.642857074737549,2,2,0,0,0,0,0,0,973,175,798,-798
Joanna Jedrzejczyk,Michelle Waterson-Gomez,Joanna Jedrzejczyk,2019-10-12,1,0,-1,1,3.2,1.5,7.619995,-7.619995,0,0,7.62001,-7.62001,333,299,21,30,-9,9,1.70000004768372,-1.70000004768372,0,3,1,0,-3,3,1,-1,308,196,112,-112
Carla Esparza,Michelle Waterson-Gomez,Carla Esparza,2020-05-09,1,0,-2,2,2.857143,1.5,-5.080002,5.080002,0,0,2.540009,-2.540009,46,0,27,30,-3,3,1.35714292526245,-1.35714292526245,2,0,2,0,2,-2,2,-2,231,210,21,-21
Angela Hill,Michelle Waterson-Gomez,Michelle Waterson-Gomez,2020-09-12,0,1,1,-1,1.153846,1.5,0,0,0,0,5.080002,-5.080002,130,243,28,30,-2,2,-0.346153855323792,0.346153855323792,1,0,0,0,1,-1,0,0,203,126,77,-77
Marina Rodriguez,Michelle Waterson-Gomez,Marina Rodriguez,2021-05-08,1,0,-1,1,5.666667,1.5,7.619995,-7.619995,0,0,7.62001,-7.62001,51,234,20,30,-10,10,4.16666650772095,-4.16666650772095,1,1,0,0,0,0,0,0,637,238,399,-399
Amanda Lemos,Michelle Waterson-Gomez,Amanda Lemos,2022-07-16,1,0,-1,1,4.333333,1.5,2.539993,-2.539993,0,0,7.62001,-7.62001,5,68,16,30,-14,14,2.83333349227905,-2.83333349227905,1,0,1,0,1,-1,1,-1,497,434,63,-63
Luana Pinheiro,Michelle Waterson-Gomez,Luana Pinheiro,2023-04-08,1,0,-7,7,11,1.5,-2.540009,2.540009,0,0,0,0,85,61,12,30,-18,18,9.5,-9.5,0,0,0,0,0,0,0,0,0,266,-266,266
Marina Rodriguez,Michelle Waterson-Gomez,Marina Rodriguez,2023-09-23,1,0,-1,1,5.666667,1.5,7.619995,-7.619995,0,0,7.62001,-7.62001,123,169,20,30,-10,10,4.16666650772095,-4.16666650772095,3,0,0,0,3,-3,0,0,567,168,399,-399
Chad Mendes,Michihiro Omigawa,Chad Mendes,2011-02-05,1,0,-10,10,3.6,1.214286,0,0,0,0,-5.080002,5.080002,375,32,23,31,-8,8,2.38571417331696,-2.38571417331696,0,0,0,0,0,0,0,0,0,0,0,0
Darren Elkins,Michihiro Omigawa,Darren Elkins,2011-06-11,1,0,-8,8,2.454545,1.214286,10.16,-10.16,0,0,7.619995,-7.619995,5,88,38,31,7,-7,1.24025976657867,-1.24025976657867,0,0,0,0,0,0,0,0,314,126,188,-188
Iuri Alcantara,Michihiro Omigawa,Iuri Alcantara,2012-01-14,1,0,-5,5,3.5,1.214286,7.619995,-7.619995,-10,10,7.619995,-7.619995,259,171,45,31,14,-14,2.28571426868439,-2.28571426868439,1,0,0,0,1,-1,0,0,140,217,-77,77
Manvel Gamburyan,Michihiro Omigawa,Manvel Gamburyan,2012-08-04,1,0,-5,5,1.5,1.214286,-2.539993,2.539993,-10,10,-2.540009,2.540009,282,63,25,31,-6,6,0.285714268684387,-0.285714268684387,0,0,0,0,0,0,0,0,218,203,15,-15
Roland Delorme,Michinori Tanaka,Michinori Tanaka,2014-06-14,0,1,7,-7,1.8,3.666667,10.15999,-10.15999,0,0,10.16,-10.16,21,613,14,14,0,0,-1.86666679382324,1.86666679382324,3,0,0,0,3,-3,0,0,364,0,364,-364
Kyung Ho Kang,Michinori Tanaka,Kyung Ho Kang,2014-09-20,1,0,4,-4,2.111111,3.666667,10.15999,-10.15999,0,0,15.24001,-15.24001,326,346,28,14,14,-14,-1.55555558204651,1.55555558204651,1,1,0,0,0,0,0,0,259,98,161,-161
Joe Soto,Michinori Tanaka,Michinori Tanaka,2016-01-02,0,1,3,-3,2.571429,3.666667,2.539993,-2.539993,0,0,-5.079987,5.079987,14,306,25,14,11,-11,-1.09523820877075,1.09523820877075,0,0,0,0,0,0,0,0,0,469,-469,469
Ricardo Ramos,Michinori Tanaka,Ricardo Ramos,2017-02-04,1,0,-5,5,3.2,3.666667,10.15999,-10.15999,10,-10,12.70001,-12.70001,102,211,21,14,7,-7,-0.466666698455811,0.466666698455811,0,1,0,0,-1,1,0,0,0,399,-399,399
Randy Brown,Mickey Gall,Randy Brown,2017-11-04,1,0,2,-2,3.4,1.4,2.539993,-2.539993,0,0,10.15999,-10.15999,528,265,22,12,10,-10,2.00000011920929,-2.00000011920929,0,0,0,0,0,0,0,0,266,0,266,-266
Ronda Rousey,Miesha Tate,Ronda Rousey,2013-12-28,1,0,-1,1,6,2.111111,2.539993,-2.539993,0,0,2.539993,-2.539993,424,119,14,28,-14,14,3.88888883590698,-3.88888883590698,0,0,0,0,0,0,0,0,0,0,0,0
Liz Carmouche,Miesha Tate,Miesha Tate,2014-04-19,0,1,3,-3,1.857143,2.111111,0,0,-10,10,2.539993,-2.539993,390,353,20,28,-8,8,-0.253968358039856,0.253968358039856,0,0,0,0,0,0,0,0,164,112,52,-52
Rin Nakai,Miesha Tate,Miesha Tate,2014-09-20,0,1,-1,1,9.5,2.111111,-12.7,12.7,0,0,-0.1000061,0.1000061,236,163,21,28,-7,7,7.38888883590698,-7.38888883590698,0,1,0,0,-1,1,0,0,0,154,-154,154
Sara McMann,Miesha Tate,Miesha Tate,2015-01-31,0,1,6,-6,2.166667,2.111111,0,0,0,0,2.539993,-2.539993,295,356,19,28,-9,9,5.55555820465088e-02,-5.55555820465088e-02,1,2,1,0,-1,1,1,-1,168,133,35,-35
Jessica Eye,Miesha Tate,Miesha Tate,2015-07-25,0,1,0,0,1.363636,2.111111,0,0,-10,10,2.539993,-2.539993,6,368,26,28,-2,2,-0.747474789619446,0.747474789619446,1,3,0,0,-2,2,0,0,252,175,77,-77
Holly Holm,Miesha Tate,Miesha Tate,2016-03-05,0,1,5,-5,2.142857,2.111111,5.080002,-5.080002,0,0,10.15999,-10.15999,51,305,22,28,-6,6,3.17459106445313e-02,-3.17459106445313e-02,3,4,0,0,-1,1,0,0,112,224,-112,112
Amanda Nunes,Miesha Tate,Amanda Nunes,2016-07-09,1,0,-1,1,4.6,2.111111,5.080002,-5.080002,0,0,10.15999,-10.15999,27,0,28,28,0,0,2.48888874053955,-2.48888874053955,1,5,1,0,-4,4,1,-1,126,126,0,0
Raquel Pennington,Miesha Tate,Raquel Pennington,2016-11-12,1,0,-2,2,1.666667,2.111111,2.539993,-2.539993,0,0,5.079987,-5.079987,407,267,24,28,-4,4,-0.444444537162781,0.444444537162781,1,0,0,0,1,-1,0,0,84,126,-42,42
Marion Reneau,Miesha Tate,Miesha Tate,2021-07-17,0,1,10,-10,1.125,2.111111,0,0,0,0,7.619995,-7.619995,0,352,17,28,-11,11,-0.986111164093018,0.986111164093018,0,0,0,0,0,0,0,0,861,1708,-847,847
Lauren Murphy,Miesha Tate,Lauren Murphy,2022-07-16,1,0,3,-3,2.666667,2.111111,-2.539993,2.539993,-10,10,5.079987,-5.079987,78,125,22,28,-6,6,0.555555582046509,-0.555555582046509,0,1,1,0,-1,1,1,-1,294,364,-70,70
Hector Aldana,Miguel Baeza,Miguel Baeza,2019-10-12,0,1,4,-4,1.333333,3.333333,-7.62001,7.62001,0,0,-5.080002,5.080002,9,0,7,13,-6,6,-1.99999988079071,1.99999988079071,0,0,1,0,0,0,1,-1,329,0,329,-329
Antonio Banuelos,Miguel Torres,Miguel Torres,2011-02-05,0,1,1,-1,1.818182,4.888889,-10.15999,10.15999,0,0,-33.01999,33.01999,1,0,31,53,-22,22,-3.07070696353912,3.07070696353912,0,0,0,0,0,0,0,0,0,0,0,0
Demetrious Johnson,Miguel Torres,Demetrious Johnson,2011-05-28,1,0,-6,6,9,4.888889,-15.23999,15.23999,-10,10,-25.39999,25.39999,520,273,30,53,-23,23,4.11111116409302,-4.11111116409302,1,1,0,0,0,0,0,0,112,112,0,0
Nick Pace,Miguel Torres,Miguel Torres,2011-11-19,0,1,-6,6,2.666667,4.888889,-5.080002,5.080002,0,0,-20.31999,20.31999,185,203,11,53,-42,42,-2.22222208976746,2.22222208976746,0,0,0,0,0,0,0,0,0,175,-175,175
Michael McDonald,Miguel Torres,Michael McDonald,2012-04-21,1,0,-10,10,4.25,4.888889,0,0,0,0,-15.23999,15.23999,2,0,21,53,-32,32,-0.638888835906982,0.638888835906982,1,1,0,0,0,0,0,0,154,154,0,0
Gilbert Burns,Mike Davis,Gilbert Burns,2019-04-27,1,0,6,-6,3.666667,5,-5.080002,5.080002,15,-15,-2.540009,2.540009,327,0,28,12,16,-16,-1.33333325386047,1.33333325386047,0,0,1,0,0,0,1,-1,294,0,294,-294
Viacheslav Borshchev,Mike Davis,Mike Davis,2022-10-01,0,1,1,-1,2.333333,5,-2.540009,2.540009,0,0,-7.62001,7.62001,14,482,10,12,-2,2,-2.66666674613953,2.66666674613953,0,0,0,0,0,0,0,0,189,1253,-1064,1064
Mark Bocek,Mike de la Torre,Mark Bocek,2014-04-16,1,0,5,-5,2.4,2,-7.619995,7.619995,10,-10,10.16,-10.16,374,68,17,21,-4,4,0.400000095367432,-0.400000095367432,0,0,1,0,0,0,1,-1,515,0,515,-515
Maximo Blanco,Mike de la Torre,Maximo Blanco,2015-07-12,1,0,3,-3,1.5,2,-7.619995,7.619995,0,0,0,0,1,0,20,21,-1,1,-0.5,0.5,2,0,0,0,2,-2,0,0,295,452,-157,157
Yui Chul Nam,Mike de la Torre,Mike de la Torre,2015-11-28,0,1,5,-5,2.25,2,-5.080002,5.080002,0,0,-2.339996,2.339996,307,237,26,21,5,-5,0.25,-0.25,0,0,0,1,0,0,-1,1,196,139,57,-57
Byron Bloodworth,Mike Easton,Mike Easton,2011-10-01,0,1,1,-1,2,2.166667,5.080002,-5.080002,0,0,-2.800003,2.800003,44,58,9,19,-10,10,-0.166666746139526,0.166666746139526,0,0,0,0,0,0,0,0,0,0,0,0
Raphael Assuncao,Mike Easton,Raphael Assuncao,2012-12-08,1,0,2,-2,2.8,2.166667,-2.539993,2.539993,0,0,-10.16,10.16,144,1,38,19,19,-19,0.633333206176758,-0.633333206176758,2,1,1,0,1,-1,1,-1,150,434,-284,284
TJ Dillashaw,Mike Easton,TJ Dillashaw,2014-01-15,1,0,-2,2,3.6,2.166667,0,0,0,0,-7.62001,7.62001,297,0,23,19,4,-4,1.43333315849304,-1.43333315849304,4,0,1,0,4,-4,1,-1,270,403,-133,133
Movsar Evloev,Mike Grundy,Movsar Evloev,2020-07-25,1,0,-7,7,17,3,0,0,0,0,0,0,48,155,17,16,1,-1,14,-14,0,0,0,0,0,0,0,0,0,0,0,0
Makwan Amirkhani,Mike Grundy,Makwan Amirkhani,2022-03-19,1,0,-2,2,1.888889,3,7.62001,-7.62001,0,0,0,0,15,31,26,16,10,-10,-1.11111116409302,1.11111116409302,0,0,2,0,0,0,2,-2,140,602,-462,462
Mickey Gall,Mike Jackson,Mickey Gall,2016-02-06,1,0,-6,6,1.4,0.5,0,0,0,0,0,0,14,0,12,3,9,-9,0.899999976158142,-0.899999976158142,0,0,0,0,0,0,0,0,0,0,0,0
Dean Barry,Mike Jackson,Mike Jackson,2022-04-23,0,1,-8,8,2,0.5,-10.16,10.16,0,0,-5.080002,5.080002,15,9,6,3,3,-3,1.5,-1.5,0,0,0,0,0,0,0,0,0,2268,-2268,2268
Justin Eilers,Mike Kyle,Justin Eilers,2004-08-21,1,0,2,-2,2.714286,1.571429,-7.619995,7.619995,30,-30,-7.580002,7.580002,1,0,26,36,-10,10,1.14285707473755,-1.14285707473755,0,0,0,0,0,0,0,0,0,0,0,0
James Irvin,Mike Kyle,Mike Kyle,2005-02-05,0,1,2,-2,1.7,1.571429,-5.079987,5.079987,0,0,-5.080002,5.080002,6,83,27,36,-9,9,0.128571510314941,-0.128571510314941,0,0,0,1,0,0,-1,1,0,168,-168,168
Edson Barboza,Mike Lullo,Edson Barboza,2010-11-20,1,0,-7,7,2.090909,2.666667,7.619995,-7.619995,0,0,17.5,-17.5,312,10,34,11,23,-23,-0.575757741928101,0.575757741928101,0,0,0,0,0,0,0,0,0,0,0,0
Mickey Gall,Mike Malott,Mike Malott,2022-04-09,0,1,0,0,1.4,10,2.540009,-2.540009,0,0,2.540009,-2.540009,17,5,12,11,1,-1,-8.60000002384186,8.60000002384186,0,0,1,0,0,0,1,-1,126,0,126,-126
Yohan Lainesse,Mike Malott,Mike Malott,2023-02-25,0,1,-1,1,4.5,10,0,0,0,0,7.619995,-7.619995,0,96,11,11,0,0,-5.5,5.5,1,1,0,0,0,0,0,0,168,322,-154,154
Adam Fugitt,Mike Malott,Mike Malott,2023-06-10,0,1,3,-3,2.25,10,0,0,0,0,10.16,-10.16,7,86,13,11,2,-2,-7.75,7.75,1,2,1,0,-1,1,1,-1,126,105,21,-21
CB Dollaway,Mike Massenzio,CB Dollaway,2008-12-27,1,0,-1,1,1.888889,1.444444,0,0,0,0,7.619995,-7.619995,120,4,26,22,4,-4,0.444444417953491,-0.444444417953491,1,0,0,0,1,-1,0,0,161,0,161,-161
Steve Cantwell,Mike Massenzio,Mike Massenzio,2011-10-08,0,1,-4,4,1.166667,1.444444,0,0,0,0,5.080002,-5.080002,10,208,13,22,-9,9,-0.277777791023254,0.277777791023254,0,0,0,1,0,0,-1,1,219,1015,-796,796
Wes Combs,Mike Nickels,Mike Nickels,2006-06-24,0,1,-1,1,3.333333,1.8,-5.079987,5.079987,0,0,-5,5,1,156,26,14,12,-12,1.53333330154419,-1.53333330154419,0,0,0,0,0,0,0,0,0,0,0,0
Stephan Bonnar,Mike Nickels,Stephan Bonnar,2007-07-07,1,0,-5,5,1.666667,1.8,0,0,0,0,4.660004,-4.660004,65,42,24,14,10,-10,-0.133333325386047,0.133333325386047,0,1,0,0,-1,1,0,0,315,378,-63,63
Hyun Gyu Lim,Mike Perry,Mike Perry,2016-08-20,0,1,7,-7,1.857143,1.75,12.7,-12.7,0,0,15.24001,-15.24001,0,88,20,22,-2,2,0.107142806053162,-0.107142806053162,0,0,1,0,0,0,1,-1,462,0,462,-462
Alan Jouban,Mike Perry,Alan Jouban,2016-12-17,1,0,10,-10,2.428571,1.75,5.080002,-5.080002,0,0,5.080002,-5.080002,66,0,24,22,2,-2,0.678571462631226,-0.678571462631226,2,1,1,0,1,-1,1,-1,163,119,44,-44
Jake Ellenberger,Mike Perry,Mike Perry,2017-04-22,0,1,7,-7,2.066667,1.75,-2.540009,2.540009,0,0,0,0,28,9,46,22,24,-24,0.316666603088379,-0.316666603088379,0,0,4,0,0,0,4,-4,140,126,14,-14
Max Griffin,Mike Perry,Max Griffin,2018-02-24,1,0,6,-6,1.9,1.75,2.539993,-2.539993,0,0,12.7,-12.7,24,78,29,22,7,-7,0.149999976158142,-0.149999976158142,0,1,0,0,-1,1,0,0,119,308,-189,189
Paul Felder,Mike Perry,Mike Perry,2018-07-07,0,1,8,-8,2.833333,1.75,2.539993,-2.539993,-15,15,-2.539993,2.539993,45,182,23,22,1,-1,1.08333325386047,-1.08333325386047,3,0,1,0,3,-3,1,-1,217,133,84,-84
Donald Cerrone,Mike Perry,Donald Cerrone,2018-11-10,1,0,8,-8,2.117647,1.75,7.619995,-7.619995,-15,15,5.080002,-5.080002,40,58,53,22,31,-31,0.367647171020508,-0.367647171020508,0,1,4,0,-1,1,4,-4,140,126,14,-14
Alex Oliveira,Mike Perry,Mike Perry,2019-04-27,0,1,4,-4,1.833333,1.75,2.539993,-2.539993,0,0,12.7,-12.7,78,130,34,22,12,-12,8.33333730697632e-02,-8.33333730697632e-02,1,0,0,0,1,-1,0,0,217,168,49,-49
Vicente Luque,Mike Perry,Vicente Luque,2019-08-10,1,0,0,0,2.444444,1.75,2.539993,-2.539993,0,0,10.16,-10.16,0,200,31,22,9,-9,0.694444417953491,-0.694444417953491,4,1,0,0,3,-3,0,0,308,105,203,-203
Geoff Neal,Mike Perry,Geoff Neal,2019-12-14,1,0,1,-1,3,1.75,2.539993,-2.539993,0,0,10.16,-10.16,2,0,20,22,-2,2,1.25,-1.25,1,0,0,0,1,-1,0,0,140,126,14,-14
Mickey Gall,Mike Perry,Mike Perry,2020-06-27,0,1,0,0,1.4,1.75,10.16,-10.16,0,0,7.62001,-7.62001,51,344,12,22,-10,10,-0.350000023841858,0.350000023841858,1,0,1,1,1,-1,0,0,329,196,133,-133
Tim Means,Mike Perry,Tim Means,2020-11-21,1,0,7,-7,2.2,1.75,10.16,-10.16,0,0,10.16,-10.16,39,188,48,22,26,-26,0.450000047683716,-0.450000047683716,1,1,1,1,0,0,0,0,105,147,-42,42
Brock Larson,Mike Pierce,Mike Pierce,2009-09-16,0,1,3,-3,4.2,2.428571,7.619995,-7.619995,0,0,0,0,49,707,52,24,28,-28,1.77142834663391,-1.77142834663391,3,0,0,0,3,-3,0,0,116,0,116,-116
Jon Fitch,Mike Pierce,Jon Fitch,2009-12-12,1,0,2,-2,4.285714,2.428571,10.16,-10.16,0,0,7.62001,-7.62001,258,189,37,24,13,-13,1.85714268684387,-1.85714268684387,2,1,0,0,1,-1,0,0,154,87,67,-67
Julio Paulino,Mike Pierce,Mike Pierce,2010-03-21,0,1,5,-5,4.6,2.428571,10.16,-10.16,0,0,4.660004,-4.660004,0,694,28,24,4,-4,2.17142844200134,-2.17142844200134,0,0,0,0,0,0,0,0,0,99,-99,99
Amilcar Alves,Mike Pierce,Mike Pierce,2010-08-28,0,1,-7,7,1.25,2.428571,10.16,-10.16,0,0,6.199997,-6.199997,0,719,27,24,3,-3,-1.17857146263123,1.17857146263123,0,1,0,0,-1,1,0,0,0,160,-160,160
Johny Hendricks,Mike Pierce,Johny Hendricks,2011-08-06,1,0,-3,3,2.25,2.428571,2.539993,-2.539993,15,-15,-5.080002,5.080002,112,190,26,24,2,-2,-0.178571462631226,0.178571462631226,1,2,0,0,-1,1,0,0,133,343,-210,210
Paul Bradley,Mike Pierce,Mike Pierce,2011-11-12,0,1,-3,3,2.875,2.428571,2.539993,-2.539993,0,0,-2.339996,2.339996,63,36,31,24,7,-7,0.446428537368774,-0.446428537368774,0,0,0,0,0,0,0,0,98,98,0,0
Josh Koscheck,Mike Pierce,Josh Koscheck,2012-02-04,1,0,3,-3,1.545455,2.428571,5.080002,-5.080002,0,0,5.080002,-5.080002,157,158,28,24,4,-4,-0.883116960525513,0.883116960525513,0,1,1,0,-1,1,1,-1,420,84,336,-336
Carlos Eduardo Rocha,Mike Pierce,Mike Pierce,2012-06-08,0,1,-1,1,2.25,2.428571,5.080002,-5.080002,0,0,5.080002,-5.080002,0,680,13,24,-11,11,-0.178571462631226,0.178571462631226,0,0,0,0,0,0,0,0,489,125,364,-364
Seth Baczynski,Mike Pierce,Mike Pierce,2012-12-14,0,1,-1,1,1.428571,2.428571,17.78,-17.78,0,0,10.16,-10.16,11,604,34,24,10,-10,-1,1,4,1,0,0,3,-3,0,0,83,189,-106,106
David Mitchell,Mike Pierce,Mike Pierce,2013-07-06,0,1,1,-1,3.142857,2.428571,10.16,-10.16,0,0,10.16,-10.16,17,280,29,24,5,-5,0.714285612106323,-0.714285612106323,1,2,0,0,-1,1,0,0,161,204,-43,43
Rousimar Palhares,Mike Pierce,Rousimar Palhares,2013-10-09,1,0,0,0,2.375,2.428571,0,0,0,0,0,0,4,9,27,24,3,-3,-5.35714626312256e-02,5.35714626312256e-02,1,3,0,0,-2,2,0,0,1964,95,1869,-1869
Ryan LaFlare,Mike Pierce,Ryan LaFlare,2015-12-11,1,0,-3,3,4.666667,2.428571,12.7,-12.7,0,0,7.62001,-7.62001,0,149,17,24,-7,7,2.23809504508972,-2.23809504508972,0,0,0,0,0,0,0,0,265,793,-528,528
Brock Larson,Mike Pyle,Brock Larson,2009-05-23,1,0,-2,2,4.2,1.928571,-2.540009,2.540009,0,0,-7.62001,7.62001,128,0,52,41,11,-11,2.27142834663391,-2.27142834663391,2,0,0,0,2,-2,0,0,52,0,52,-52
Jake Ellenberger,Mike Pyle,Jake Ellenberger,2010-01-02,1,0,-10,10,2.066667,1.928571,-7.62001,7.62001,0,0,-7.62001,7.62001,278,0,46,41,5,-5,0.138095140457153,-0.138095140457153,0,0,0,0,0,0,0,0,0,224,-224,224
Jesse Lennox,Mike Pyle,Mike Pyle,2010-06-12,0,1,-6,6,3.5,1.928571,-7.62001,7.62001,0,0,-5.080002,5.080002,136,169,18,41,-23,23,1.57142853736877,-1.57142853736877,0,0,0,1,0,0,-1,1,152,161,-9,9
John Hathaway,Mike Pyle,Mike Pyle,2010-10-16,0,1,-12,12,8.5,1.928571,2.539993,-2.539993,0,0,2.539993,-2.539993,49,436,19,41,-22,22,6.57142853736877,-6.57142853736877,3,1,0,1,2,-2,-1,1,140,126,14,-14
Ricardo Almeida,Mike Pyle,Mike Pyle,2011-03-19,0,1,-1,1,2.6,1.928571,0,0,0,0,0,0,312,55,18,41,-23,23,0.671428442001343,-0.671428442001343,1,2,1,1,-1,1,0,0,98,154,-56,56
Rory MacDonald,Mike Pyle,Rory MacDonald,2011-08-06,1,0,-13,13,4.75,1.928571,0,0,0,0,5.079987,-5.079987,109,61,23,41,-18,18,2.82142853736877,-2.82142853736877,0,3,0,1,-3,3,-1,1,0,140,-140,140
Ricardo Funch,Mike Pyle,Mike Pyle,2012-01-14,0,1,-5,5,1.5,1.928571,-5.080002,5.080002,0,0,0,0,0,3,15,41,-26,26,-0.428571462631226,0.428571462631226,0,0,0,2,0,0,-2,2,581,161,420,-420
Josh Neer,Mike Pyle,Mike Pyle,2012-06-08,0,1,-7,7,2.25,1.928571,-2.540009,2.540009,0,0,-5.080002,5.080002,9,175,52,41,11,-11,0.321428537368774,-0.321428537368774,1,1,0,2,0,0,-2,2,251,146,105,-105
James Head,Mike Pyle,Mike Pyle,2012-12-15,0,1,-9,9,2.25,1.928571,2.539993,-2.539993,0,0,-2.540009,2.540009,20,6,13,41,-28,28,0.321428537368774,-0.321428537368774,0,2,0,2,-2,2,-2,2,553,190,363,-363
Matt Brown,Mike Pyle,Matt Brown,2013-08-17,1,0,-5,5,1.368421,1.928571,0,0,0,0,2.539993,-2.539993,6,0,45,41,4,-4,-0.560150384902954,0.560150384902954,6,3,0,2,3,-3,-2,2,119,245,-126,126
Jordan Mein,Mike Pyle,Jordan Mein,2014-08-23,1,0,-14,14,2.583333,1.928571,0,0,0,0,-2.540009,2.540009,0,4,43,41,2,-2,0.654761791229248,-0.654761791229248,2,0,0,3,2,-2,-3,3,126,371,-245,245
Colby Covington,Mike Pyle,Colby Covington,2015-05-23,1,0,-12,12,5.666667,1.928571,-2.540009,2.540009,0,0,-5.080002,5.080002,683,42,20,41,-21,21,3.73809504508972,-3.73809504508972,2,0,0,4,2,-2,-4,4,196,273,-77,77
Alberto Mina,Mike Pyle,Alberto Mina,2016-07-07,1,0,-6,6,13,1.928571,0,0,0,0,7.619995,-7.619995,176,0,14,41,-27,27,11.0714285373688,-11.0714285373688,0,0,0,4,0,0,-4,4,0,411,-411,411
Alex Garcia,Mike Pyle,Alex Garcia,2016-12-30,1,0,-12,12,2.5,1.928571,-7.62001,7.62001,0,0,-5.080002,5.080002,89,0,21,41,-20,20,0.571428537368774,-0.571428537368774,0,0,1,5,0,0,-4,4,313,176,137,-137
Zak Ottow,Mike Pyle,Zak Ottow,2018-03-03,1,0,-11,11,2.428571,1.928571,-2.540009,2.540009,0,0,-5.080002,5.080002,20,0,24,41,-17,17,0.5,-0.5,0,0,0,6,0,0,-6,6,0,428,-428,428
Colin Fletcher,Mike Ricci,Mike Ricci,2013-03-16,0,1,4,-4,1.75,2.2,5.080002,-5.080002,0,0,-2.039993,2.039993,75,219,22,16,6,-6,-0.450000047683716,0.450000047683716,0,0,0,0,0,0,0,0,92,0,92,-92
Myles Jury,Mike Ricci,Myles Jury,2013-09-21,1,0,-3,3,4.25,2.2,-5.080002,5.080002,-10,10,-7.619995,7.619995,351,46,21,16,5,-5,2.04999995231628,-2.04999995231628,2,1,0,0,1,-1,0,0,154,189,-35,35
John Cofer,Mike Rio,Mike Rio,2012-12-15,0,1,-3,3,2,2,-2.540009,2.540009,0,0,0.1999969,-0.1999969,182,352,12,15,-3,3,0,0,0,0,1,0,0,0,1,-1,197,0,197,-197
Tony Ferguson,Mike Rio,Tony Ferguson,2013-10-19,1,0,-3,3,2.888889,2,2.539993,-2.539993,0,0,15.23999,-15.23999,17,17,35,15,20,-20,0.888888835906982,-0.888888835906982,0,1,0,0,-1,1,0,0,532,308,224,-224
Daron Cruickshank,Mike Rio,Daron Cruickshank,2014-01-25,1,0,-4,4,1.8,2,-5.080002,5.080002,0,0,5.080002,-5.080002,86,2,28,15,13,-13,-0.200000047683716,0.200000047683716,0,0,0,0,0,0,0,0,77,98,-21,21
Devin Clark,Mike Rodriguez,Devin Clark,2018-04-07,1,0,-2,2,1.75,1.571429,-10.15999,10.15999,0,0,-17.78,17.78,685,38,22,18,4,-4,0.178571462631226,-0.178571462631226,2,0,1,0,2,-2,1,-1,357,0,357,-357
Adam Milstead,Mike Rodriguez,Mike Rodriguez,2018-12-15,0,1,1,-1,2,1.571429,-2.539993,2.539993,0,0,-15.24001,15.24001,0,112,12,18,-6,6,0.428571462631226,-0.428571462631226,0,0,0,0,0,0,0,0,0,252,-252,252
Marcin Prachnio,Mike Rodriguez,Mike Rodriguez,2020-08-22,0,1,1,-1,2.285714,1.571429,-2.539993,2.539993,0,0,-20.31999,20.31999,25,16,23,18,5,-5,0.714285850524902,-0.714285850524902,0,1,0,0,-1,1,0,0,0,616,-616,616
Ed Herman,Mike Rodriguez,Ed Herman,2020-09-12,1,0,8,-8,1.6875,1.571429,-7.619995,7.619995,0,0,-12.7,12.7,249,196,43,18,25,-25,0.116071462631226,-0.116071462631226,1,2,2,0,-1,1,2,-2,308,21,287,-287
Danilo Marques,Mike Rodriguez,Danilo Marques,2021-02-06,1,0,3,-3,2.75,1.571429,5.080002,-5.080002,0,0,-12.7,12.7,459,4,15,18,-3,3,1.17857146263123,-1.17857146263123,0,0,0,0,0,0,0,0,0,147,-147,147
Tafon Nchukwi,Mike Rodriguez,Tafon Nchukwi,2021-09-18,1,0,-6,6,1.5,1.571429,-10.15999,10.15999,-20,20,-12.7,12.7,285,2,10,18,-8,8,-7.14285373687744e-02,7.14285373687744e-02,0,0,0,0,0,0,0,0,133,224,-91,91
Justin McCully,Mike Russow,Mike Russow,2009-08-29,0,1,1,-1,2.2,5,0,0,-30,30,0,0,31,684,16,18,-2,2,-2.79999995231628,2.79999995231628,1,0,0,0,1,-1,0,0,262,0,262,-262
Todd Duffee,Mike Russow,Mike Russow,2010-05-29,0,1,-9,9,3,5,5.080002,-5.080002,5,-5,12.7,-12.7,1,3,12,18,-6,6,-2,2,1,1,0,0,0,0,0,0,273,273,0,0
Jon Madsen,Mike Russow,Mike Russow,2011-03-26,0,1,-3,3,4,5,-2.539993,2.539993,-15,15,-2.539993,2.539993,0,206,10,18,-8,8,-1,1,3,2,0,0,1,-1,0,0,154,301,-147,147
Jon Olav Einemo,Mike Russow,Mike Russow,2012-01-28,0,1,1,-1,2,5,12.7,-12.7,-2,2,15.58,-15.58,3,648,9,18,-9,9,-3,3,0,3,0,0,-3,3,0,0,0,308,-308,308
Shawn Jordan,Mike Russow,Shawn Jordan,2013-01-26,1,0,-8,8,2.375,5,-2.539993,2.539993,5,-5,5.080002,-5.080002,124,218,27,18,9,-9,-2.625,2.625,0,4,0,0,-4,4,0,0,189,364,-175,175
Zabit Magomedsharipov,Mike Santiago,Zabit Magomedsharipov,2017-09-02,1,0,-2,2,18,1.583333,7.619995,-7.619995,0,0,10.16,-10.16,244,145,19,31,-12,12,16.4166666269302,-16.4166666269302,0,0,0,0,0,0,0,0,0,0,0,0
Mads Burnell,Mike Santiago,Mads Burnell,2018-01-14,1,0,-5,5,3,1.583333,-5.080002,5.080002,0,0,0,0,553,271,12,31,-19,19,1.41666662693024,-1.41666662693024,0,0,0,0,0,0,0,0,134,134,0,0
Dan Ige,Mike Santiago,Dan Ige,2018-06-09,1,0,-2,2,2.428571,1.583333,-7.62001,7.62001,0,0,5.080002,-5.080002,32,0,24,31,-7,7,0.845238089561462,-0.845238089561462,0,0,0,0,0,0,0,0,0,146,-146,146
Pascal Krauss,Mike Stumpf,Pascal Krauss,2013-01-26,1,0,-1,1,5.5,2.75,7.619995,-7.619995,0,0,5,-5,225,150,13,15,-2,2,2.75,-2.75,1,0,0,0,1,-1,0,0,805,0,805,-805
Alex Schoenauer,Mike Swick,Mike Swick,2005-04-09,0,1,3,-3,1.5,2.5,5.080002,-5.080002,15,-15,-2.580002,2.580002,0,0,25,21,4,-4,-1,1,0,0,0,0,0,0,0,0,0,0,0,0
Gideon Ray,Mike Swick,Mike Swick,2005-08-06,0,1,6,-6,1.133333,2.5,-7.619995,7.619995,15,-15,-15.58,15.58,0,3,32,21,11,-11,-1.36666667461395,1.36666667461395,0,1,0,0,-1,1,0,0,0,119,-119,119
Joe Riggs,Mike Swick,Mike Swick,2006-05-27,0,1,-3,3,2.588235,2.5,-2.539993,2.539993,15,-15,-17.78,17.78,27,10,61,21,40,-40,8.82353782653809e-02,-8.82353782653809e-02,0,2,0,0,-2,2,0,0,406,294,112,-112
David Loiseau,Mike Swick,Mike Swick,2006-09-23,0,1,-1,1,2.090909,2.5,-2.539993,2.539993,15,-15,-2.540009,2.540009,162,209,34,21,13,-13,-0.409090995788574,0.409090995788574,3,3,0,0,0,0,0,0,355,119,236,-236
Yushin Okami,Mike Swick,Yushin Okami,2007-04-07,1,0,-2,2,2.833333,2.5,2.540009,-2.540009,0,0,-5.080002,5.080002,434,59,46,21,25,-25,0.333333253860474,-0.333333253860474,2,4,0,0,-2,2,0,0,98,196,-98,98
Joshua Burkman,Mike Swick,Mike Swick,2008-01-23,0,1,-1,1,1.75,2.5,-7.619995,7.619995,0,0,-12.7,12.7,344,84,44,21,23,-23,-0.75,0.75,1,0,0,0,1,-1,0,0,95,291,-196,196
Marcus Davis,Mike Swick,Mike Swick,2008-06-07,0,1,6,-6,2,2.5,-7.619995,7.619995,0,0,-17.78,17.78,134,520,33,21,12,-12,-0.5,0.5,5,1,1,0,4,-4,1,-1,140,136,4,-4
Jonathan Goulet,Mike Swick,Mike Swick,2008-12-10,0,1,0,0,1.916667,2.5,-2.539993,2.539993,0,0,-10.16,10.16,0,9,35,21,14,-14,-0.583333373069763,0.583333373069763,1,2,2,0,-1,1,2,-2,235,186,49,-49
Ben Saunders,Mike Swick,Mike Swick,2009-06-13,0,1,-3,3,1.692308,2.5,2.540009,-2.540009,0,0,0,0,38,327,35,21,14,-14,-0.807692289352417,0.807692289352417,2,3,0,0,-1,1,0,0,185,185,0,0
Dan Hardy,Mike Swick,Dan Hardy,2009-11-14,1,0,-3,3,2.5,2.5,-2.539993,2.539993,0,0,-7.619995,7.619995,359,159,35,21,14,-14,0,0,1,4,0,0,-3,3,0,0,266,154,112,-112
DaMarques Johnson,Mike Swick,Mike Swick,2012-08-04,0,1,-3,3,1,2.5,0,0,0,0,-5.080002,5.080002,203,13,30,21,9,-9,-1.5,1.5,0,0,2,0,0,0,2,-2,112,994,-882,882
Matt Brown,Mike Swick,Matt Brown,2012-12-08,1,0,-2,2,1.368421,2.5,-2.539993,2.539993,0,0,-5.080002,5.080002,61,181,45,21,24,-24,-1.13157892227173,1.13157892227173,4,1,0,0,3,-3,0,0,169,126,43,-43
Alex Garcia,Mike Swick,Alex Garcia,2015-07-11,1,0,-9,9,2.5,2.5,-10.16,10.16,0,0,-12.7,12.7,362,9,21,21,0,0,0,0,0,0,0,1,0,0,-1,1,322,945,-623,623
Joe Pardo,Mike van Arsdale,Mike van Arsdale,1998-05-15,0,1,,,0.6666667,1.6,-2.540009,2.540009,5,-5,-3,3,0,0,10,13,-3,3,-0.933333337306976,0.933333337306976,0,0,0,0,0,0,0,0,0,0,0,0
John Marsh,Mike van Arsdale,Mike van Arsdale,2005-04-16,0,1,-5,5,1.142857,1.6,-5.080002,5.080002,60,-60,2,-2,161,446,15,13,2,-2,-0.45714282989502,0.45714282989502,0,1,0,0,-1,1,0,0,0,2528,-2528,2528
Randy Couture,Mike van Arsdale,Randy Couture,2005-08-20,1,0,2,-2,1.727273,1.6,-2.540009,2.540009,0,0,-0.5,0.5,427,69,30,13,17,-17,0.127272725105286,-0.127272725105286,0,2,2,0,-2,2,2,-2,126,126,0,0
Renato Sobral,Mike van Arsdale,Renato Sobral,2006-02-04,1,0,-10,10,3.363636,1.6,-2.540009,2.540009,0,0,-0.5,0.5,96,14,48,13,35,-35,1.76363623142242,-1.76363623142242,2,0,0,0,2,-2,0,0,120,168,-48,48
Antoni Hardonk,Mike Wessel,Antoni Hardonk,2008-12-27,1,0,1,-1,1.333333,1.875,10.15999,-10.15999,-15,15,13.12,-13.12,96,237,14,23,-9,9,-0.541666626930237,0.541666626930237,2,0,0,0,2,-2,0,0,203,0,203,-203
Keith Jardine,Mike Whitehead,Keith Jardine,2006-02-04,1,0,6,-6,1.545455,3.375,2.540009,-2.540009,-20,20,5.039993,-5.039993,0,383,28,35,-7,7,-1.82954549789429,1.82954549789429,1,0,0,0,1,-1,0,0,91,0,91,-91
Brendan Loughnane,Mike Wilkinson,Mike Wilkinson,2012-12-14,0,1,-2,2,5.666667,2.25,7.62001,-7.62001,0,0,10.16,-10.16,114,232,20,13,7,-7,3.41666650772095,-3.41666650772095,0,0,0,0,0,0,0,0,0,0,0,0
Rony Jason,Mike Wilkinson,Rony Jason,2013-06-08,1,0,4,-4,2,2.25,0,0,0,0,17.78,-17.78,0,44,21,13,8,-8,-0.25,0.25,2,1,0,0,1,-1,0,0,238,176,62,-62
Niklas Backstrom,Mike Wilkinson,Mike Wilkinson,2014-10-04,0,1,-2,2,3.666667,2.25,15.24001,-15.24001,0,0,21.49001,-21.49001,0,2,14,13,1,-1,1.41666674613953,-1.41666674613953,1,0,0,0,1,-1,0,0,126,483,-357,357
Makwan Amirkhani,Mike Wilkinson,Makwan Amirkhani,2016-02-27,1,0,-1,1,1.888889,2.25,7.62001,-7.62001,0,0,15.24001,-15.24001,607,155,26,13,13,-13,-0.361111164093018,0.361111164093018,2,1,0,0,1,-1,0,0,252,511,-259,259
Mario Bautista,Miles Johns,Mario Bautista,2020-02-08,1,0,1,-1,6.5,7,5.080002,-5.080002,0,0,7.619995,-7.619995,4,0,15,16,-1,1,-0.5,0.5,1,0,0,0,1,-1,0,0,203,0,203,-203
Anderson Dos Santos,Miles Johns,Miles Johns,2021-08-07,0,1,9,-9,2.333333,7,-5.079987,5.079987,0,0,10.16,-10.16,9,0,30,16,14,-14,-4.66666674613953,4.66666674613953,0,0,0,1,0,0,-1,1,777,546,231,-231
John Castaneda,Miles Johns,John Castaneda,2022-02-05,1,0,3,-3,3.333333,7,-2.539993,2.539993,0,0,12.7,-12.7,105,0,26,16,10,-10,-3.66666674613953,3.66666674613953,1,1,0,1,0,0,-1,1,350,182,168,-168
Dan Argueta,Miles Johns,Miles Johns,2023-09-23,0,1,1,-1,4.5,7,0,0,0,0,5.080002,-5.080002,235,279,11,16,-5,5,-2.5,2.5,0,0,0,1,0,0,-1,1,476,595,-119,119
Godofredo Pepey,Milton Vieira,Godofredo Pepey,2013-01-19,1,0,-9,9,2.166667,1.625,-12.70001,12.70001,0,0,0.4199982,-0.4199982,252,361,19,21,-2,2,0.541666746139526,-0.541666746139526,0,0,0,0,0,0,0,0,0,0,0,0
Royce Gracie,Minoki Ichihara,Royce Gracie,1994-03-11,1,0,,,7.5,0,15.24001,-15.24001,-3,3,20,-20,0,0,17,1,16,-16,7.5,-7.5,1,0,0,0,1,-1,0,0,0,0,0,0
Hannah Goldy,Miranda Granger,Miranda Granger,2019-08-03,0,1,0,0,1.5,2.333333,-7.619995,7.619995,0,0,-17.78,17.78,90,5,10,10,0,0,-0.833333253860474,0.833333253860474,0,0,0,0,0,0,0,0,0,0,0,0
Liana Jojua,Miranda Maverick,Miranda Maverick,2020-10-24,0,1,2,-2,1.6,2.8,2.539993,-2.539993,0,0,-7.62001,7.62001,0,0,13,19,-6,6,-1.19999992847443,1.19999992847443,0,0,1,0,0,0,1,-1,413,0,413,-413
Maycee Barber,Miranda Maverick,Maycee Barber,2021-07-24,1,0,-1,1,6.5,2.8,5.080002,-5.080002,0,0,0,0,146,81,15,19,-4,4,3.70000004768372,-3.70000004768372,0,1,0,0,-1,1,0,0,161,273,-112,112
Erin Blanchfield,Miranda Maverick,Erin Blanchfield,2021-12-11,1,0,-2,2,12,2.8,2.539993,-2.539993,0,0,2.539993,-2.539993,720,6,13,19,-6,6,9.20000004768372,-9.20000004768372,0,0,0,0,0,0,0,0,0,140,-140,140
Jasmine Jasudavicius,Miranda Maverick,Jasmine Jasudavicius,2023-06-10,1,0,9,-9,3,2.8,10.15999,-10.15999,0,0,7.619995,-7.619995,455,7,12,19,-7,7,0.200000047683716,-0.200000047683716,0,0,0,0,0,0,0,0,357,546,-189,189
Priscila Cachoeira,Miranda Maverick,Miranda Maverick,2023-07-29,0,1,8,-8,2.4,2.8,10.15999,-10.15999,0,0,0,0,0,534,17,19,-2,2,-0.399999856948853,0.399999856948853,2,0,0,0,2,-2,0,0,350,49,301,-301
Mostapha Al-Turk,Mirko Filipovic,Mirko Filipovic,2009-06-13,0,1,1,-1,1,3.181818,0,0,15,-15,10.16,-10.16,5,15,12,46,-34,34,-2.18181824684143,2.18181824684143,0,0,1,0,0,0,1,-1,168,0,168,-168
Junior Dos Santos,Mirko Filipovic,Junior Dos Santos,2009-09-19,1,0,-10,10,2.333333,3.181818,5.079987,-5.079987,8,-8,10.16,-10.16,48,23,30,46,-16,16,-0.848484992980957,0.848484992980957,2,1,0,0,1,-1,0,0,210,98,112,-112
Pat Barry,Mirko Filipovic,Mirko Filipovic,2010-06-12,0,1,-5,5,1.142857,3.181818,-7.62001,7.62001,5,-5,2.540009,-2.540009,4,267,15,46,-31,31,-2.03896105289459,2.03896105289459,1,0,0,1,1,-1,-1,1,231,266,-35,35
John Cholish,Mitch Clarke,John Cholish,2011-12-10,1,0,1,-1,2.666667,2.2,2.539993,-2.539993,0,0,2.540009,-2.540009,173,16,11,16,-5,5,0.466666698455811,-0.466666698455811,0,0,0,0,0,0,0,0,0,0,0,0
Michael Chiesa,Mitch Clarke,Michael Chiesa,2015-04-04,1,0,-2,2,2.571429,2.2,7.619995,-7.619995,15,-15,5.080002,-5.080002,321,156,25,16,9,-9,0.371428489685059,-0.371428489685059,0,0,1,1,0,0,0,0,211,1211,-1000,1000
Bryan Caraway,Mitch Gagnon,Bryan Caraway,2012-07-21,1,0,0,0,2.333333,2.4,7.619995,-7.619995,0,0,7.619995,-7.619995,319,200,30,17,13,-13,-6.6666841506958e-02,6.6666841506958e-02,1,0,0,0,1,-1,0,0,231,0,231,-231
Renan Barao,Mitch Gagnon,Renan Barao,2014-12-20,1,0,-3,3,3.777778,2.4,2.539993,-2.539993,10,-10,12.7,-12.7,142,255,43,17,26,-26,1.37777757644653,-1.37777757644653,0,0,1,0,0,0,1,-1,210,882,-672,672
Rodrigo Damm,Mizuto Hirota,Rodrigo Damm,2013-06-08,1,0,1,-1,1.444444,1.8,0,0,0,0,10.16,-10.16,104,0,22,28,-6,6,-0.355555534362793,0.355555534362793,1,0,0,0,1,-1,0,0,350,0,350,-350
Christos Giagos,Mizuto Hirota,Christos Giagos,2018-12-01,1,0,-9,9,1.818182,1.8,7.62001,-7.62001,0,0,10.16,-10.16,562,66,31,28,3,-3,1.81819200515747e-02,-1.81819200515747e-02,0,0,0,0,0,0,0,0,70,2002,-1932,1932
Zac Pauga,Mohammed Usman,Mohammed Usman,2022-08-06,0,1,1,-1,3.5,5.5,0,0,-34,34,-7.62001,7.62001,0,2,9,13,-4,4,-2,2,0,0,0,0,0,0,0,0,0,0,0,0
Junior Tafa,Mohammed Usman,Mohammed Usman,2023-04-22,0,1,-8,8,5,5.5,2.539993,-2.539993,1,-1,-10.16,10.16,0,723,6,13,-7,7,-0.5,0.5,0,1,0,0,-1,1,0,0,0,259,-259,259
Jake Collier,Mohammed Usman,Mohammed Usman,2023-09-23,0,1,0,0,1.3,5.5,2.539993,-2.539993,-9,9,-2.540009,2.540009,53,187,23,13,10,-10,-4.20000004768372,4.20000004768372,1,2,2,0,-1,1,2,-2,616,154,462,-462
Priscila Cachoeira,Molly McCann,Molly McCann,2019-03-16,0,1,2,-2,2.4,2.166667,7.619995,-7.619995,0,0,7.62001,-7.62001,66,74,17,19,-2,2,0.233333349227905,-0.233333349227905,0,0,0,0,0,0,0,0,406,0,406,-406
Ariane Lipski,Molly McCann,Molly McCann,2019-06-22,0,1,-4,4,2,2.166667,5.080002,-5.080002,0,0,12.7,-12.7,2,44,24,19,5,-5,-0.166666746139526,0.166666746139526,0,1,0,0,-1,1,0,0,154,98,56,-56
Diana Belbita,Molly McCann,Molly McCann,2019-10-18,0,1,-6,6,2.142857,2.166667,7.619995,-7.619995,-10,10,15.24001,-15.24001,86,219,22,19,3,-3,-2.38096714019775e-02,2.38096714019775e-02,0,2,0,0,-2,2,0,0,0,118,-118,118
Luana Carolina,Molly McCann,Molly McCann,2022-03-19,0,1,-3,3,2.25,2.166667,5.080002,-5.080002,0,0,17.78,-17.78,27,270,13,19,-6,6,8.33332538604736e-02,-8.33332538604736e-02,1,3,0,0,-2,2,0,0,154,883,-729,729
Hannah Goldy,Molly McCann,Molly McCann,2022-07-23,0,1,-2,2,1.5,2.166667,0,0,-10,10,-2.539993,2.539993,70,10,10,19,-9,9,-0.666666746139526,0.666666746139526,1,4,0,0,-3,3,0,0,308,126,182,-182
Erin Blanchfield,Molly McCann,Erin Blanchfield,2022-11-12,1,0,-9,9,12,2.166667,0,0,0,0,10.16,-10.16,168,0,13,19,-6,6,9.83333325386047,-9.83333325386047,1,5,0,0,-4,4,0,0,336,112,224,-224
Viviane Araujo,Montana De La Rosa,Viviane Araujo,2020-09-05,1,0,8,-8,2.2,1.5,-7.619995,7.619995,0,0,0,0,12,36,16,20,-4,4,0.700000047683716,-0.700000047683716,0,0,0,0,0,0,0,0,266,0,266,-266
Maycee Barber,Montana De La Rosa,Maycee Barber,2022-04-23,1,0,-4,4,6.5,1.5,-5.079987,5.079987,0,0,-7.619995,7.619995,420,355,15,20,-5,5,5,-5,1,0,0,0,1,-1,0,0,273,595,-322,322
Felipe Colares,Montel Jackson,Montel Jackson,2020-01-25,0,1,-2,2,2.5,6.5,-5.080002,5.080002,10,-10,-15.24001,15.24001,82,637,14,15,-1,1,-4,4,1,0,0,0,1,-1,0,0,189,0,189,-189
JP Buys,Montel Jackson,Montel Jackson,2021-09-18,0,1,-4,4,1.5,6.5,-12.7,12.7,0,0,-20.32001,20.32001,80,603,15,15,0,0,-5,5,0,1,1,0,-1,1,1,-1,182,602,-420,420
Julio Arce,Montel Jackson,Montel Jackson,2022-11-12,0,1,3,-3,3,6.5,-7.62001,7.62001,0,0,-12.7,12.7,6,355,24,15,9,-9,-3.5,3.5,1,2,1,0,-1,1,1,-1,217,420,-203,203
Jaqueline Amorim,Montserrat Conejo Ruiz,Jaqueline Amorim,2023-08-12,1,0,-2,2,7,3.333333,7.62001,-7.62001,0,0,17.78,-17.78,485,219,8,13,-5,5,3.66666674613953,-3.66666674613953,0,0,0,0,0,0,0,0,126,0,126,-126
Mark Coleman,Moti Horenstein,Mark Coleman,1996-07-12,1,0,,,1.6,0.1666667,-7.619995,7.619995,-25,25,-6.5,6.5,0,0,26,7,19,-19,1.43333335220814,-1.43333335220814,1,0,0,0,1,-1,0,0,0,0,0,0
Alex Caceres,Motonobu Tezuka,Alex Caceres,2012-11-10,1,0,-1,1,1.5,2.333333,7.62001,-7.62001,10,-10,12.42,-12.42,71,224,35,40,-5,5,-0.833333253860474,0.833333253860474,1,0,0,0,1,-1,0,0,122,0,122,-122
Vaughan Lee,Motonobu Tezuka,Vaughan Lee,2013-02-16,1,0,5,-5,1.076923,2.333333,-2.539993,2.539993,-10,10,-5.360001,5.360001,71,471,27,40,-13,13,-1.25641012191772,1.25641012191772,1,0,0,0,1,-1,0,0,357,98,259,-259
Warlley Alves,Mounir Lazzez,Warlley Alves,2021-01-20,1,0,-3,3,2.5,3.666667,-5.080002,5.080002,0,0,-10.15999,10.15999,96,42,21,14,7,-7,-1.16666674613953,1.16666674613953,0,0,1,0,0,0,1,-1,431,0,431,-431
Gabriel Bonfim,Mounir Lazzez,Gabriel Bonfim,2023-01-21,1,0,-10,10,15,3.666667,0,0,0,0,-10.15999,10.15999,4,0,15,14,1,-1,11.3333332538605,-11.3333332538605,0,0,0,1,0,0,-1,1,0,731,-731,731
SeungWoo Choi,Movsar Evloev,Movsar Evloev,2019-04-20,0,1,1,-1,1.833333,17,12.70001,-12.70001,0,0,5.080002,-5.080002,2,699,17,17,0,0,-15.1666666269302,15.1666666269302,0,0,0,0,0,0,0,0,0,0,0,0
Enrique Barzola,Movsar Evloev,Movsar Evloev,2019-10-26,0,1,5,-5,3.4,17,0,0,0,0,-5.080002,5.080002,38,132,22,17,5,-5,-13.5999999046326,13.5999999046326,4,1,0,0,3,-3,0,0,77,189,-112,112
Hakeem Dawodu,Movsar Evloev,Movsar Evloev,2021-06-12,0,1,2,-2,3.25,17,2.540009,-2.540009,0,0,2.539993,-2.539993,16,535,17,17,0,0,-13.75,13.75,2,2,0,0,0,0,0,0,259,595,-336,336
Cody Durden,Muhammad Mokaev,Muhammad Mokaev,2022-03-19,0,1,9,-9,4,10,0,0,0,0,-7.62001,7.62001,0,11,20,10,10,-10,-6,6,0,0,0,0,0,0,0,0,455,0,455,-455
Charles Johnson,Muhammad Mokaev,Muhammad Mokaev,2022-07-23,0,1,10,-10,2.6,10,5.080002,-5.080002,0,0,0,0,27,704,18,10,8,-8,-7.40000009536743,7.40000009536743,0,1,0,0,-1,1,0,0,0,126,-126,126
Malcolm Gordon,Muhammad Mokaev,Muhammad Mokaev,2022-10-22,0,1,10,-10,2,10,0,0,0,0,2.539993,-2.539993,169,618,21,10,11,-11,-8,8,0,2,0,0,-2,2,0,0,0,91,-91,91
Jafel Filho,Muhammad Mokaev,Muhammad Mokaev,2023-03-18,0,1,7,-7,5,10,0,0,0,0,-5.080002,5.080002,50,495,18,10,8,-8,-5,5,0,3,0,0,-3,3,0,0,0,147,-147,147
Jamie Mullarkey,Muhammad Naimov,Muhammad Naimov,2023-06-03,0,1,0,0,2.833333,4.5,7.62001,-7.62001,10,-10,10.16,-10.16,148,1,23,11,12,-12,-1.66666674613953,1.66666674613953,1,0,1,0,1,-1,1,-1,112,0,112,-112
John Castaneda,Muin Gafurov,John Castaneda,2023-06-03,1,0,4,-4,3.333333,3.6,-2.539993,2.539993,0,0,7.619995,-7.619995,256,115,26,23,3,-3,-0.266666650772095,0.266666650772095,0,0,1,0,0,0,1,-1,245,0,245,-245
Yoji Anjo,Murilo Bustamante,Murilo Bustamante,2000-04-14,0,1,0,0,0,1.875,-7.62001,7.62001,22,-22,-7.050003,7.050003,12,290,5,23,-18,18,-1.875,1.875,0,0,0,0,0,0,0,0,0,0,0,0
Alex Garcia,Muslim Salikhov,Alex Garcia,2017-11-25,1,0,-3,3,2.5,4.75,-5.080002,5.080002,0,0,5.080002,-5.080002,188,0,21,23,-2,2,-2.25,2.25,0,0,1,0,0,0,1,-1,153,0,153,-153
Ricky Rainey,Muslim Salikhov,Muslim Salikhov,2018-04-14,0,1,1,-1,2,4.75,5.080002,-5.080002,0,0,17.78,-17.78,5,20,18,23,-5,5,-2.75,2.75,0,0,0,0,0,0,0,0,0,140,-140,140
Li Jingliang,Muslim Salikhov,Li Jingliang,2022-07-16,1,0,-4,4,2.375,4.75,2.540009,-2.540009,0,0,2.539993,-2.539993,30,70,27,23,4,-4,-2.375,2.375,1,1,0,0,0,0,0,0,546,1554,-1008,1008
Andre Fialho,Muslim Salikhov,Muslim Salikhov,2022-11-19,0,1,-10,10,2,4.75,2.540009,-2.540009,0,0,10.16,-10.16,20,187,24,23,1,-1,-2.75,2.75,0,0,1,1,0,0,0,0,161,126,35,-35
Nicolas Dalby,Muslim Salikhov,Nicolas Dalby,2023-06-17,1,0,-1,1,5.5,4.75,0,0,0,0,10.16,-10.16,396,55,26,23,3,-3,0.75,-0.75,1,1,0,1,0,0,-1,1,329,210,119,-119
Michael Johnson,Myles Jury,Myles Jury,2012-12-29,0,1,2,-2,1.157895,4.25,0,0,10,-10,0,0,0,630,41,21,20,-20,-3.09210526943207,3.09210526943207,1,0,0,0,1,-1,0,0,336,0,336,-336
Takanori Gomi,Myles Jury,Myles Jury,2014-09-20,0,1,10,-10,2.5,4.25,-7.62001,7.62001,10,-10,-7.619995,7.619995,0,5,49,21,28,-28,-1.75,1.75,1,1,0,0,0,0,0,0,147,630,-483,483
Donald Cerrone,Myles Jury,Donald Cerrone,2015-01-03,1,0,5,-5,2.117647,4.25,7.619995,-7.619995,10,-10,0,0,221,121,53,21,32,-32,-2.13235282897949,2.13235282897949,3,2,1,0,1,-1,1,-1,171,105,66,-66
Mike de la Torre,Myles Jury,Myles Jury,2017-04-08,0,1,2,-2,2,4.25,2.539993,-2.539993,0,0,-5.080002,5.080002,0,183,21,21,0,0,-2.25,2.25,0,0,0,0,0,0,0,0,196,826,-630,630
Ricky Glenn,Myles Jury,Myles Jury,2017-12-30,0,1,-1,1,3.142857,4.25,5.080002,-5.080002,10,-10,-7.619995,7.619995,127,285,29,21,8,-8,-1.10714292526245,1.10714292526245,2,1,0,0,1,-1,0,0,112,266,-154,154
Andre Fili,Myles Jury,Andre Fili,2019-02-17,1,0,-2,2,2.2,4.25,2.539993,-2.539993,0,0,2.540009,-2.540009,0,50,32,21,11,-11,-2.04999995231628,2.04999995231628,0,2,1,0,-2,2,1,-1,176,414,-238,238
Anderson Dos Santos,Nad Narimani,Nad Narimani,2018-11-17,0,1,2,-2,2.333333,3,-7.619995,7.619995,-10,10,0,0,18,280,30,16,14,-14,-0.666666746139526,0.666666746139526,0,0,0,0,0,0,0,0,0,0,0,0
Mike Grundy,Nad Narimani,Mike Grundy,2019-03-16,1,0,1,-1,3,3,-2.540009,2.540009,0,0,5.080002,-5.080002,63,0,16,16,0,0,0,0,0,1,0,0,-1,1,0,0,0,119,-119,119
Grant Dawson,Nad Narimani,Grant Dawson,2020-07-18,1,0,-7,7,20,3,5.080002,-5.080002,10,-10,5.080002,-5.080002,491,9,21,16,5,-5,17,-17,3,0,0,1,3,-3,-1,1,140,490,-350,350
Alex Chambers,Nadia Kassem,Nadia Kassem,2017-11-18,0,1,17,-17,1,2.5,-5.080002,5.080002,-10,10,-7.619995,7.619995,463,88,10,7,3,-3,-1.5,1.5,0,0,0,0,0,0,0,0,805,0,805,-805
Montana De La Rosa,Nadia Kassem,Montana De La Rosa,2019-02-09,1,0,0,0,1.5,2.5,5.079987,-5.079987,0,0,5.080002,-5.080002,382,50,20,7,13,-13,-1,1,2,1,0,0,1,-1,0,0,218,448,-230,230
Leonard Garcia,Nam Phan,Leonard Garcia,2010-12-04,1,0,4,-4,1.384615,1.235294,10.16,-10.16,10,-10,-5.080002,5.080002,56,161,31,38,-7,7,0.149321317672729,-0.149321317672729,0,0,0,0,0,0,0,0,1172,0,1172,-1172
Mike Brown,Nam Phan,Mike Brown,2011-08-06,1,0,7,-7,2.888889,1.235294,0,0,10,-10,0,0,517,0,35,38,-3,3,1.65359473228455,-1.65359473228455,0,0,0,0,0,0,0,0,196,245,-49,49
Leonard Garcia,Nam Phan,Nam Phan,2011-10-08,0,1,4,-4,1.384615,1.235294,10.16,-10.16,10,-10,-5.080002,5.080002,26,93,31,38,-7,7,0.149321317672729,-0.149321317672729,0,0,0,0,0,0,0,0,196,63,133,-133
Jimy Hettes,Nam Phan,Jimy Hettes,2011-12-30,1,0,-4,4,3.666667,1.235294,7.619995,-7.619995,10,-10,2.539993,-2.539993,711,35,14,38,-24,24,2.43137264251709,-2.43137264251709,0,1,0,0,-1,1,0,0,0,83,-83,83
Cole Miller,Nam Phan,Nam Phan,2012-08-04,0,1,-1,1,1.909091,1.235294,17.78,-17.78,10,-10,7.619995,-7.619995,0,0,32,38,-6,6,0.673796772956848,-0.673796772956848,0,0,1,0,0,0,1,-1,155,218,-63,63
Takeya Mizugaki,Nam Phan,Takeya Mizugaki,2013-12-06,1,0,-1,1,1.909091,1.235294,2.539993,-2.539993,0,0,-2.540009,2.540009,123,0,32,38,-6,6,0.673796772956848,-0.673796772956848,1,1,0,0,0,0,0,0,100,489,-389,389
Vaughan Lee,Nam Phan,Vaughan Lee,2014-03-01,1,0,1,-1,1.076923,1.235294,0,0,-10,10,-10.16,10.16,1,13,27,38,-11,11,-0.158370971679688,0.158370971679688,2,0,0,0,2,-2,0,0,378,85,293,-293
Yan Cabral,Naoyuki Kotani,Yan Cabral,2014-10-25,1,0,-1,1,4.333333,2.428571,7.619995,-7.619995,0,0,17.78,-17.78,260,70,16,48,-32,32,1.90476202964783,-1.90476202964783,0,0,0,0,0,0,0,0,168,0,168,-168
Kajan Johnson,Naoyuki Kotani,Kajan Johnson,2015-09-26,1,0,-2,2,1.769231,2.428571,7.619995,-7.619995,0,0,22.86,-22.86,67,162,36,48,-12,12,-0.659340739250183,0.659340739250183,1,0,0,0,1,-1,0,0,133,336,-203,203
Marc Diakiese,Nasrat Haqparast,Nasrat Haqparast,2018-07-22,0,1,3,-3,2.285714,3,0,0,0,0,2.539993,-2.539993,0,34,23,20,3,-3,-0.714285612106323,0.714285612106323,0,0,0,0,0,0,0,0,204,0,204,-204
Thibault Gouti,Nasrat Haqparast,Nasrat Haqparast,2018-10-27,0,1,8,-8,2.4,3,0,0,0,0,0,0,0,175,17,20,-3,3,-0.599999904632568,0.599999904632568,0,1,1,0,-1,1,1,-1,251,97,154,-154
Drew Dober,Nasrat Haqparast,Drew Dober,2020-01-18,1,0,7,-7,2.166667,3,-5.080002,5.080002,0,0,-5.080002,5.080002,6,0,38,20,18,-18,-0.833333253860474,0.833333253860474,4,2,0,0,2,-2,0,0,203,448,-245,245
Rafa Garcia,Nasrat Haqparast,Nasrat Haqparast,2021-03-13,0,1,1,-1,5.333333,3,-7.62001,7.62001,0,0,-5.080002,5.080002,21,0,19,20,-1,1,2.33333349227905,-2.33333349227905,0,0,0,1,0,0,-1,1,0,420,-420,420
Bobby Green,Nasrat Haqparast,Bobby Green,2022-02-12,1,0,9,-9,2.142857,3,0,0,0,0,-2.540009,2.540009,0,0,44,20,24,-24,-0.857142925262451,0.857142925262451,1,1,1,1,0,0,0,0,98,336,-238,238
Phil Hawes,Nassourdine Imavov,Phil Hawes,2021-02-20,1,0,7,-7,2.4,3,-7.619995,7.619995,0,0,5.080002,-5.080002,666,7,17,16,1,-1,-0.599999904632568,0.599999904632568,1,0,0,0,1,-1,0,0,119,0,119,-119
Ian Heinisch,Nassourdine Imavov,Nassourdine Imavov,2021-07-24,0,1,6,-6,2.8,3,-10.16,10.16,0,0,-7.619995,7.619995,63,71,19,16,3,-3,-0.200000047683716,0.200000047683716,1,0,0,0,1,-1,0,0,413,154,259,-259
Joaquin Buckley,Nassourdine Imavov,Nassourdine Imavov,2022-09-03,0,1,1,-1,2.666667,3,-12.7,12.7,-15,15,2.539993,-2.539993,29,236,22,16,6,-6,-0.333333253860474,0.333333253860474,2,1,2,0,1,-1,2,-2,77,406,-329,329
Jasmine Jasudavicius,Natalia Silva,Natalia Silva,2022-06-18,0,1,8,-8,3,3.2,7.619995,-7.619995,0,0,7.619995,-7.619995,217,67,12,21,-9,9,-0.200000047683716,0.200000047683716,0,0,0,0,0,0,0,0,0,0,0,0
Tereza Bleda,Natalia Silva,Natalia Silva,2022-11-19,0,1,-5,5,7,3.2,12.7,-12.7,0,0,15.23999,-15.23999,296,133,8,21,-13,13,3.79999995231628,-3.79999995231628,0,1,0,0,-1,1,0,0,0,154,-154,154
Victoria Leonardo,Natalia Silva,Natalia Silva,2023-05-20,0,1,7,-7,1.5,3.2,2.540009,-2.540009,0,0,-2.540009,2.540009,0,16,15,21,-6,6,-1.70000004768372,1.70000004768372,0,2,0,0,-2,2,0,0,0,182,-182,182
Andrea Lee,Natalia Silva,Natalia Silva,2023-08-19,0,1,8,-8,1.625,3.2,5.080002,-5.080002,0,0,10.15999,-10.15999,0,0,21,21,0,0,-1.57500004768372,1.57500004768372,1,3,0,0,-2,2,0,0,826,91,735,-735
Rafa Garcia,Natan Levy,Rafa Garcia,2021-11-20,1,0,-3,3,5.333333,8,-5.080002,5.080002,0,0,-2.539993,2.539993,337,48,19,9,10,-10,-2.66666650772095,2.66666650772095,0,0,0,0,0,0,0,0,112,0,112,-112
Mike Breeden,Natan Levy,Natan Levy,2022-04-30,0,1,3,-3,1.666667,8,2.540009,-2.540009,0,0,-2.539993,2.539993,116,219,16,9,7,-7,-6.33333337306976,6.33333337306976,0,0,1,0,0,0,1,-1,210,161,49,-49
Junior Assuncao,Nate Diaz,Nate Diaz,2007-09-19,0,1,4,-4,2.666667,1.692308,-7.62001,7.62001,-25,25,-10.15999,10.15999,119,93,22,35,-13,13,0.974359035491943,-0.974359035491943,1,0,0,0,1,-1,0,0,151,0,151,-151
Marcus Davis,Nate Diaz,Nate Diaz,2010-08-28,0,1,12,-12,2,1.692308,-5.080002,5.080002,0,0,-15.23999,15.23999,12,144,33,35,-2,2,0.307692289352417,-0.307692289352417,1,1,2,0,0,0,2,-2,112,1074,-962,962
Donald Cerrone,Nate Diaz,Nate Diaz,2011-12-30,0,1,2,-2,2.117647,1.692308,2.539993,-2.539993,-15,15,-7.619995,7.619995,4,64,53,35,18,-18,0.425339460372925,-0.425339460372925,4,2,0,0,2,-2,0,0,62,489,-427,427
Herbert Burns,Nate Landwehr,Herbert Burns,2020-01-25,1,0,0,0,2.75,3.4,0,0,0,0,2.539993,-2.539993,95,33,15,22,-7,7,-0.650000095367432,0.650000095367432,0,0,0,0,0,0,0,0,0,0,0,0
Darren Elkins,Nate Landwehr,Nate Landwehr,2020-05-16,0,1,5,-5,2.454545,3.4,2.540009,-2.540009,0,0,-2.540009,2.540009,84,29,38,22,16,-16,-0.945454597473145,0.945454597473145,0,0,2,1,0,0,1,-1,308,112,196,-196
Julian Erosa,Nate Landwehr,Julian Erosa,2021-02-20,1,0,-1,1,2.333333,3.4,10.16,-10.16,0,0,5.080002,-5.080002,1,0,40,22,18,-18,-1.06666684150696,1.06666684150696,1,1,2,1,0,0,1,-1,238,280,-42,42
Ludovit Klein,Nate Landwehr,Nate Landwehr,2021-10-16,0,1,-7,7,5,3.4,-5.080002,5.080002,10,-10,0,0,32,226,24,22,2,-2,1.59999990463257,-1.59999990463257,0,0,0,2,0,0,-2,2,161,238,-77,77
Dan Ige,Nate Landwehr,Dan Ige,2023-06-10,1,0,-4,4,2.428571,3.4,-5.080002,5.080002,0,0,-2.540009,2.540009,41,26,24,22,2,-2,-0.971428632736206,0.971428632736206,1,1,0,2,0,0,-2,2,147,602,-455,455
Tim Credeur,Nate Loughran,Tim Credeur,2008-12-10,1,0,3,-3,3,5.5,2.539993,-2.539993,0,0,2.5,-2.5,212,0,16,13,3,-3,-2.5,2.5,1,0,0,0,1,-1,0,0,144,0,144,-144
Tony Gravely,Nate Maness,Nate Maness,2021-09-18,0,1,-1,1,2.555556,4.666667,-12.7,12.7,10,-10,-7.62001,7.62001,146,15,32,17,15,-15,-2.11111092567444,2.11111092567444,0,0,0,0,0,0,0,0,602,0,602,-602
Joe Doerksen,Nate Marquardt,Nate Marquardt,2006-03-04,0,1,2,-2,3.1875,1.842105,0,0,0,0,2.539993,-2.539993,101,405,67,54,13,-13,1.34539473056793,-1.34539473056793,0,0,1,0,0,0,1,-1,196,0,196,-196
Dean Lister,Nate Marquardt,Nate Marquardt,2007-01-25,0,1,3,-3,1.857143,1.842105,2.539993,-2.539993,0,0,2.539993,-2.539993,0,502,20,54,-34,34,1.50375366210938e-02,-1.50375366210938e-02,2,1,0,0,1,-1,0,0,161,327,-166,166
Jeremy Horn,Nate Marquardt,Nate Marquardt,2008-02-02,0,1,4,-4,4.136364,1.842105,2.539993,-2.539993,0,0,0,0,83,238,113,54,59,-59,2.29425823688507,-2.29425823688507,2,2,1,0,0,0,1,-1,616,373,243,-243
Thales Leites,Nate Marquardt,Thales Leites,2008-06-07,1,0,-3,3,3.111111,1.842105,2.539993,-2.539993,0,0,10.15999,-10.15999,113,424,37,54,-17,17,1.26900589466095,-1.26900589466095,2,3,0,0,-1,1,0,0,350,126,224,-224
Martin Kampmann,Nate Marquardt,Nate Marquardt,2008-09-06,0,1,-3,3,2.857143,1.842105,0,0,-15,15,-5.080002,5.080002,8,11,27,54,-27,27,1.01503765583038,-1.01503765583038,4,0,0,0,4,-4,0,0,91,91,0,0
Wilson Gouveia,Nate Marquardt,Nate Marquardt,2009-02-21,0,1,1,-1,1.75,1.842105,2.539993,-2.539993,0,0,5.079987,-5.079987,0,259,22,54,-32,32,-9.21052694320679e-02,9.21052694320679e-02,2,1,1,0,1,-1,1,-1,70,168,-98,98
Demian Maia,Nate Marquardt,Nate Marquardt,2009-08-29,0,1,1,-1,2.545455,1.842105,2.539993,-2.539993,-15,15,-5.080002,5.080002,0,1,39,54,-15,15,0.703349232673645,-0.703349232673645,2,2,0,0,0,0,0,0,189,189,0,0
Jake Ellenberger,Nate Marquardt,Jake Ellenberger,2013-03-16,1,0,-6,6,2.066667,1.842105,-7.62001,7.62001,-15,15,-7.62001,7.62001,3,0,46,54,-8,8,0.224561333656311,-0.224561333656311,1,3,1,0,-2,2,1,-1,162,1295,-1133,1133
Hector Lombard,Nate Marquardt,Hector Lombard,2013-10-19,1,0,1,-1,3.4,1.842105,-7.62001,7.62001,0,0,-7.62001,7.62001,3,0,44,54,-10,10,1.55789482593536,-1.55789482593536,0,0,0,1,0,0,-1,1,231,217,14,-14
Kelvin Gastelum,Nate Marquardt,Kelvin Gastelum,2015-06-13,1,0,-13,13,2.25,1.842105,-7.62001,7.62001,-15,15,-7.62001,7.62001,219,12,26,54,-28,28,0.407894730567932,-0.407894730567932,0,0,0,2,0,0,-2,2,133,602,-469,469
CB Dollaway,Nate Marquardt,Nate Marquardt,2015-12-19,0,1,-4,4,1.888889,1.842105,5.080002,-5.080002,0,0,5.079987,-5.079987,3,4,26,54,-28,28,4.67835664749146e-02,-4.67835664749146e-02,0,0,3,3,0,0,0,0,364,189,175,-175
Sam Alvey,Nate Marquardt,Sam Alvey,2017-01-28,1,0,-7,7,1.833333,1.842105,5.080002,-5.080002,0,0,2.539993,-2.539993,121,112,51,54,-3,3,-8.77189636230469e-03,8.77189636230469e-03,3,1,1,3,2,-2,-2,2,84,406,-322,322
Vitor Belfort,Nate Marquardt,Vitor Belfort,2017-06-03,1,0,2,-2,1.857143,1.842105,0,0,0,0,0,0,0,63,40,54,-14,14,1.50375366210938e-02,-1.50375366210938e-02,0,0,6,3,0,0,3,-3,238,126,112,-112
Cezar Ferreira,Nate Marquardt,Cezar Ferreira,2017-11-11,1,0,-6,6,1.625,1.842105,2.539993,-2.539993,0,0,10.15999,-10.15999,284,41,21,54,-33,33,-0.217105269432068,0.217105269432068,0,0,1,3,0,0,-2,2,265,161,104,-104
Luke Caudillo,Nate Mohr,Nate Mohr,2007-06-12,0,1,2,-2,1,1.285714,-5.080002,5.080002,0,0,-20.88,20.88,1,0,34,16,18,-18,-0.285714268684387,0.285714268684387,0,0,0,0,0,0,0,0,0,0,0,0
Manvel Gamburyan,Nate Mohr,Manvel Gamburyan,2007-12-29,1,0,2,-2,1.5,1.285714,-10.15999,10.15999,-20,20,-12.70001,12.70001,59,12,25,16,9,-9,0.214285731315613,-0.214285731315613,0,1,0,0,-1,1,0,0,0,200,-200,200
Shonie Carter,Nate Quarry,Nate Quarry,2005-06-04,0,1,0,0,1.645161,3,-5.080002,5.080002,-15,15,-4.880005,4.880005,42,36,82,16,66,-66,-1.35483872890472,1.35483872890472,0,0,1,0,0,0,1,-1,1436,0,1436,-1436
Rich Franklin,Nate Quarry,Rich Franklin,2005-11-19,1,0,-2,2,4.142857,3,2.539993,-2.539993,0,0,10.15999,-10.15999,10,0,36,16,20,-20,1.14285707473755,-1.14285707473755,4,1,0,0,3,-3,0,0,168,168,0,0
Demian Maia,Nate Quarry,Demian Maia,2008-11-15,1,0,-5,5,2.545455,3,2.539993,-2.539993,-15,15,0,0,105,6,39,16,23,-23,-0.454545497894287,0.454545497894287,0,0,0,1,0,0,-1,1,0,1092,-1092,1092
Jason MacDonald,Nate Quarry,Nate Quarry,2009-04-18,0,1,-4,4,1.5625,3,7.619995,-7.619995,0,0,20.31999,-20.31999,27,107,41,16,25,-25,-1.4375,1.4375,0,0,0,1,0,0,-1,1,252,154,98,-98
Tim Credeur,Nate Quarry,Nate Quarry,2009-09-16,0,1,-5,5,3,3,7.619995,-7.619995,0,0,7.619995,-7.619995,40,481,16,16,0,0,0,0,2,1,0,1,1,-1,-1,1,280,151,129,-129
Ian Freeman,Nate Schroeder,Ian Freeman,2000-06-09,1,0,,,2.857143,1.1,-5.080002,5.080002,-5,5,-5,5,104,210,27,21,6,-6,1.75714290142059,-1.75714290142059,0,0,0,0,0,0,0,0,0,0,0,0
Johnny Eduardo,Nathaniel Wood,Nathaniel Wood,2018-06-01,0,1,14,-14,2.153846,4,2.539993,-2.539993,-10,10,5.080002,-5.080002,3,41,41,25,16,-16,-1.8461537361145,1.8461537361145,0,0,1,0,0,0,1,-1,363,0,363,-363
Andre Ewell,Nathaniel Wood,Nathaniel Wood,2018-12-29,0,1,5,-5,1.888889,4,5.080002,-5.080002,0,0,15.24001,-15.24001,0,515,26,25,1,-1,-2.11111116409302,2.11111116409302,0,1,0,0,-1,1,0,0,0,211,-211,211
Jose Quinonez,Nathaniel Wood,Nathaniel Wood,2019-03-16,0,1,3,-3,1.8,4,5.080002,-5.080002,-10,10,0,0,108,72,14,25,-11,11,-2.20000004768372,2.20000004768372,1,2,0,0,-1,1,0,0,588,77,511,-511
John Dodson,Nathaniel Wood,John Dodson,2020-02-15,1,0,9,-9,1.833333,4,-7.619995,7.619995,-10,10,-7.619995,7.619995,119,48,34,25,9,-9,-2.16666662693024,2.16666662693024,0,3,0,0,-3,3,0,0,357,336,21,-21
John Castaneda,Nathaniel Wood,Nathaniel Wood,2020-07-25,0,1,1,-1,3.333333,4,0,0,-10,10,5.080002,-5.080002,11,49,26,25,1,-1,-0.666666746139526,0.666666746139526,0,0,0,1,0,0,-1,1,0,161,-161,161
Casey Kenney,Nathaniel Wood,Casey Kenney,2020-10-24,1,0,2,-2,4,4,2.539993,-2.539993,-10,10,-2.539993,2.539993,90,0,20,25,-5,5,0,0,1,1,0,1,0,0,-1,1,147,91,56,-56
Charles Rosa,Nathaniel Wood,Nathaniel Wood,2022-07-23,0,1,6,-6,1.75,4,7.619995,-7.619995,0,0,0,0,52,85,22,25,-3,3,-2.25,2.25,1,0,0,1,1,-1,-1,1,2743,637,2106,-2106
Charles Jourdain,Nathaniel Wood,Nathaniel Wood,2022-09-03,0,1,-3,3,2.5,4,7.619995,-7.619995,0,0,0,0,24,270,21,25,-4,4,-1.5,1.5,2,1,0,1,1,-1,-1,1,133,42,91,-91
Andre Fili,Nathaniel Wood,Nathaniel Wood,2023-07-22,0,1,3,-3,2.2,4,12.7,-12.7,0,0,12.70001,-12.70001,175,107,32,25,7,-7,-1.79999995231628,1.79999995231628,0,2,1,1,-2,2,0,0,994,322,672,-672
Evan Elder,Nazim Sadykhov,Nazim Sadykhov,2023-02-18,0,1,-3,3,4,9,0,0,0,0,7.62001,-7.62001,93,19,10,10,0,0,-5,5,0,0,0,0,0,0,0,0,301,0,301,-301
Terrance McKinney,Nazim Sadykhov,Nazim Sadykhov,2023-07-15,0,1,-1,1,2.8,9,0,0,0,0,10.16,-10.16,256,55,19,10,9,-9,-6.20000004768372,6.20000004768372,1,1,0,0,0,0,0,0,504,147,357,-357
Mike Ciesnolevicz,Neil Grove,Mike Ciesnolevicz,2009-02-21,1,0,-9,9,4.75,1.5,-15.23999,15.23999,-30,30,-15,15,0,22,23,20,3,-3,3.25,-3.25,0,0,0,0,0,0,0,0,0,0,0,0
Seth Baczynski,Neil Magny,Seth Baczynski,2013-11-06,1,0,6,-6,1.428571,2.333333,0,0,0,0,-12.7,12.7,505,141,34,40,-6,6,-0.904761791229248,0.904761791229248,0,0,1,0,0,0,1,-1,123,0,123,-123
Rodrigo de Lima,Neil Magny,Neil Magny,2014-06-28,0,1,-3,3,2.666667,2.333333,-20.32001,20.32001,-15,15,-30.2,30.2,222,38,11,40,-29,29,0.333333492279053,-0.333333492279053,0,0,0,0,0,0,0,0,0,234,-234,234
Alex Garcia,Neil Magny,Neil Magny,2014-08-23,0,1,0,0,2.5,2.333333,-15.24001,15.24001,0,0,-20.31999,20.31999,371,240,21,40,-19,19,0.166666746139526,-0.166666746139526,2,1,0,0,1,-1,0,0,161,56,105,-105
William Macario,Neil Magny,Neil Magny,2014-10-25,0,1,-4,4,3,2.333333,-10.16,10.16,0,0,-12.7,12.7,36,170,12,40,-28,28,0.666666746139526,-0.666666746139526,1,2,0,0,-1,1,0,0,301,63,238,-238
Kiichi Kunimoto,Neil Magny,Neil Magny,2015-02-14,0,1,6,-6,2.571429,2.333333,-12.7,12.7,0,0,-22.86,22.86,192,328,25,40,-15,15,0.238095283508301,-0.238095283508301,2,3,0,0,-1,1,0,0,147,112,35,-35
Hyun Gyu Lim,Neil Magny,Neil Magny,2015-05-16,0,1,3,-3,1.857143,2.333333,0,0,0,0,-7.619995,7.619995,32,186,20,40,-20,20,-0.476190447807312,0.476190447807312,1,4,0,0,-3,3,0,0,238,91,147,-147
Kelvin Gastelum,Neil Magny,Neil Magny,2015-11-21,0,1,-4,4,2.25,2.333333,-15.24001,15.24001,0,0,-22.86,22.86,435,334,26,40,-14,14,-8.33332538604736e-02,8.33332538604736e-02,1,5,0,0,-4,4,0,0,161,189,-28,28
Hector Lombard,Neil Magny,Neil Magny,2016-03-19,0,1,10,-10,3.4,2.333333,-15.24001,15.24001,15,-15,-22.86,22.86,276,139,44,40,4,-4,1.06666684150696,-1.06666684150696,2,6,0,0,-4,4,0,0,735,119,616,-616
Lorenz Larkin,Neil Magny,Lorenz Larkin,2016-08-20,1,0,0,0,3,2.333333,-10.16,10.16,0,0,-20.31999,20.31999,58,3,24,40,-16,16,0.666666746139526,-0.666666746139526,1,7,1,0,-6,6,1,-1,83,154,-71,71
Johny Hendricks,Neil Magny,Neil Magny,2016-12-30,0,1,4,-4,2.25,2.333333,-15.24001,15.24001,15,-15,-27.94,27.94,600,1,26,40,-14,14,-8.33332538604736e-02,8.33332538604736e-02,0,0,1,1,0,0,0,0,328,132,196,-196
Rafael Dos Anjos,Neil Magny,Rafael Dos Anjos,2017-09-09,1,0,2,-2,2.133333,2.333333,-17.78,17.78,0,0,-25.39999,25.39999,200,0,47,40,7,-7,-0.199999809265137,0.199999809265137,1,1,1,1,0,0,0,0,84,253,-169,169
Carlos Condit,Neil Magny,Neil Magny,2017-12-30,0,1,3,-3,2.285714,2.333333,-2.539993,2.539993,0,0,-12.7,12.7,44,309,46,40,6,-6,-4.76188659667969e-02,4.76188659667969e-02,0,0,1,1,0,0,0,0,490,112,378,-378
Li Jingliang,Neil Magny,Neil Magny,2020-03-07,0,1,-1,1,2.375,2.333333,-7.619995,7.619995,0,0,-22.86,22.86,219,306,27,40,-13,13,4.16667461395264e-02,-4.16667461395264e-02,2,1,0,1,1,-1,-1,1,189,798,-609,609
Robbie Lawler,Neil Magny,Neil Magny,2020-08-29,0,1,5,-5,1.875,2.333333,-10.16,10.16,0,0,-15.23999,15.23999,93,494,46,40,6,-6,-0.458333253860474,0.458333253860474,0,2,1,1,-2,2,0,0,1491,175,1316,-1316
Michael Chiesa,Neil Magny,Michael Chiesa,2021-01-20,1,0,0,0,2.571429,2.333333,-5.080002,5.080002,0,0,-12.7,12.7,921,135,25,40,-15,15,0.238095283508301,-0.238095283508301,3,3,1,1,0,0,0,0,361,144,217,-217
Max Griffin,Neil Magny,Neil Magny,2022-03-26,0,1,2,-2,1.9,2.333333,-10.16,10.16,0,0,-10.16,10.16,39,273,29,40,-11,11,-0.433333277702332,0.433333277702332,1,0,0,1,1,-1,-1,1,371,430,-59,59
Gilbert Burns,Neil Magny,Gilbert Burns,2023-01-21,1,0,1,-1,3.666667,2.333333,-12.7,12.7,0,0,-22.86,22.86,155,0,28,40,-12,12,1.33333349227905,-1.33333349227905,0,1,2,1,-1,1,1,-1,287,301,-14,14
Ian Garry,Neil Magny,Ian Garry,2023-08-19,1,0,-11,11,13,2.333333,0,0,0,0,-15.23999,15.23999,152,70,13,40,-27,27,10.6666667461395,-10.6666667461395,5,0,0,1,5,-5,-1,1,98,210,-112,112
Brad Pickett,Neil Seery,Brad Pickett,2014-03-08,1,0,1,-1,1.785714,1.230769,5.080002,-5.080002,10,-10,10.16,-10.16,462,0,39,29,10,-10,0.55494499206543,-0.55494499206543,0,0,0,0,0,0,0,0,434,0,434,-434
Phil Harris,Neil Seery,Neil Seery,2014-07-19,0,1,-4,4,1.833333,1.230769,0,0,0,0,2.540009,-2.540009,81,144,34,29,5,-5,0.602564096450806,-0.602564096450806,0,0,1,0,0,0,1,-1,266,133,133,-133
Chris Beal,Neil Seery,Neil Seery,2015-01-24,0,1,-6,6,2,1.230769,7.619995,-7.619995,0,0,12.7,-12.7,283,47,15,29,-14,14,0.769230723381042,-0.769230723381042,2,1,0,0,1,-1,0,0,141,189,-48,48
Jon Delos Reyes,Neil Seery,Neil Seery,2015-10-24,0,1,-8,8,1.6,1.230769,5.080002,-5.080002,0,0,7.619995,-7.619995,154,143,13,29,-16,16,0.3692307472229,-0.3692307472229,1,2,1,0,-1,1,1,-1,161,273,-112,112
Kyoji Horiguchi,Neil Seery,Kyoji Horiguchi,2016-05-08,1,0,-11,11,9.5,1.230769,2.540009,-2.540009,0,0,5.080002,-5.080002,349,24,21,29,-8,8,8.26923072338104,-8.26923072338104,0,3,0,0,-3,3,0,0,379,197,182,-182
Alexandre Pantoja,Neil Seery,Alexandre Pantoja,2017-07-16,1,0,-10,10,5.2,1.230769,2.540009,-2.540009,0,0,7.619995,-7.619995,268,4,31,29,2,-2,3.96923053264618,-3.96923053264618,1,0,0,0,1,-1,0,0,169,434,-265,265
Shane Carwin,Neil Wain,Shane Carwin,2008-10-18,1,0,,,6,3.25,10.16,-10.16,23,-23,23.2,-23.2,62,0,14,17,-3,3,2.75,-2.75,1,0,0,0,1,-1,0,0,147,0,147,-147
Roxanne Modafferi,Nicco Montano,Nicco Montano,2017-12-01,0,1,7,-7,1.190476,1.666667,5.079987,-5.079987,-10,10,10.15999,-10.15999,185,371,46,8,38,-38,-0.476190447807312,0.476190447807312,0,0,0,0,0,0,0,0,1462,0,1462,-1462
Viscardi Andrade,Nicholas Musoke,Nicholas Musoke,2014-02-15,0,1,2,-2,3.166667,2.6,-2.540009,2.540009,0,0,0,0,152,477,25,18,7,-7,0.566666841506958,-0.566666841506958,1,0,0,0,1,-1,0,0,196,0,196,-196
Kelvin Gastelum,Nicholas Musoke,Kelvin Gastelum,2014-06-28,1,0,-6,6,2.25,2.6,-7.62001,7.62001,0,0,-10.16,10.16,78,257,26,18,8,-8,-0.349999904632568,0.349999904632568,3,1,0,0,2,-2,0,0,105,133,-28,28
Chris Camozzi,Nick Catone,Chris Camozzi,2012-06-22,1,0,-5,5,1.846154,2.5,5.080002,-5.080002,0,0,7.619995,-7.619995,48,157,37,14,23,-23,-0.653846144676208,0.653846144676208,1,0,0,0,1,-1,0,0,146,0,146,-146
Roland Delorme,Nick Denis,Roland Delorme,2012-05-05,1,0,0,0,1.8,3.666667,5.080002,-5.080002,0,0,7.339996,-7.339996,34,126,14,14,0,0,-1.86666679382324,1.86666679382324,1,0,0,0,1,-1,0,0,154,0,154,-154
Carlos Condit,Nick Diaz,Carlos Condit,2012-02-04,1,0,-1,1,2.285714,2.6,2.540009,-2.540009,0,0,-2.539993,2.539993,4,104,46,36,10,-10,-0.314285516738892,0.314285516738892,4,0,0,0,4,-4,0,0,217,0,217,-217
Drew Dober,Nick Hein,Nick Hein,2014-05-31,0,1,-5,5,2.166667,2.8,5.080002,-5.080002,0,0,10.16,-10.16,179,255,38,19,19,-19,-0.633333206176758,0.633333206176758,0,0,0,0,0,0,0,0,182,0,182,-182
Damir Hadzovic,Nick Hein,Damir Hadzovic,2018-07-22,1,0,-3,3,2,2.8,7.619995,-7.619995,0,0,10.16,-10.16,7,0,21,19,2,-2,-0.799999952316284,0.799999952316284,0,1,1,0,-1,1,1,-1,169,1513,-1344,1344
Frank Camacho,Nick Hein,Frank Camacho,2019-06-01,1,0,-5,5,2.2,2.8,10.16,-10.16,0,0,17.78,-17.78,0,21,32,19,13,-13,-0.599999904632568,0.599999904632568,0,0,1,0,0,0,1,-1,266,314,-48,48
Cody Brundage,Nick Maximov,Nick Maximov,2021-09-25,0,1,4,-4,1.8,4,0,0,0,0,-10.15999,10.15999,115,561,14,10,4,-4,-2.20000004768372,2.20000004768372,0,0,0,0,0,0,0,0,0,0,0,0
Jacob Malkoun,Nick Maximov,Jacob Malkoun,2022-10-15,1,0,3,-3,2.333333,4,-7.62001,7.62001,0,0,-7.619995,7.619995,457,4,10,10,0,0,-1.66666674613953,1.66666674613953,1,1,0,0,0,0,0,0,546,385,161,-161
Frank Lester,Nick Osipczak,Nick Osipczak,2009-06-20,0,1,1,-1,1.833333,2,-7.62001,7.62001,0,0,-13.03999,13.03999,4,140,17,9,8,-8,-0.166666626930237,0.166666626930237,0,0,0,0,0,0,0,0,0,0,0,0
Duane Ludwig,Nick Osipczak,Duane Ludwig,2010-11-13,1,0,7,-7,1.5,2,-10.16,10.16,0,0,-15.23999,15.23999,63,237,35,9,26,-26,-0.5,0.5,0,1,0,0,-1,1,0,0,315,511,-196,196
Will Campuzano,Nick Pace,Nick Pace,2010-12-04,0,1,1,-1,2.333333,2.666667,5.080002,-5.080002,-10,10,5.080002,-5.080002,194,485,20,11,9,-9,-0.333333492279053,0.333333492279053,0,0,0,0,0,0,0,0,0,0,0,0
Ivan Menjivar,Nick Pace,Ivan Menjivar,2011-08-06,1,0,5,-5,2.083333,2.666667,-2.539993,2.539993,10,-10,-10.16,10.16,1,184,37,11,26,-26,-0.583333492279053,0.583333492279053,1,1,0,0,0,0,0,0,98,245,-147,147
Cody Donovan,Nick Penner,Cody Donovan,2012-12-14,1,0,-1,1,1.6,3.666667,-2.539993,2.539993,0,0,-8.039993,8.039993,59,108,13,14,-1,1,-2.06666672229767,2.06666672229767,0,0,0,0,0,0,0,0,0,0,0,0
Riki Fukuda,Nick Ring,Nick Ring,2011-02-26,0,1,-2,2,2.666667,3.5,0,0,0,0,-2.540009,2.540009,292,4,33,18,15,-15,-0.833333253860474,0.833333253860474,0,0,0,0,0,0,0,0,0,0,0,0
James Head,Nick Ring,Nick Ring,2011-06-11,0,1,-5,5,2.25,3.5,2.539993,-2.539993,-15,15,-2.540009,2.540009,23,539,13,18,-5,5,-1.25,1.25,0,1,0,0,-1,1,0,0,0,105,-105,105
Tim Boetsch,Nick Ring,Tim Boetsch,2011-09-24,1,0,-2,2,1.615385,3.5,0,0,0,0,0,0,185,188,34,18,16,-16,-1.88461542129517,1.88461542129517,1,2,1,0,-1,1,1,-1,119,105,14,-14
Court McGee,Nick Ring,Nick Ring,2012-07-21,0,1,-6,6,1.833333,3.5,-2.540009,2.540009,-15,15,2.539993,-2.539993,9,26,34,18,16,-16,-1.66666662693024,1.66666662693024,0,0,0,0,0,0,0,0,141,301,-160,160
Chris Camozzi,Nick Ring,Chris Camozzi,2013-03-16,1,0,-8,8,1.846154,3.5,5.080002,-5.080002,0,0,2.539993,-2.539993,20,0,37,18,19,-19,-1.65384614467621,1.65384614467621,3,1,0,0,2,-2,0,0,154,238,-84,84
Caio Magalhaes,Nick Ring,Caio Magalhaes,2013-12-06,1,0,-9,9,3.333333,3.5,2.539993,-2.539993,0,0,-2.540009,2.540009,344,171,13,18,-5,5,-0.166666746139526,0.166666746139526,1,0,0,0,1,-1,0,0,181,265,-84,84
Jared Cannonier,Nick Roehrick,Jared Cannonier,2017-07-07,1,0,3,-3,2.833333,7,-7.62001,7.62001,-20,20,15.58,-15.58,34,14,23,8,15,-15,-4.16666674613953,4.16666674613953,0,0,1,0,0,0,1,-1,146,0,146,-146
Jackie Lee,Nick Sanzo,Nick Sanzo,1997-02-07,0,1,,,0,1,,,,,-5,5,0,0,1,2,-1,1,-1,1,0,0,0,0,0,0,0,0,0,0,0,0
Jerry Bohlander,Nick Sanzo,Jerry Bohlander,1997-02-07,1,0,,,2.75,1,5.080002,-5.080002,9,-9,5,-5,0,0,15,2,13,-13,1.75,-1.75,2,1,1,0,1,-1,1,-1,140,0,140,-140
Benji Radach,Nick Serra,Benji Radach,2002-06-22,1,0,-1,1,3,2.333333,2.540009,-2.540009,15,-15,2,-2,614,104,28,10,18,-18,0.666666746139526,-0.666666746139526,0,0,0,0,0,0,0,0,0,0,0,0
Karo Parisyan,Nick Thompson,Karo Parisyan,2006-04-15,1,0,-1,1,2.181818,2.714286,-7.619995,7.619995,0,0,-5.080002,5.080002,243,10,35,52,-17,17,-0.532467365264893,0.532467365264893,1,0,0,0,1,-1,0,0,315,0,315,-315
Aleksa Camur,Nicolae Negumereanu,Nicolae Negumereanu,2021-06-19,0,1,-1,1,2,6.5,2.539993,-2.539993,0,0,-10.15999,10.15999,0,292,9,15,-6,6,-4.5,4.5,0,0,0,0,0,0,0,0,266,0,266,-266
Zak Cummings,Nicolas Dalby,Zak Cummings,2016-04-10,1,0,0,0,3.571429,5.5,2.540009,-2.540009,35,-35,2.539993,-2.539993,212,7,32,26,6,-6,-1.92857146263123,1.92857146263123,1,0,0,0,1,-1,0,0,260,0,260,-260
Warlley Alves,Nicolas Dalby,Nicolas Dalby,2023-01-21,0,1,-6,6,2.5,5.5,0,0,0,0,-5.080002,5.080002,129,242,21,26,-5,5,-3,3,0,0,2,0,0,0,2,-2,574,2477,-1903,1903
Rob Emerson,Nik Lentz,Nik Lentz,2010-03-31,0,1,3,-3,1.5,2.5,2.539993,-2.539993,10,-10,5.080002,-5.080002,19,533,30,42,-12,12,-1,1,1,0,0,0,1,-1,0,0,53,0,53,-53
Tyson Griffin,Nik Lentz,Nik Lentz,2010-11-20,0,1,0,0,2,2.5,-5.080002,5.080002,0,0,0,0,427,204,24,42,-18,18,-0.5,0.5,0,1,0,0,-1,1,0,0,756,234,522,-522
Mark Bocek,Nik Lentz,Mark Bocek,2011-12-10,1,0,3,-3,2.4,2.5,0,0,10,-10,17.78,-17.78,701,45,17,42,-25,25,-9.99999046325684e-02,9.99999046325684e-02,0,2,1,0,-2,2,1,-1,224,385,-161,161
Evan Dunham,Nik Lentz,Evan Dunham,2012-01-28,1,0,3,-3,2,2.5,5.080002,-5.080002,10,-10,5.080002,-5.080002,291,60,27,42,-15,15,-0.5,0.5,0,0,1,0,0,0,1,-1,371,49,322,-322
Hacran Dias,Nik Lentz,Nik Lentz,2013-05-18,0,1,0,0,3.833333,2.5,0,0,10,-10,2.539993,-2.539993,220,448,29,42,-13,13,1.33333325386047,-1.33333325386047,0,0,0,1,0,0,-1,1,0,476,-476,476
Manvel Gamburyan,Nik Lentz,Nik Lentz,2014-05-10,0,1,4,-4,1.5,2.5,-7.619995,7.619995,-10,10,-2.540009,2.540009,82,558,25,42,-17,17,-1,1,2,1,0,1,1,-1,-1,1,266,357,-91,91
Danny Castillo,Nik Lentz,Nik Lentz,2015-12-19,0,1,5,-5,1.7,2.5,2.539993,-2.539993,10,-10,7.619995,-7.619995,214,94,27,42,-15,15,-0.799999952316284,0.799999952316284,0,2,2,1,-2,2,1,-1,147,588,-441,441
Will Brooks,Nik Lentz,Nik Lentz,2017-11-18,0,1,-2,2,4.5,2.5,5.080002,-5.080002,10,-10,10.16,-10.16,45,46,22,42,-20,20,2,-2,0,3,1,1,-3,3,0,0,224,700,-476,476
Scott Holtzman,Nik Lentz,Nik Lentz,2019-02-17,0,1,1,-1,2.333333,2.5,2.539993,-2.539993,10,-10,2.539993,-2.539993,17,407,20,42,-22,22,-0.166666746139526,0.166666746139526,4,4,0,1,0,0,-1,1,134,456,-322,322
Arnold Allen,Nik Lentz,Arnold Allen,2020-01-25,1,0,-9,9,9.5,2.5,0,0,0,0,5.080002,-5.080002,81,77,21,42,-21,21,7,-7,6,5,0,1,1,-1,-1,1,203,342,-139,139
Movsar Evloev,Nik Lentz,Movsar Evloev,2021-01-23,1,0,-10,10,17,2.5,-2.540009,2.540009,0,0,10.16,-10.16,276,86,17,42,-25,25,14.5,-14.5,1,0,0,1,1,-1,-1,1,182,364,-182,182
Walt Harris,Nikita Krylov,Nikita Krylov,2014-01-25,0,1,9,-9,1.3,3.333333,5.080002,-5.080002,45,-45,0,0,0,3,23,39,-16,16,-2.03333330154419,2.03333330154419,0,0,0,0,0,0,0,0,56,0,56,-56
Cody Donovan,Nikita Krylov,Nikita Krylov,2014-07-19,0,1,11,-11,1.6,3.333333,0,0,0,0,-7.619995,7.619995,94,112,13,39,-26,26,-1.73333323001862,1.73333323001862,0,1,2,0,-1,1,2,-2,245,175,70,-70
Francimar Barroso,Nikita Krylov,Nikita Krylov,2016-05-08,0,1,12,-12,2.714286,3.333333,-5.080002,5.080002,0,0,-5.080002,5.080002,100,244,26,39,-13,13,-0.61904764175415,0.61904764175415,2,2,0,0,0,0,0,0,112,659,-547,547
Ed Herman,Nikita Krylov,Nikita Krylov,2016-07-30,0,1,11,-11,1.6875,3.333333,-5.080002,5.080002,0,0,0,0,25,55,43,39,4,-4,-1.64583325386047,1.64583325386047,1,3,1,0,-2,2,1,-1,812,83,729,-729
Misha Cirkunov,Nikita Krylov,Misha Cirkunov,2016-12-10,1,0,5,-5,1.666667,3.333333,0,0,0,0,0,0,40,93,24,39,-15,15,-1.66666662693024,1.66666662693024,3,4,0,0,-1,1,0,0,175,133,42,-42
Jan Blachowicz,Nikita Krylov,Jan Blachowicz,2018-09-15,1,0,9,-9,2.9,3.333333,-2.539993,2.539993,0,0,2.539993,-2.539993,293,100,39,39,0,0,-0.433333158493042,0.433333158493042,3,0,0,0,3,-3,0,0,182,644,-462,462
Magomed Ankalaev,Nikita Krylov,Magomed Ankalaev,2021-02-27,1,0,0,0,18,3.333333,0,0,0,0,-5.080002,5.080002,359,104,19,39,-20,20,14.6666667461395,-14.6666667461395,4,0,0,0,4,-4,0,0,126,896,-770,770
Paul Craig,Nikita Krylov,Paul Craig,2022-03-19,1,0,4,-4,2.833333,3.333333,0,0,-20,20,-2.540009,2.540009,2,229,23,39,-16,16,-0.5,0.5,3,0,3,0,3,-3,3,-3,280,385,-105,105
Alexander Gustafsson,Nikita Krylov,Nikita Krylov,2022-07-23,0,1,5,-5,2.25,3.333333,5.080002,-5.080002,0,0,5.080002,-5.080002,7,9,26,39,-13,13,-1.08333325386047,1.08333325386047,0,0,2,0,0,0,2,-2,728,126,602,-602
Ramazan Emeev,Niklas Stolze,Ramazan Emeev,2020-07-25,1,0,6,-6,3.333333,2,-7.619995,7.619995,15,-15,5.079987,-5.079987,410,21,26,18,8,-8,1.33333325386047,-1.33333325386047,0,0,0,0,0,0,0,0,259,0,259,-259
Jared Gooden,Niklas Stolze,Jared Gooden,2021-07-31,1,0,-1,1,2.444444,2,-2.539993,2.539993,15,-15,7.619995,-7.619995,21,0,31,18,13,-13,0.444444417953491,-0.444444417953491,0,0,0,0,0,0,0,0,126,371,-245,245
Benoit Saint Denis,Niklas Stolze,Benoit Saint Denis,2022-06-04,1,0,-3,3,12,2,-5.080002,5.080002,0,0,-2.540009,2.540009,344,0,13,18,-5,5,10,-10,0,0,0,1,0,0,-1,1,217,308,-91,91
Alan Jouban,Niko Price,Niko Price,2017-08-05,0,1,8,-8,2.428571,2.142857,0,0,0,0,-7.619995,7.619995,0,5,24,22,2,-2,0.285714387893677,-0.285714387893677,0,0,1,0,0,0,1,-1,140,0,140,-140
Vicente Luque,Niko Price,Vicente Luque,2017-10-28,1,0,-3,3,2.444444,2.142857,-2.540009,2.540009,0,0,-2.539993,2.539993,18,0,31,22,9,-9,0.301587343215942,-0.301587343215942,2,1,0,0,1,-1,0,0,350,84,266,-266
Randy Brown,Niko Price,Niko Price,2018-07-14,0,1,0,0,3.4,2.142857,7.619995,-7.619995,0,0,5.080002,-5.080002,99,104,22,22,0,0,1.25714302062988,-1.25714302062988,1,0,0,0,1,-1,0,0,252,259,-7,7
Tim Means,Niko Price,Niko Price,2019-03-09,0,1,6,-6,2.2,2.142857,5.080002,-5.080002,0,0,-2.539993,2.539993,111,2,48,22,26,-26,5.7142972946167e-02,-5.7142972946167e-02,1,1,0,0,0,0,0,0,99,238,-139,139
Geoff Neal,Niko Price,Geoff Neal,2019-07-27,1,0,-1,1,3,2.142857,-2.540009,2.540009,0,0,-2.539993,2.539993,217,54,20,22,-2,2,0.857142925262451,-0.857142925262451,0,2,0,0,-2,2,0,0,0,140,-140,140
Vicente Luque,Niko Price,Vicente Luque,2020-05-09,1,0,-2,2,2.444444,2.142857,-2.540009,2.540009,0,0,-2.539993,2.539993,25,109,31,22,9,-9,0.301587343215942,-0.301587343215942,0,0,0,1,0,0,-1,1,189,287,-98,98
Michel Pereira,Niko Price,Michel Pereira,2021-07-10,1,0,-4,4,2.545455,2.142857,2.539993,-2.539993,15,-15,-7.619995,7.619995,167,132,39,22,17,-17,0.402597427368164,-0.402597427368164,1,0,0,2,1,-1,-2,2,203,427,-224,224
Alex Oliveira,Niko Price,Niko Price,2021-10-02,0,1,1,-1,1.833333,2.142857,-2.540009,2.540009,0,0,0,0,194,290,34,22,12,-12,-0.309523701667786,0.309523701667786,0,0,0,2,0,0,-2,2,343,84,259,-259
Robbie Lawler,Niko Price,Robbie Lawler,2023-07-08,1,0,8,-8,1.875,2.142857,-2.540009,2.540009,0,0,-5.079987,5.079987,0,0,46,22,24,-24,-0.267857074737549,0.267857074737549,0,1,1,2,-1,1,-1,1,1043,644,399,-399
Jim Miller,Nikolas Motta,Jim Miller,2022-02-19,1,0,9,-9,2.117647,2.6,-2.539993,2.539993,0,0,2.539993,-2.539993,34,0,53,18,35,-35,-0.482352733612061,0.482352733612061,0,0,0,0,0,0,0,0,315,0,315,-315
Juliana Lima,Nina Nunes,Juliana Lima,2014-11-08,1,0,4,-4,1.8,1.571429,0,0,-10,10,2.540009,-2.540009,402,164,14,18,-4,4,0.22857141494751,-0.22857141494751,0,0,0,0,0,0,0,0,0,0,0,0
Justine Kish,Nina Nunes,Justine Kish,2016-01-02,1,0,-3,3,1.75,1.571429,0,0,0,0,0,0,171,160,11,18,-7,7,0.178571462631226,-0.178571462631226,0,0,0,0,0,0,0,0,0,420,-420,420
Jocelyn Jones-Lybarger,Nina Nunes,Nina Nunes,2017-01-15,0,1,0,0,1.5,1.571429,5.079987,-5.079987,-10,10,0,0,3,511,10,18,-8,8,-7.14285373687744e-02,7.14285373687744e-02,0,0,0,0,0,0,0,0,211,379,-168,168
Angela Hill,Nina Nunes,Nina Nunes,2017-11-11,0,1,1,-1,1.153846,1.571429,-5.080002,5.080002,-10,10,0,0,8,2,28,18,10,-10,-0.417582392692566,0.417582392692566,1,1,0,0,0,0,0,0,127,300,-173,173
Randa Markos,Nina Nunes,Nina Nunes,2018-07-28,0,1,0,0,0.9166667,1.571429,-2.540009,2.540009,-10,10,-2.539993,2.539993,297,33,23,18,5,-5,-0.654761850833893,0.654761850833893,0,2,0,0,-2,2,0,0,1324,259,1065,-1065
Claudia Gadelha,Nina Nunes,Nina Nunes,2018-12-08,0,1,-3,3,3.6,1.571429,-2.540009,2.540009,-10,10,-2.539993,2.539993,200,0,23,18,5,-5,2.02857136726379,-2.02857136726379,1,3,0,0,-2,2,0,0,553,133,420,-420
Mackenzie Dern,Nina Nunes,Mackenzie Dern,2021-04-10,1,0,-7,7,4.333333,1.571429,-2.540009,2.540009,-10,10,-2.539993,2.539993,240,0,16,18,-2,2,2.76190495491028,-2.76190495491028,2,4,0,0,-2,2,0,0,119,854,-735,735
Cynthia Calvillo,Nina Nunes,Nina Nunes,2022-08-13,0,1,-1,1,1.5,1.571429,-2.540009,2.540009,-10,10,0,0,129,0,15,18,-3,3,-7.14285373687744e-02,7.14285373687744e-02,0,0,1,0,0,0,1,-1,273,490,-217,217
Niklas Backstrom,Noad Lahat,Noad Lahat,2015-06-20,0,1,-6,6,3.666667,5.5,10.16,-10.16,0,0,13.87001,-13.87001,340,252,14,13,1,-1,-1.83333325386047,1.83333325386047,0,0,1,0,0,0,1,-1,259,0,259,-259
Frankie Saenz,Nolan Ticman,Frankie Saenz,2014-08-16,1,0,8,-8,1.857143,1.333333,0,0,10,-10,-2.360001,2.360001,347,18,20,7,13,-13,0.523809432983398,-0.523809432983398,0,0,0,0,0,0,0,0,0,0,0,0
Vik Grujic,Nordine Taleb,Nordine Taleb,2014-04-16,0,1,5,-5,1,2.142857,-5.080002,5.080002,0,0,-2.540009,2.540009,2,640,12,22,-10,10,-1.14285707473755,1.14285707473755,0,0,0,0,0,0,0,0,0,0,0,0
Li Jingliang,Nordine Taleb,Nordine Taleb,2014-10-04,0,1,-7,7,2.375,2.142857,-2.539993,2.539993,0,0,-7.62001,7.62001,42,148,27,22,5,-5,0.232142925262451,-0.232142925262451,1,1,0,0,0,0,0,0,133,171,-38,38
Chris Clements,Nordine Taleb,Nordine Taleb,2015-04-25,0,1,6,-6,2,2.142857,-7.619995,7.619995,0,0,-10.16,10.16,0,602,18,22,-4,4,-0.142857074737549,0.142857074737549,1,2,1,0,-1,1,1,-1,169,203,-34,34
Warlley Alves,Nordine Taleb,Warlley Alves,2015-08-01,1,0,-10,10,2.5,2.142857,-5.080002,5.080002,0,0,-5.080002,5.080002,258,65,21,22,-1,1,0.357142925262451,-0.357142925262451,1,3,0,0,-2,2,0,0,266,98,168,-168
Erick Silva,Nordine Taleb,Nordine Taleb,2016-03-05,0,1,-3,3,2.111111,2.142857,-2.539993,2.539993,0,0,0,0,0,5,28,22,6,-6,-3.17459106445313e-02,3.17459106445313e-02,0,0,0,0,0,0,0,0,0,217,-217,217
Santiago Ponzinibbio,Nordine Taleb,Santiago Ponzinibbio,2017-02-19,1,0,-5,5,4.285714,2.142857,-2.539993,2.539993,0,0,-2.540009,2.540009,118,0,37,22,15,-15,2.14285707473755,-2.14285707473755,2,1,0,0,1,-1,0,0,437,351,86,-86
Oliver Enkamp,Nordine Taleb,Nordine Taleb,2017-05-28,0,1,-10,10,3.5,2.142857,-2.539993,2.539993,0,0,7.619995,-7.619995,47,272,9,22,-13,13,1.35714292526245,-1.35714292526245,0,0,0,0,0,0,0,0,0,98,-98,98
Danny Roberts,Nordine Taleb,Nordine Taleb,2017-12-16,0,1,-6,6,2.25,2.142857,0,0,0,0,0,0,0,0,26,22,4,-4,0.107142925262451,-0.107142925262451,1,1,0,0,0,0,0,0,602,202,400,-400
Claudio Silva,Nordine Taleb,Claudio Silva,2018-05-27,1,0,-1,1,3.5,2.142857,-5.080002,5.080002,0,0,-7.62001,7.62001,108,11,18,22,-4,4,1.35714292526245,-1.35714292526245,0,2,0,0,-2,2,0,0,0,162,-162,162
Sean Strickland,Nordine Taleb,Sean Strickland,2018-10-27,1,0,-10,10,5.6,2.142857,0,0,15,-15,5.079987,-5.079987,37,0,33,22,11,-11,3.45714282989502,-3.45714282989502,0,0,1,0,0,0,1,-1,168,153,15,-15
Kyle Prepolec,Nordine Taleb,Nordine Taleb,2019-05-04,0,1,-8,8,1.714286,2.142857,-7.619995,7.619995,0,0,-10.16,10.16,0,3,19,22,-3,3,-0.428571343421936,0.428571343421936,0,0,0,1,0,0,-1,1,0,189,-189,189
Muslim Salikhov,Nordine Taleb,Muslim Salikhov,2019-09-07,1,0,-3,3,4.75,2.142857,-5.080002,5.080002,0,0,-10.16,10.16,2,0,23,22,1,-1,2.60714292526245,-2.60714292526245,0,1,0,1,-1,1,-1,1,0,126,-126,126
Demetrious Johnson,Norifumi Yamamoto,Demetrious Johnson,2011-02-05,1,0,-9,9,9,3,-2.539993,2.539993,-10,10,0,0,226,27,30,24,6,-6,6,-6,0,0,0,0,0,0,0,0,0,0,0,0
Darren Uyenoyama,Norifumi Yamamoto,Darren Uyenoyama,2011-11-12,1,0,-2,2,1.666667,3,5.080002,-5.080002,-10,10,-2.539993,2.539993,348,250,16,24,-8,8,-1.33333337306976,1.33333337306976,0,0,0,0,0,0,0,0,0,280,-280,280
Vaughan Lee,Norifumi Yamamoto,Vaughan Lee,2012-02-25,1,0,-5,5,1.076923,3,5.080002,-5.080002,-10,10,0,0,4,39,27,24,3,-3,-1.92307686805725,1.92307686805725,0,0,0,0,0,0,0,0,0,105,-105,105
Megan Anderson,Norma Dumont,Megan Anderson,2020-02-29,1,0,1,-1,2.2,5,12.70001,-12.70001,0,0,12.70001,-12.70001,14,139,16,12,4,-4,-2.79999995231628,2.79999995231628,1,0,0,0,1,-1,0,0,147,0,147,-147
Macy Chiasson,Norma Dumont,Macy Chiasson,2022-05-07,1,0,-1,1,3,5,10.16,-10.16,-10,10,12.70001,-12.70001,454,26,12,12,0,0,-2,2,0,0,0,1,0,0,-1,1,140,798,-658,658
Chelsea Chandler,Norma Dumont,Norma Dumont,2023-07-15,0,1,0,0,2.5,5,2.540009,-2.540009,0,0,2.540009,-2.540009,150,538,7,12,-5,5,-2.5,2.5,1,0,0,1,1,-1,-1,1,287,434,-147,147
Colin Fletcher,Norman Parke,Norman Parke,2012-12-14,0,1,4,-4,1.75,3.833333,7.62001,-7.62001,0,0,13.2,-13.2,35,411,22,29,-7,7,-2.08333325386047,2.08333325386047,0,0,0,0,0,0,0,0,0,0,0,0
Naoyuki Kotani,Norman Parke,Norman Parke,2014-07-19,0,1,5,-5,2.428571,3.833333,-7.619995,7.619995,0,0,-10.16,10.16,62,213,48,29,19,-19,-1.40476179122925,1.40476179122925,0,1,1,0,-1,1,1,-1,2506,582,1924,-1924
Reza Madadi,Norman Parke,Norman Parke,2015-10-24,0,1,9,-9,2.333333,3.833333,0,0,0,0,7.619995,-7.619995,137,267,20,29,-9,9,-1.5,1.5,0,2,0,0,-2,2,0,0,1106,462,644,-644
Rustam Khabilov,Norman Parke,Rustam Khabilov,2016-02-27,1,0,0,0,6,3.833333,-7.619995,7.619995,0,0,7.619995,-7.619995,275,108,28,29,-1,1,2.16666674613953,-2.16666674613953,0,3,0,0,-3,3,0,0,370,126,244,-244
Brunno Ferreira,Nursulton Ruziboev,Nursulton Ruziboev,2023-07-01,0,1,1,-1,10,4.375,-17.78,17.78,0,0,-10.15999,10.15999,0,1,11,43,-32,32,5.625,-5.625,1,0,0,0,1,-1,0,0,161,0,161,-161
Brian Kelleher,Ode Osbourne,Brian Kelleher,2020-01-18,1,0,5,-5,1.714286,2,-2.539993,2.539993,10,-10,-17.78,17.78,118,4,38,18,20,-20,-0.285714268684387,0.285714268684387,0,0,1,0,0,0,1,-1,616,0,616,-616
Manel Kape,Ode Osbourne,Manel Kape,2021-08-07,1,0,-2,2,3.166667,2,-5.079987,5.079987,0,0,-12.7,12.7,2,0,25,18,7,-7,1.16666674613953,-1.16666674613953,0,0,0,0,0,0,0,0,147,567,-420,420
Zarrukh Adashev,Ode Osbourne,Ode Osbourne,2022-06-04,0,1,-1,1,1,2,-5.079987,5.079987,0,0,-20.31999,20.31999,0,3,8,18,-10,10,-1,1,1,0,1,1,1,-1,0,0,308,301,7,-7
Tyson Nam,Ode Osbourne,Tyson Nam,2022-08-13,1,0,8,-8,1.5,2,0,0,0,0,-12.7,12.7,3,0,35,18,17,-17,-0.5,0.5,0,1,0,1,-1,1,-1,1,570,70,500,-500
Charles Johnson,Ode Osbourne,Ode Osbourne,2023-02-25,0,1,1,-1,2.6,2,5.080002,-5.080002,0,0,-7.619995,7.619995,78,173,18,18,0,0,0.599999904632568,-0.599999904632568,1,0,0,2,1,-1,-2,2,98,196,-98,98
Assu Almabayev,Ode Osbourne,Assu Almabayev,2023-08-05,1,0,-2,2,9,2,-7.619995,7.619995,0,0,-20.31999,20.31999,324,21,20,18,2,-2,7,-7,0,1,0,2,-1,1,-2,2,0,161,-161,161
Dan Severn,Oleg Taktarov,Dan Severn,1995-04-07,1,0,9,-9,5.31579,3.4,5.080002,-5.080002,40,-40,6,-6,0,0,120,22,98,-98,1.91578960418701,-1.91578960418701,0,0,0,0,0,0,0,0,0,0,0,0
Anthony Macias,Oleg Taktarov,Oleg Taktarov,1995-07-14,0,1,,,1.444444,3.4,-7.62001,7.62001,-25,25,-7,7,0,0,44,22,22,-22,-1.95555567741394,1.95555567741394,0,0,0,1,0,0,-1,1,210,98,112,-112
Dave Beneteau,Oleg Taktarov,Oleg Taktarov,1995-07-14,0,1,,,1.2,3.4,5.080002,-5.080002,40,-40,6,-6,0,0,11,22,-11,11,-2.20000004768372,2.20000004768372,2,1,0,1,1,-1,-1,1,98,0,98,-98
David Abbott,Oleg Taktarov,Oleg Taktarov,1995-07-14,0,1,,,0.6666667,3.4,0,0,55,-55,-2.5,2.5,0,0,25,22,3,-3,-2.73333340883255,2.73333340883255,2,2,0,1,0,0,-1,1,0,0,0,0
Dave Beneteau,Oleg Taktarov,Oleg Taktarov,1995-12-16,0,1,,,1.2,3.4,5.080002,-5.080002,40,-40,6,-6,0,0,11,22,-11,11,-2.20000004768372,2.20000004768372,0,3,0,1,-3,3,-1,1,155,155,0,0
Dan Severn,Oleg Taktarov,Dan Severn,1995-12-16,1,0,9,-9,5.31579,3.4,5.080002,-5.080002,40,-40,6,-6,0,0,120,22,98,-98,1.91578960418701,-1.91578960418701,1,4,0,1,-3,3,-1,1,155,0,155,-155
Marco Ruas,Oleg Taktarov,Oleg Taktarov,1995-12-16,0,1,6,-6,2.25,3.4,2.539993,-2.539993,0,0,3,-3,0,0,13,22,-9,9,-1.15000009536743,1.15000009536743,1,0,0,1,1,-1,-1,1,99,0,99,-99
Shawn Jordan,Oli Thompson,Shawn Jordan,2012-03-02,1,0,-5,5,2.375,1.7,-2.539993,2.539993,18,-18,2.5,-2.5,81,5,27,27,0,0,0.674999952316284,-0.674999952316284,0,0,0,0,0,0,0,0,0,0,0,0
Philip De Fries,Oli Thompson,Philip De Fries,2012-08-04,1,0,-6,6,2,1.7,10.16,-10.16,8,-8,12.66,-12.66,364,49,18,27,-9,9,0.299999952316284,-0.299999952316284,0,0,1,1,0,0,0,0,171,155,16,-16
Dong Hyun Ma,Omar Morales,Omar Morales,2019-12-21,0,1,-3,3,1.454545,2.75,0,0,0,0,-7.619995,7.619995,0,365,27,15,12,-12,-1.29545450210571,1.29545450210571,0,0,3,0,0,0,3,-3,315,0,315,-315
Gabriel Benitez,Omar Morales,Omar Morales,2020-05-13,0,1,-3,3,2.090909,2.75,-7.619995,7.619995,0,0,-5.080002,5.080002,0,0,34,15,19,-19,-0.659090995788574,0.659090995788574,0,1,2,0,-1,1,2,-2,270,144,126,-126
Giga Chikadze,Omar Morales,Giga Chikadze,2020-10-10,1,0,-2,2,5,2.75,2.540009,-2.540009,-10,10,2.540009,-2.540009,29,64,18,15,3,-3,2.25,-2.25,3,2,0,0,1,-1,0,0,147,150,-3,3
Uros Medic,Omar Morales,Uros Medic,2022-05-21,1,0,-7,7,9,2.75,5.080002,-5.080002,15,-15,-5.080002,5.080002,2,0,10,15,-5,5,6.25,-6.25,0,0,0,0,0,0,0,0,238,588,-350,350
Chris Duncan,Omar Morales,Chris Duncan,2023-03-18,1,0,-8,8,11,2.75,-2.539993,2.539993,0,0,-5.080002,5.080002,391,2,12,15,-3,3,8.25,-8.25,0,0,0,1,0,0,-1,1,0,301,-301,301
Francesco Maturi,Onassis Parungao,Onassis Parungao,1995-09-08,0,1,,,0,2,,,,,-10,10,0,0,1,3,-2,2,-2,2,0,0,0,0,0,0,0,0,0,0,0,0
Remco Pardoel,Orlando Wiet,Remco Pardoel,1994-03-11,1,0,,,1.5,0.2,12.7,-12.7,90,-90,18,-18,0,0,15,6,9,-9,1.29999999701977,-1.29999999701977,0,0,0,0,0,0,0,0,0,0,0,0
Robert Lucarelli,Orlando Wiet,Orlando Wiet,1994-03-11,0,1,,,0,0.2,10.16,-10.16,75,-75,16,-16,0,0,1,6,-5,5,-0.200000002980232,0.200000002980232,0,0,0,1,0,0,-1,1,0,0,0,0
Gerald Meerschaert,Oskar Piechota,Gerald Meerschaert,2018-07-06,1,0,2,-2,2.058824,3.666667,2.539993,-2.539993,0,0,2.540009,-2.540009,150,201,52,14,38,-38,-1.60784316062927,1.60784316062927,1,0,1,0,1,-1,1,-1,217,0,217,-217
Cody Donovan,Ovince Saint Preux,Ovince Saint Preux,2013-08-17,0,1,2,-2,1.6,1.529412,0,0,0,0,-15.23999,15.23999,73,10,13,43,-30,30,7.0588231086731e-02,-7.0588231086731e-02,1,0,0,0,1,-1,0,0,246,0,246,-246
Nikita Krylov,Ovince Saint Preux,Ovince Saint Preux,2014-03-15,0,1,-8,8,3.333333,1.529412,0,0,0,0,-7.619995,7.619995,0,61,39,43,-4,4,1.80392146110535,-1.80392146110535,0,1,1,0,-1,1,1,-1,196,210,-14,14
Ryan Jimmo,Ovince Saint Preux,Ovince Saint Preux,2014-06-14,0,1,1,-1,3.8,1.529412,-5.080002,5.080002,0,0,-17.78,17.78,61,120,24,43,-19,19,2.27058815956116,-2.27058815956116,1,2,1,0,-1,1,1,-1,59,91,-32,32
Ryan Bader,Ovince Saint Preux,Ryan Bader,2014-08-16,1,0,0,0,4.6,1.529412,-2.539993,2.539993,0,0,-15.23999,15.23999,610,107,28,43,-15,15,3.07058811187744,-3.07058811187744,2,3,2,0,-1,1,2,-2,63,63,0,0
Mauricio Rua,Ovince Saint Preux,Ovince Saint Preux,2014-11-08,0,1,1,-1,1.928571,1.529412,-5.080002,5.080002,0,0,-10.16,10.16,0,6,41,43,-2,2,0.399159669876099,-0.399159669876099,1,0,0,0,1,-1,0,0,337,84,253,-253
Patrick Cummins,Ovince Saint Preux,Ovince Saint Preux,2015-04-18,0,1,2,-2,1.428571,1.529412,-2.539993,2.539993,0,0,-10.16,10.16,47,4,17,43,-26,26,-0.100840330123901,0.100840330123901,2,1,0,0,1,-1,0,0,266,161,105,-105
Rafael Cavalcante,Ovince Saint Preux,Ovince Saint Preux,2016-02-06,0,1,3,-3,1.714286,1.529412,-5.080002,5.080002,0,0,-15.23999,15.23999,0,395,19,43,-24,24,0.184873938560486,-0.184873938560486,0,2,2,0,-2,2,2,-2,189,294,-105,105
Jon Jones,Ovince Saint Preux,Jon Jones,2016-04-23,1,0,-5,5,27,1.529412,2.539993,-2.539993,43,-43,10.16,-10.16,235,0,28,43,-15,15,25.4705882072449,-25.4705882072449,7,3,0,0,4,-4,0,0,728,77,651,-651
Jimi Manuwa,Ovince Saint Preux,Jimi Manuwa,2016-10-08,1,0,3,-3,2.833333,1.529412,-5.080002,5.080002,0,0,-2.539993,2.539993,30,206,23,43,-20,20,1.30392146110535,-1.30392146110535,0,0,0,0,0,0,0,0,0,168,-168,168
Volkan Oezdemir,Ovince Saint Preux,Volkan Oezdemir,2017-02-04,1,0,-6,6,2.714286,1.529412,-2.539993,2.539993,0,0,-12.7,12.7,84,39,26,43,-17,17,1.1848738193512,-1.1848738193512,0,0,0,1,0,0,-1,1,0,119,-119,119
Marcos Rogerio de Lima,Ovince Saint Preux,Ovince Saint Preux,2017-04-22,0,1,-3,3,2.1,1.529412,-5.080002,5.080002,48,-48,-12.7,12.7,0,108,31,43,-12,12,0.570588111877441,-0.570588111877441,0,0,0,1,0,0,-1,1,0,77,-77,77
Yushin Okami,Ovince Saint Preux,Ovince Saint Preux,2017-09-22,0,1,2,-2,2.833333,1.529412,-2.539993,2.539993,-35,35,-12.7,12.7,0,103,46,43,3,-3,1.30392146110535,-1.30392146110535,0,1,2,1,-1,1,1,-1,1479,153,1326,-1326
Corey Anderson,Ovince Saint Preux,Ovince Saint Preux,2017-11-04,0,1,-6,6,2.8,1.529412,0,0,0,0,-2.539993,2.539993,428,2,19,43,-24,24,1.27058815956116,-1.27058815956116,0,2,2,1,-2,2,1,-1,231,43,188,-188
Ilir Latifi,Ovince Saint Preux,Ilir Latifi,2018-02-24,1,0,1,-1,1.888889,1.529412,-12.7,12.7,25,-25,-17.78,17.78,20,0,26,43,-17,17,0.359477043151855,-0.359477043151855,4,3,0,1,1,-1,-1,1,168,112,56,-56
Tyson Pedro,Ovince Saint Preux,Ovince Saint Preux,2018-06-23,0,1,-9,9,2.5,1.529412,0,0,0,0,-2.539993,2.539993,79,34,14,43,-29,29,0.970588207244873,-0.970588207244873,2,0,0,1,2,-2,-1,1,133,119,14,-14
Dominick Reyes,Ovince Saint Preux,Dominick Reyes,2018-10-06,1,0,-7,7,3,1.529412,2.539993,-2.539993,0,0,-7.619995,7.619995,86,93,16,43,-27,27,1.47058820724487,-1.47058820724487,0,1,0,1,-1,1,-1,1,0,105,-105,105
Nikita Krylov,Ovince Saint Preux,Nikita Krylov,2019-04-13,1,0,-9,9,3.333333,1.529412,0,0,0,0,-7.619995,7.619995,143,196,39,43,-4,4,1.80392146110535,-1.80392146110535,2,0,1,1,2,-2,0,0,1329,189,1140,-1140
Michal Oleksiejczuk,Ovince Saint Preux,Ovince Saint Preux,2019-09-28,0,1,-12,12,3.166667,1.529412,-7.619995,7.619995,-20,20,-15.23999,15.23999,90,50,25,43,-18,18,1.6372549533844,-1.6372549533844,1,0,0,1,1,-1,-1,1,217,168,49,-49
Ben Rothwell,Ovince Saint Preux,Ben Rothwell,2020-05-13,1,0,1,-1,2.785714,1.529412,2.539993,-2.539993,60,-60,-5.080002,5.080002,349,22,53,43,10,-10,1.25630259513855,-1.25630259513855,4,1,1,1,3,-3,0,0,158,228,-70,70
Alonzo Menifield,Ovince Saint Preux,Ovince Saint Preux,2020-09-05,0,1,-5,5,4.666667,1.529412,-7.619995,7.619995,0,0,-10.16,10.16,36,3,17,43,-26,26,3.13725471496582,-3.13725471496582,1,0,0,1,1,-1,-1,1,595,115,480,-480
Jamahal Hill,Ovince Saint Preux,Jamahal Hill,2020-12-05,1,0,-8,8,12,1.529412,2.539993,-2.539993,0,0,-2.539993,2.539993,15,0,13,43,-30,30,10.4705882072449,-10.4705882072449,1,1,0,1,0,0,-1,1,315,91,224,-224
Tanner Boser,Ovince Saint Preux,Tanner Boser,2021-06-26,1,0,-9,9,2.1,1.529412,-2.539993,2.539993,0,0,-12.7,12.7,16,72,31,43,-12,12,0.570588111877441,-0.570588111877441,0,0,0,2,0,0,-2,2,21,203,-182,182
Mauricio Rua,Ovince Saint Preux,Ovince Saint Preux,2022-05-07,0,1,1,-1,1.928571,1.529412,-5.080002,5.080002,0,0,-10.16,10.16,0,15,41,43,-2,2,0.399159669876099,-0.399159669876099,0,0,2,3,0,0,-1,1,1385,315,1070,-1070
Philipe Lins,Ovince Saint Preux,Philipe Lins,2023-02-18,1,0,-2,2,3.4,1.529412,-2.539993,2.539993,0,0,-5.080002,5.080002,2,0,22,43,-21,21,1.8705883026123,-1.8705883026123,1,1,0,3,0,0,-3,3,301,287,14,-14
Dennis Bermudez,Pablo Garza,Dennis Bermudez,2012-05-05,1,0,-3,3,1.888889,3,-17.78,17.78,10,-10,-17.78,17.78,780,9,26,16,10,-10,-1.11111116409302,1.11111116409302,0,0,0,0,0,0,0,0,154,0,154,-154
Diego Brandao,Pablo Garza,Diego Brandao,2013-04-06,1,0,-4,4,2,3,-15.24001,15.24001,0,0,-22.86,22.86,101,0,33,16,17,-17,-1,1,1,0,0,0,1,-1,0,0,175,336,-161,161
Jordan Leavitt,Paddy Pimblett,Paddy Pimblett,2022-07-23,0,1,0,0,5.5,6.666667,-2.540009,2.540009,0,0,-5.080002,5.080002,290,104,13,23,-10,10,-1.16666650772095,1.16666650772095,2,0,0,0,2,-2,0,0,98,0,98,-98
Jared Gordon,Paddy Pimblett,Paddy Pimblett,2022-12-10,0,1,7,-7,3.166667,6.666667,-2.540009,2.540009,0,0,-12.7,12.7,388,35,25,23,2,-2,-3.49999976158142,3.49999976158142,2,1,2,0,1,-1,2,-2,112,140,-28,28
Kailin Curran,Paige VanZant,Paige VanZant,2014-11-22,0,1,3,-3,0.8,1.6,0,0,0,0,0,0,222,458,9,13,-4,4,-0.800000011920929,0.800000011920929,0,0,0,0,0,0,0,0,0,0,0,0
Felice Herrig,Paige VanZant,Paige VanZant,2015-04-18,0,1,9,-9,1.4,1.6,0,0,0,0,0,0,163,633,24,13,11,-11,-0.200000047683716,0.200000047683716,0,1,0,0,-1,1,0,0,0,147,-147,147
Alex Chambers,Paige VanZant,Paige VanZant,2015-09-05,0,1,15,-15,1,1.6,-2.539993,2.539993,0,0,-5.080002,5.080002,28,434,10,13,-3,3,-0.600000023841858,0.600000023841858,1,2,0,0,-1,1,0,0,119,140,-21,21
Rose Namajunas,Paige VanZant,Rose Namajunas,2015-12-10,1,0,2,-2,2,1.6,2.540009,-2.540009,10,-10,0,0,1001,26,18,13,5,-5,0.399999976158142,-0.399999976158142,0,3,0,0,-3,3,0,0,0,96,-96,96
Bec Rawlings,Paige VanZant,Paige VanZant,2016-08-27,0,1,5,-5,0.875,1.6,5.080002,-5.080002,10,-10,-2.540009,2.540009,0,15,15,13,2,-2,-0.725000023841858,0.725000023841858,0,0,0,0,0,0,0,0,0,261,-261,261
Jessica-Rose Clark,Paige VanZant,Jessica-Rose Clark,2018-01-14,1,0,7,-7,1.222222,1.6,2.540009,-2.540009,20,-20,-2.540009,2.540009,337,153,20,13,7,-7,-0.377777814865112,0.377777814865112,1,1,0,0,0,0,0,0,57,505,-448,448
Rachael Ostovich,Paige VanZant,Paige VanZant,2019-01-19,0,1,3,-3,0.6666667,1.6,-2.539993,2.539993,10,-10,-7.62001,7.62001,51,272,10,13,-3,3,-0.933333337306976,0.933333337306976,0,0,0,0,0,0,0,0,0,370,-370,370
Amanda Ribas,Paige VanZant,Amanda Ribas,2020-07-11,1,0,0,0,2.75,1.6,-2.539993,2.539993,10,-10,2.539993,-2.539993,68,32,15,13,2,-2,1.14999997615814,-1.14999997615814,1,1,0,0,0,0,0,0,378,539,-161,161
Macy Chiasson,Pannie Kianzad,Macy Chiasson,2018-11-30,1,0,1,-1,3,2.428571,10.16,-10.16,0,0,15.24001,-15.24001,331,13,12,24,-12,12,0.571428537368774,-0.571428537368774,0,0,0,0,0,0,0,0,0,0,0,0
Julia Avila,Pannie Kianzad,Julia Avila,2019-07-06,1,0,4,-4,4.5,2.428571,0,0,0,0,5.080002,-5.080002,346,164,11,24,-13,13,2.07142853736877,-2.07142853736877,0,0,0,0,0,0,0,0,0,218,-218,218
Jessica-Rose Clark,Pannie Kianzad,Pannie Kianzad,2019-11-09,0,1,4,-4,1.222222,2.428571,-5.079987,5.079987,0,0,-5.080002,5.080002,18,49,20,24,-4,4,-1.20634925365448,1.20634925365448,0,0,0,0,0,0,0,0,504,126,378,-378
Bethe Correia,Pannie Kianzad,Pannie Kianzad,2020-07-25,0,1,9,-9,1.833333,2.428571,-5.079987,5.079987,0,0,-5.080002,5.080002,121,5,17,24,-7,7,-0.595238089561462,0.595238089561462,1,1,2,0,0,0,2,-2,308,259,49,-49
Sijara Eubanks,Pannie Kianzad,Pannie Kianzad,2020-12-19,0,1,6,-6,1.142857,2.428571,-7.619995,7.619995,-10,10,2.539993,-2.539993,393,134,15,24,-9,9,-1.28571426868439,1.28571426868439,0,2,0,0,-2,2,0,0,84,147,-63,63
Alexis Davis,Pannie Kianzad,Pannie Kianzad,2021-06-12,0,1,7,-7,1.909091,2.428571,-2.539993,2.539993,0,0,5.080002,-5.080002,6,5,32,24,8,-8,-0.519480586051941,0.519480586051941,1,3,1,0,-2,2,1,-1,105,175,-70,70
Chris Daukaus,Parker Porter,Chris Daukaus,2020-08-15,1,0,-5,5,1.714286,1.555556,7.619995,-7.619995,-60,60,2.539993,-2.539993,35,0,19,23,-4,4,0.158730149269104,-0.158730149269104,0,0,0,0,0,0,0,0,0,0,0,0
Josh Parisian,Parker Porter,Parker Porter,2020-11-28,0,1,-4,4,2.142857,1.555556,10.15999,-10.15999,0,0,10.16,-10.16,28,267,22,23,-1,1,0.58730149269104,-0.58730149269104,0,0,0,1,0,0,-1,1,0,105,-105,105
Alan Baudot,Parker Porter,Parker Porter,2022-02-19,0,1,-2,2,2.666667,1.555556,7.619995,-7.619995,-22,22,10.16,-10.16,24,394,11,23,-12,12,1.11111116409302,-1.11111116409302,0,1,0,1,-1,1,-1,1,0,448,-448,448
Jailton Almeida,Parker Porter,Jailton Almeida,2022-05-21,1,0,-7,7,9.5,1.555556,7.619995,-7.619995,-60,60,10.16,-10.16,269,0,21,23,-2,2,7.94444441795349,-7.94444441795349,1,2,0,1,-1,1,-1,1,105,91,14,-14
John Hathaway,Pascal Krauss,John Hathaway,2012-05-05,1,0,-1,1,8.5,5.5,0,0,0,0,5.5,-5.5,299,105,19,13,6,-6,3,-3,1,0,0,0,1,-1,0,0,406,0,406,-406
Hyun Gyu Lim,Pascal Krauss,Hyun Gyu Lim,2013-08-31,1,0,2,-2,1.857143,5.5,5.080002,-5.080002,0,0,10.58,-10.58,13,0,20,13,7,-7,-3.64285719394684,3.64285719394684,0,0,0,0,0,0,0,0,0,483,-483,483
Bobby Green,Pat Healy,Bobby Green,2013-12-14,1,0,-3,3,2.142857,1.478261,-5.080002,5.080002,0,0,-2.540009,2.540009,150,185,44,57,-13,13,0.664596199989319,-0.664596199989319,2,0,0,0,2,-2,0,0,38,0,38,-38
Chris Brennan,Pat Miletich,Pat Miletich,1998-03-13,0,1,-4,4,1.615385,4.142857,-5.080002,5.080002,0,0,-5,5,0,0,34,36,-2,2,-2.52747249603271,2.52747249603271,1,0,0,0,1,-1,0,0,0,0,0,0
Mikey Burnett,Pat Miletich,Pat Miletich,1998-10-16,0,1,-6,6,2.5,4.142857,-10.16,10.16,0,0,-10,10,0,0,7,36,-29,29,-1.64285707473755,1.64285707473755,1,1,0,0,0,0,0,0,217,217,0,0
John Alessio,Pat Miletich,Pat Miletich,2000-06-09,0,1,-12,12,2.058824,4.142857,0,0,-15,15,2.880005,-2.880005,0,303,52,36,16,-16,-2.08403348922729,2.08403348922729,0,2,0,0,-2,2,0,0,0,602,-602,602
Shonie Carter,Pat Miletich,Pat Miletich,2001-06-29,0,1,-4,4,1.645161,4.142857,0,0,0,0,-2,2,0,239,82,36,46,-46,-2.49769580364227,2.49769580364227,3,3,0,0,0,0,0,0,56,385,-329,329
Matt Lindland,Pat Miletich,Matt Lindland,2002-03-22,1,0,-3,3,2.444444,4.142857,5.080002,-5.080002,15,-15,7.960007,-7.960007,170,0,31,36,-5,5,-1.69841265678406,1.69841265678406,0,4,0,0,-4,4,0,0,0,266,-266,266
Tristan Connelly,Pat Sabatini,Pat Sabatini,2021-04-24,0,1,5,-5,1.75,4.5,5.080002,-5.080002,0,0,-5.080002,5.080002,80,598,22,22,0,0,-2.75,2.75,1,0,0,0,1,-1,0,0,588,0,588,-588
Jamall Emmers,Pat Sabatini,Pat Sabatini,2021-08-28,0,1,2,-2,2.714286,4.5,5.080002,-5.080002,0,0,10.16,-10.16,49,0,26,22,4,-4,-1.78571438789368,1.78571438789368,0,1,0,0,-1,1,0,0,0,126,-126,126
Tucker Lutz,Pat Sabatini,Pat Sabatini,2021-11-20,0,1,-4,4,3,4.5,0,0,0,0,5.080002,-5.080002,76,655,16,22,-6,6,-1.5,1.5,0,2,0,0,-2,2,0,0,0,84,-84,84
TJ Laramie,Pat Sabatini,Pat Sabatini,2022-04-16,0,1,-7,7,2.4,4.5,-5.080002,5.080002,0,0,-10.16,10.16,247,479,17,22,-5,5,-2.09999990463257,2.09999990463257,0,3,0,0,-3,3,0,0,574,147,427,-427
Damon Jackson,Pat Sabatini,Damon Jackson,2022-09-17,1,0,3,-3,3.666667,4.5,7.619995,-7.619995,0,0,2.539993,-2.539993,32,0,28,22,6,-6,-0.833333253860474,0.833333253860474,2,4,1,0,-2,2,1,-1,189,154,35,-35
Lucas Almeida,Pat Sabatini,Pat Sabatini,2023-06-17,0,1,0,0,7,4.5,7.619995,-7.619995,0,0,2.539993,-2.539993,0,387,16,22,-6,6,2.5,-2.5,1,0,0,1,1,-1,-1,1,378,273,105,-105
Daniel Pineda,Pat Schilling,Daniel Pineda,2012-01-20,1,0,3,-3,1.866667,2.5,-2.540009,2.540009,0,0,0.2599945,-0.2599945,45,0,43,7,36,-36,-0.633333325386047,0.633333325386047,0,0,0,0,0,0,0,0,0,0,0,0
Max Holloway,Pat Schilling,Max Holloway,2012-06-01,1,0,-3,3,3.571429,2.5,7.619995,-7.619995,0,0,0.2599945,-0.2599945,56,60,32,7,25,-25,1.07142853736877,-1.07142853736877,0,0,0,0,0,0,0,0,118,133,-15,15
Ricardo Almeida,Patrick Cote,Patrick Cote,2008-07-05,0,1,3,-3,2.6,2.090909,2.540009,-2.540009,0,0,-2.539993,2.539993,296,105,18,34,-16,16,0.509090900421143,-0.509090900421143,1,0,1,0,1,-1,1,-1,154,0,154,-154
Alan Belcher,Patrick Cote,Alan Belcher,2010-05-08,1,0,-4,4,2.25,2.090909,7.62001,-7.62001,15,-15,0,0,147,99,26,34,-8,8,0.159090995788574,-0.159090995788574,3,1,1,0,2,-2,1,-1,147,672,-525,525
Joshua Burkman,Patrick Cote,Patrick Cote,2015-08-23,0,1,0,0,1.75,2.090909,-2.539993,2.539993,0,0,-7.619995,7.619995,60,160,44,34,10,-10,-0.340909004211426,0.340909004211426,0,0,0,0,0,0,0,0,92,1933,-1841,1841
Donald Cerrone,Patrick Cote,Donald Cerrone,2016-06-18,1,0,-3,3,2.117647,2.090909,5.080002,-5.080002,-15,15,-5.080002,5.080002,283,0,53,34,19,-19,2.6738166809082e-02,-2.6738166809082e-02,1,1,2,0,0,0,2,-2,118,300,-182,182
Thiago Alves,Patrick Cote,Thiago Alves,2017-04-08,1,0,-4,4,1.533333,2.090909,-5.080002,5.080002,0,0,-12.7,12.7,162,33,38,34,4,-4,-0.557575702667236,0.557575702667236,0,0,2,1,0,0,1,-1,147,294,-147,147
Daniel Cormier,Patrick Cummins,Daniel Cormier,2014-02-22,1,0,1,-1,7.333333,1.428571,-7.62001,7.62001,30,-30,-10.15999,10.15999,9,0,25,17,8,-8,5.90476202964783,-5.90476202964783,2,0,0,0,2,-2,0,0,126,0,126,-126
Antonio Carlos Junior,Patrick Cummins,Patrick Cummins,2014-12-20,0,1,-10,10,2.2,1.428571,0,0,-20,20,7.62001,-7.62001,37,674,16,17,-1,1,0.77142858505249,-0.77142858505249,1,0,0,1,1,-1,-1,1,203,301,-98,98
Rafael Cavalcante,Patrick Cummins,Patrick Cummins,2015-08-01,0,1,1,-1,1.714286,1.428571,-2.540009,2.540009,0,0,-5.079987,5.079987,3,430,19,17,2,-2,0.285714268684387,-0.285714268684387,1,1,1,1,0,0,0,0,630,224,406,-406
Jan Blachowicz,Patrick Cummins,Patrick Cummins,2017-04-08,0,1,-2,2,2.9,1.428571,0,0,0,0,5.080002,-5.080002,72,459,39,17,22,-22,1.47142863273621,-1.47142863273621,0,2,0,1,-2,2,-1,1,217,616,-399,399
Corey Anderson,Patrick Cummins,Corey Anderson,2018-04-21,1,0,-9,9,2.8,1.428571,2.539993,-2.539993,0,0,7.62001,-7.62001,482,30,19,17,2,-2,1.37142848968506,-1.37142848968506,0,3,3,1,-3,3,2,-2,168,378,-210,210
Misha Cirkunov,Patrick Cummins,Misha Cirkunov,2018-10-27,1,0,-6,6,1.666667,1.428571,2.539993,-2.539993,0,0,2.540009,-2.540009,39,86,24,17,7,-7,0.238095164299011,-0.238095164299011,0,0,2,1,0,0,1,-1,315,189,126,-126
Royce Gracie,Patrick Smith,Royce Gracie,1994-03-11,1,0,-3,3,7.5,1.176471,-2.540009,2.540009,-50,50,3,-3,0,0,17,37,-20,20,6.32352936267853,-6.32352936267853,2,0,0,0,2,-2,0,0,0,0,0,0
Johnny Rhodes,Patrick Smith,Patrick Smith,1994-03-11,0,1,,,2,1.176471,-5.080002,5.080002,-15,15,-6,6,0,0,3,37,-34,34,0.823529362678528,-0.823529362678528,0,0,0,0,0,0,0,0,0,0,0,0
Scott Morris,Patrick Smith,Patrick Smith,1994-03-11,0,1,,,2,1.176471,-10.16,10.16,-15,15,-11,11,0,0,3,37,-34,34,0.823529362678528,-0.823529362678528,0,1,0,1,-1,1,-1,1,0,0,0,0
Rudyard Moncayo,Patrick Smith,Patrick Smith,1995-07-14,0,1,,,0,1.176471,-10.16,10.16,-30,30,-11,11,0,0,3,37,-34,34,-1.17647063732147,1.17647063732147,0,2,0,1,-2,2,-1,1,0,490,-490,490
Daniel Spohn,Patrick Walsh,Patrick Walsh,2014-07-06,0,1,4,-4,2.5,3.333333,12.7,-12.7,20,-20,17.66,-17.66,64,664,21,13,8,-8,-0.833333253860474,0.833333253860474,0,0,0,0,0,0,0,0,0,0,0,0
Daniel Kelly,Patrick Walsh,Daniel Kelly,2015-02-14,1,0,11,-11,3.25,3.333333,2.540009,-2.540009,0,0,-5.199997,5.199997,0,2,17,13,4,-4,-8.33332538604736e-02,8.33332538604736e-02,1,1,0,0,0,0,0,0,99,223,-124,124
Chris Beal,Patrick Williams,Chris Beal,2014-04-26,1,0,-4,4,2,1.333333,-2.540009,2.540009,-10,10,-10.16,10.16,4,36,15,14,1,-1,0.666666626930237,-0.666666626930237,0,0,0,0,0,0,0,0,0,0,0,0
Alejandro Perez,Patrick Williams,Patrick Williams,2015-06-13,0,1,-8,8,2.555556,1.333333,-5.080002,5.080002,0,0,-15.24001,15.24001,2,2,32,14,18,-18,1.22222220897675,-1.22222220897675,1,0,0,1,1,-1,-1,1,210,413,-203,203
Tom Duquesnoy,Patrick Williams,Tom Duquesnoy,2017-04-15,1,0,-12,12,8,1.333333,-2.540009,2.540009,0,0,-12.7,12.7,14,38,18,14,4,-4,6.66666662693024,-6.66666662693024,0,1,0,1,-1,1,-1,1,0,672,-672,672
Luke Sanders,Patrick Williams,Luke Sanders,2018-04-14,1,0,-4,4,2.6,1.333333,-5.080002,5.080002,0,0,-15.24001,15.24001,79,55,18,14,4,-4,1.26666653156281,-1.26666653156281,0,0,1,2,0,0,-1,1,126,364,-238,238
Andrei Arlovski,Paul Buentello,Andrei Arlovski,2005-10-07,1,0,-5,5,1.545455,2.058824,2.539993,-2.539993,-5,5,0,0,3,0,56,52,4,-4,-0.513369083404541,0.513369083404541,5,0,2,0,5,-5,2,-2,125,0,125,-125
Gilbert Aldana,Paul Buentello,Paul Buentello,2006-02-04,0,1,-4,4,3,2.058824,-2.540009,2.540009,5,-5,-7.580002,7.580002,108,117,8,52,-44,44,0.941176414489746,-0.941176414489746,0,0,0,1,0,0,-1,1,0,120,-120,120
Magomed Ankalaev,Paul Craig,Paul Craig,2018-03-17,0,1,-5,5,18,2.833333,0,0,20,-20,-2.539993,2.539993,402,107,19,23,-4,4,15.1666667461395,-15.1666667461395,0,0,0,0,0,0,0,0,0,0,0,0
Gadzhimurad Antigulov,Paul Craig,Paul Craig,2020-07-25,0,1,1,-1,2.5,2.833333,-10.16,10.16,20,-20,-15.23999,15.23999,101,0,28,23,5,-5,-0.333333253860474,0.333333253860474,0,1,2,0,-1,1,2,-2,462,861,-399,399
Danny Castillo,Paul Felder,Paul Felder,2015-01-03,0,1,5,-5,1.7,2.833333,-5.080002,5.080002,0,0,2.539993,-2.539993,0,2,27,23,4,-4,-1.13333320617676,1.13333320617676,0,0,1,0,0,0,1,-1,126,0,126,-126
Edson Barboza,Paul Felder,Edson Barboza,2015-07-25,1,0,-2,2,2.090909,2.833333,0,0,-10,10,12.7,-12.7,0,18,34,23,11,-11,-0.742424249649048,0.742424249649048,0,1,1,0,-1,1,1,-1,153,203,-50,50
Daron Cruickshank,Paul Felder,Paul Felder,2016-01-17,0,1,-1,1,1.8,2.833333,-7.619995,7.619995,0,0,5.080002,-5.080002,177,372,28,23,5,-5,-1.03333330154419,1.03333330154419,0,0,0,0,0,0,0,0,176,176,0,0
Joshua Burkman,Paul Felder,Paul Felder,2016-05-29,0,1,4,-4,1.75,2.833333,-2.539993,2.539993,15,-15,5.080002,-5.080002,205,73,44,23,21,-21,-1.08333325386047,1.08333325386047,1,1,1,0,0,0,1,-1,113,133,-20,20
Edson Barboza,Paul Felder,Paul Felder,2019-09-07,0,1,-2,2,2.090909,2.833333,0,0,-10,10,12.7,-12.7,109,123,34,23,11,-11,-0.742424249649048,0.742424249649048,0,2,3,0,-2,2,3,-3,161,1196,-1035,1035
Rafael Dos Anjos,Paul Felder,Rafael Dos Anjos,2020-11-14,1,0,0,0,2.133333,2.833333,-7.619995,7.619995,15,-15,0,0,855,100,47,23,24,-24,-0.699999809265137,0.699999809265137,0,3,1,0,-3,3,1,-1,483,434,49,-49
Gary Goodridge,Paul Herrera,Gary Goodridge,1996-02-16,1,0,,,1.045455,1,12.7,-12.7,64,-64,13,-13,0,0,45,2,43,-43,4.54545021057129e-02,-4.54545021057129e-02,0,0,0,0,0,0,0,0,0,0,0,0
Marcus Davis,Paul Kelly,Marcus Davis,2008-10-18,1,0,11,-11,2,2.8,2.540009,-2.540009,15,-15,0,0,46,23,33,19,14,-14,-0.799999952316284,0.799999952316284,0,0,1,0,0,0,1,-1,133,0,133,-133
Rolando Delgado,Paul Kelly,Paul Kelly,2009-06-13,0,1,3,-3,1.833333,2.8,15.24001,-15.24001,0,0,17.78,-17.78,243,474,17,19,-2,2,-0.966666579246521,0.966666579246521,1,0,0,0,1,-1,0,0,182,238,-56,56
Donald Cerrone,Paul Kelly,Donald Cerrone,2011-02-05,1,0,1,-1,2.117647,2.8,10.16,-10.16,0,0,7.619995,-7.619995,211,0,53,19,34,-34,-0.682352781295776,0.682352781295776,0,1,0,0,-1,1,0,0,0,602,-602,602
Mirsad Bektic,Paul Redmond,Mirsad Bektic,2015-01-24,1,0,-5,5,3.25,1.714286,-5.080002,5.080002,0,0,-2.199997,2.199997,833,0,17,19,-2,2,1.53571426868439,-1.53571426868439,1,0,0,0,1,-1,0,0,280,0,280,-280
Tony DeSouza,Paul Rodriguez,Tony DeSouza,2001-06-29,1,0,,,2.75,1.111111,12.70001,-12.70001,15,-15,-15.2,15.2,32,0,15,19,-4,4,1.63888883590698,-1.63888883590698,0,0,0,0,0,0,0,0,0,0,0,0
Mark Holst,Paul Sass,Paul Sass,2010-10-16,0,1,3,-3,2,7,0,0,0,0,1.580002,-1.580002,198,0,18,16,2,-2,-5,5,0,0,0,0,0,0,0,0,0,0,0,0
Michael Johnson,Paul Sass,Paul Sass,2011-10-01,0,1,2,-2,1.157895,7,-5.080002,5.080002,0,0,0,0,37,5,41,16,25,-25,-5.84210526943207,5.84210526943207,0,1,0,0,-1,1,0,0,0,350,-350,350
Danny Castillo,Paul Sass,Danny Castillo,2013-02-16,1,0,9,-9,1.7,7,-7.62001,7.62001,0,0,-5.080002,5.080002,735,0,27,16,11,-11,-5.29999995231628,5.29999995231628,0,2,1,0,-2,2,1,-1,134,504,-370,370
Edilberto de Oliveira,Paul Taylor,Paul Taylor,2007-04-21,0,1,-3,3,1.933333,1.833333,0,0,15,-15,3.119995,-3.119995,19,8,44,17,27,-27,9.99999046325684e-02,-9.99999046325684e-02,0,0,0,0,0,0,0,0,0,0,0,0
Marcus Davis,Paul Taylor,Marcus Davis,2007-09-08,1,0,7,-7,2,1.833333,-5.080002,5.080002,15,-15,-5.080002,5.080002,151,66,33,17,16,-16,0.166666626930237,-0.166666626930237,3,1,1,0,2,-2,1,-1,84,140,-56,56
Paul Kelly,Paul Taylor,Paul Kelly,2008-01-19,1,0,-5,5,2.8,1.833333,-7.62001,7.62001,0,0,-5.080002,5.080002,727,82,19,17,2,-2,0.966666579246521,-0.966666579246521,0,0,0,0,0,0,0,0,0,133,-133,133
Jess Liaudin,Paul Taylor,Paul Taylor,2008-06-07,0,1,,,1.818182,1.833333,-7.62001,7.62001,15,-15,0,0,537,189,31,17,14,-14,-1.51515007019043e-02,1.51515007019043e-02,2,0,0,0,2,-2,0,0,273,140,133,-133
Chris Lytle,Paul Taylor,Chris Lytle,2008-10-18,1,0,6,-6,1.722222,1.833333,-2.540009,2.540009,15,-15,-10.16,10.16,479,64,49,17,32,-32,-0.111111164093018,0.111111164093018,0,1,1,0,-1,1,1,-1,707,133,574,-574
Peter Sobotta,Paul Taylor,Paul Taylor,2009-06-13,0,1,-7,7,2.428571,1.833333,0,0,15,-15,7.619995,-7.619995,128,273,24,17,7,-7,0.595238089561462,-0.595238089561462,0,0,0,0,0,0,0,0,0,238,-238,238
John Hathaway,Paul Taylor,John Hathaway,2009-11-14,1,0,-7,7,8.5,1.833333,2.539993,-2.539993,15,-15,7.619995,-7.619995,803,0,19,17,2,-2,6.66666662693024,-6.66666662693024,1,1,0,0,0,0,0,0,154,154,0,0
Sam Stout,Paul Taylor,Sam Stout,2010-10-23,1,0,-4,4,1.666667,1.833333,-7.62001,7.62001,0,0,-5.080002,5.080002,27,0,32,17,15,-15,-0.166666746139526,0.166666746139526,1,0,0,0,1,-1,0,0,553,343,210,-210
Gabe Ruediger,Paul Taylor,Paul Taylor,2011-02-05,0,1,2,-2,2.25,1.833333,-5.080002,5.080002,0,0,-2.880005,2.880005,67,198,26,17,9,-9,0.416666626930237,-0.416666626930237,0,0,0,0,0,0,0,0,0,105,-105,105
David Abbott,Paul Varelans,David Abbott,1995-07-14,1,0,,,0.6666667,1,-20.31999,20.31999,-35,35,-23.5,23.5,0,0,25,18,7,-7,-0.333333313465118,0.333333313465118,1,0,0,0,1,-1,0,0,0,0,0,0
Mark Hall,Paul Varelans,Paul Varelans,1995-09-08,0,1,,,0.8333333,1,-20.31999,20.31999,-110,110,-18,18,0,0,11,18,-7,7,-0.166666686534882,0.166666686534882,0,0,0,2,0,0,-2,2,0,56,-56,56
Gerry Harris,Paul Varelans,Paul Varelans,1995-09-08,0,1,,,0.25,1,0,0,-30,30,1,-1,0,0,5,18,-13,13,-0.75,0.75,0,1,0,1,-1,1,-1,1,0,0,0,0
Marco Ruas,Paul Varelans,Marco Ruas,1995-09-08,1,0,,,2.25,1,-17.78,17.78,-90,90,-18,18,0,0,13,18,-5,5,1.25,-1.25,0,2,0,1,-2,2,-1,1,0,0,0,0
Dan Severn,Paul Varelans,Dan Severn,1995-12-16,1,0,,,5.31579,1,-15.23999,15.23999,-50,50,-15,15,0,0,120,18,102,-102,4.31578969955444,-4.31578969955444,0,0,0,2,0,0,-2,2,0,99,-99,99
Joe Moreira,Paul Varelans,Paul Varelans,1996-02-16,0,1,,,1,1,-22.86,22.86,-105,105,-23,23,0,0,4,18,-14,14,0,0,0,0,0,2,0,0,-2,2,0,62,-62,62
Kimo Leopoldo,Paul Varelans,Kimo Leopoldo,1996-12-07,1,0,,,1.428571,1,-12.7,12.7,-65,65,-13,13,0,0,17,18,-1,1,0.428571462631226,-0.428571462631226,0,1,0,2,-1,1,-2,2,295,295,0,0
Oluwale Bamgbose,Paulo Costa,Paulo Costa,2017-06-03,0,1,3,-3,1.5,7,-5.080002,5.080002,0,0,15.23999,-15.23999,82,15,10,16,-6,6,-5.5,5.5,0,0,1,0,0,0,1,-1,413,0,413,-413
Israel Adesanya,Paulo Costa,Israel Adesanya,2020-09-26,1,0,2,-2,8,7,7.619995,-7.619995,0,0,20.31999,-20.31999,9,1,27,16,11,-11,1,-1,8,1,0,0,7,-7,0,0,203,1211,-1008,1008
Cesar Marscucci,Paulo Santos,Cesar Marscucci,1998-10-16,1,0,,,1.5,0,,,,,-12,12,0,0,5,3,2,-2,1.5,-1.5,0,0,0,0,0,0,0,0,0,0,0,0
Josh Koscheck,Paulo Thiago,Paulo Thiago,2009-02-21,0,1,3,-3,1.545455,2,-2.539993,2.539993,0,0,-2.540009,2.540009,0,2,28,27,1,-1,-0.454545497894287,0.454545497894287,2,0,0,0,2,-2,0,0,73,0,73,-73
Jon Fitch,Paulo Thiago,Jon Fitch,2009-07-11,1,0,3,-3,4.285714,2,2.540009,-2.540009,0,0,0,0,741,83,37,27,10,-10,2.2857141494751,-2.2857141494751,1,1,0,0,0,0,0,0,161,140,21,-21
Mike Swick,Paulo Thiago,Paulo Thiago,2010-02-06,0,1,1,-1,2.5,2,5.080002,-5.080002,0,0,7.619995,-7.619995,30,15,21,27,-6,6,0.5,-0.5,1,0,0,0,1,-1,0,0,1435,210,1225,-1225
Martin Kampmann,Paulo Thiago,Martin Kampmann,2010-06-12,1,0,-1,1,2.857143,2,2.540009,-2.540009,0,0,-5.080002,5.080002,419,93,27,27,0,0,0.857142925262451,-0.857142925262451,1,1,1,0,0,0,1,-1,161,126,35,-35
Diego Sanchez,Paulo Thiago,Diego Sanchez,2010-10-23,1,0,-1,1,2.384615,2,-2.539993,2.539993,0,0,-5.080002,5.080002,552,92,44,27,17,-17,0.384615421295166,-0.384615421295166,1,0,0,0,1,-1,0,0,609,133,476,-476
David Mitchell,Paulo Thiago,Paulo Thiago,2011-08-27,0,1,1,-1,3.142857,2,2.540009,-2.540009,0,0,2.539993,-2.539993,37,295,29,27,2,-2,1.14285707473755,-1.14285707473755,0,0,0,0,0,0,0,0,346,308,38,-38
Siyar Bahadurzada,Paulo Thiago,Siyar Bahadurzada,2012-04-14,1,0,-4,4,3,2,0,0,0,0,-2.540009,2.540009,2,0,32,27,5,-5,1,-1,0,1,0,0,-1,1,0,0,0,231,-231,231
Dong Hyun Kim,Paulo Thiago,Dong Hyun Kim,2012-11-10,1,0,-1,1,5.5,2,7.62001,-7.62001,0,0,5.079987,-5.079987,732,17,26,27,-1,1,3.5,-3.5,0,0,1,1,0,0,0,0,126,210,-84,84
Michel Prazeres,Paulo Thiago,Paulo Thiago,2013-05-18,0,1,-1,1,6.5,2,-12.7,12.7,0,0,-17.78001,17.78001,282,162,30,27,3,-3,4.5,-4.5,0,0,0,1,0,0,-1,1,0,189,-189,189
Brandon Thatch,Paulo Thiago,Brandon Thatch,2013-11-09,1,0,-4,4,2.2,2,7.62001,-7.62001,0,0,0,0,27,23,16,27,-11,11,0.200000047683716,-0.200000047683716,0,1,0,1,-1,1,-1,1,0,175,-175,175
Sean Spencer,Paulo Thiago,Sean Spencer,2014-09-13,1,0,-6,6,2,2,-2.539993,2.539993,0,0,0,0,296,159,18,27,-9,9,0,0,1,0,0,2,1,-1,-2,2,374,308,66,-66
Leon Edwards,Pawel Pawlak,Leon Edwards,2015-07-18,1,0,-3,3,7,4,5.080002,-5.080002,0,0,2.540009,-2.540009,423,20,24,15,9,-9,3,-3,0,0,0,0,0,0,0,0,252,0,252,-252
Cynthia Calvillo,Pearl Gonzalez,Cynthia Calvillo,2017-04-08,1,0,-1,1,1.5,2,0,0,0,0,-2.440002,2.440002,322,77,15,9,6,-6,-0.5,0.5,1,0,0,0,1,-1,0,0,35,0,35,-35
Poliana Botelho,Pearl Gonzalez,Poliana Botelho,2017-10-07,1,0,-3,3,1.6,2,10.16,-10.16,10,-10,5.179993,-5.179993,57,610,13,9,4,-4,-0.399999976158142,0.399999976158142,0,0,0,0,0,0,0,0,0,182,-182,182
Raphael Assuncao,Pedro Munhoz,Raphael Assuncao,2014-02-22,1,0,4,-4,2.8,2.5,-2.539993,2.539993,0,0,2.539993,-2.539993,124,0,38,28,10,-10,0.299999952316284,-0.299999952316284,5,0,1,0,5,-5,1,-1,136,0,136,-136
Matt Hobar,Pedro Munhoz,Pedro Munhoz,2014-05-31,0,1,0,0,3,2.5,10.16,-10.16,0,0,12.7,-12.7,16,31,12,28,-16,16,0.5,-0.5,0,0,0,0,0,0,0,0,0,98,-98,98
Russell Doane,Pedro Munhoz,Pedro Munhoz,2016-07-07,0,1,0,0,1.875,2.5,2.539993,-2.539993,0,0,12.7,-12.7,8,20,23,28,-5,5,-0.625,0.625,0,1,0,0,-1,1,0,0,361,768,-407,407
Rob Font,Pedro Munhoz,Pedro Munhoz,2017-10-28,0,1,-1,1,2.857143,2.5,5.080002,-5.080002,0,0,15.23999,-15.23999,5,2,27,28,-1,1,0.357142925262451,-0.357142925262451,2,2,0,0,0,0,0,0,112,478,-366,366
John Dodson,Pedro Munhoz,John Dodson,2018-03-03,1,0,2,-2,1.833333,2.5,-7.619995,7.619995,0,0,2.539993,-2.539993,0,62,34,28,6,-6,-0.666666626930237,0.666666626930237,0,3,0,0,-3,3,0,0,112,126,-14,14
Brett Johns,Pedro Munhoz,Pedro Munhoz,2018-08-04,0,1,-5,5,8.5,2.5,2.539993,-2.539993,0,0,15.23999,-15.23999,66,271,19,28,-9,9,6,-6,0,0,0,0,0,0,0,0,105,154,-49,49
Bryan Caraway,Pedro Munhoz,Pedro Munhoz,2018-11-30,0,1,2,-2,2.333333,2.5,5.080002,-5.080002,0,0,7.619995,-7.619995,17,2,30,28,2,-2,-0.166666746139526,0.166666746139526,0,1,0,0,-1,1,0,0,272,118,154,-154
Cody Garbrandt,Pedro Munhoz,Pedro Munhoz,2019-03-02,0,1,-5,5,2.6,2.5,5.080002,-5.080002,0,0,0,0,4,21,18,28,-10,10,9.99999046325684e-02,-9.99999046325684e-02,2,2,0,0,0,0,0,0,924,92,832,-832
Frankie Edgar,Pedro Munhoz,Frankie Edgar,2020-08-22,1,0,5,-5,2.090909,2.5,0,0,0,0,7.619995,-7.619995,18,0,34,28,6,-6,-0.409090995788574,0.409090995788574,0,3,2,0,-3,3,2,-2,245,539,-294,294
Jose Aldo,Pedro Munhoz,Jose Aldo,2021-08-07,1,0,0,0,3.875,2.5,2.539993,-2.539993,0,0,12.7,-12.7,0,10,39,28,11,-11,1.375,-1.375,1,0,4,0,1,-1,4,-4,231,350,-119,119
Dominick Cruz,Pedro Munhoz,Dominick Cruz,2021-12-11,1,0,1,-1,6,2.5,5.080002,-5.080002,0,0,7.619995,-7.619995,6,10,28,28,0,0,3.5,-3.5,1,0,0,0,1,-1,0,0,280,126,154,-154
Chris Gutierrez,Pedro Munhoz,Pedro Munhoz,2023-04-15,0,1,-5,5,3.8,2.5,7.619995,-7.619995,0,0,5.079987,-5.079987,6,174,24,28,-4,4,1.29999995231628,-1.29999995231628,2,0,0,0,2,-2,0,0,1050,490,560,-560
David Abbott,Pedro Rizzo,Pedro Rizzo,1998-10-16,0,1,,,0.6666667,1.818182,-2.539993,2.539993,24,-24,-5.5,5.5,0,0,25,31,-6,6,-1.15151518583298,1.15151518583298,2,0,1,0,2,-2,1,-1,154,0,154,-154
Mark Coleman,Pedro Rizzo,Pedro Rizzo,1999-01-08,0,1,10,-10,1.6,1.818182,0,0,-36,36,2.5,-2.5,0,0,26,31,-5,5,-0.218181848526001,0.218181848526001,0,1,1,0,-1,1,1,-1,238,84,154,-154
Tsuyoshi Kohsaka,Pedro Rizzo,Pedro Rizzo,1999-11-19,0,1,4,-4,1.421053,1.818182,-5.080002,5.080002,-16,16,-5,5,0,8,46,31,15,-15,-0.39712929725647,0.39712929725647,1,2,1,0,-1,1,1,-1,126,315,-189,189
Kevin Randleman,Pedro Rizzo,Kevin Randleman,2000-06-09,1,0,2,-2,1.0625,1.818182,-7.619995,7.619995,-36,36,-8,8,214,0,33,31,2,-2,-0.755681872367859,0.755681872367859,1,3,0,0,-2,2,0,0,203,203,0,0
Josh Barnett,Pedro Rizzo,Pedro Rizzo,2001-02-23,0,1,-3,3,4.375,1.818182,5.080002,-5.080002,9,-9,10.12,-10.12,0,1,43,31,12,-12,2.55681812763214,-2.55681812763214,1,0,0,0,1,-1,0,0,98,259,-161,161
Randy Couture,Pedro Rizzo,Randy Couture,2001-05-04,1,0,10,-10,1.727273,1.818182,0,0,-36,36,2.5,-2.5,478,256,30,31,-1,1,-9.09091234207153e-02,9.09091234207153e-02,4,1,0,0,3,-3,0,0,168,70,98,-98
Randy Couture,Pedro Rizzo,Randy Couture,2001-11-02,1,0,11,-11,1.727273,1.818182,0,0,-36,36,2.5,-2.5,348,3,30,31,-1,1,-9.09091234207153e-02,9.09091234207153e-02,5,0,0,0,5,-5,0,0,182,182,0,0
Andrei Arlovski,Pedro Rizzo,Pedro Rizzo,2002-03-22,0,1,-4,4,1.545455,1.818182,5.080002,-5.080002,-1,1,7.580002,-7.580002,0,0,56,31,25,-25,-0.272727370262146,0.272727370262146,0,0,1,1,0,0,0,0,266,140,126,-126
Gan McGee,Pedro Rizzo,Gan McGee,2002-09-27,1,0,-3,3,2.6,1.818182,22.86,-22.86,24,-24,22,-22,11,0,18,31,-13,13,0.781818032264709,-0.781818032264709,0,1,0,1,-1,1,-1,1,0,189,-189,189
Vladimir Matyushenko,Pedro Rizzo,Vladimir Matyushenko,2003-02-28,1,0,4,-4,3.375,1.818182,-2.539993,2.539993,-36,36,-3.999329e-02,3.999329e-02,434,79,35,31,4,-4,1.55681812763214,-1.55681812763214,1,0,0,2,1,-1,-2,2,98,154,-56,56
Jessamyn Duke,Peggy Morgan,Jessamyn Duke,2013-11-30,1,0,-6,6,0.6,1,-5.080002,5.080002,0,0,25.42,-25.42,88,352,8,8,0,0,-0.399999976158142,0.399999976158142,0,0,0,0,0,0,0,0,0,0,0,0
Evan Dunham,Per Eklund,Evan Dunham,2009-02-21,1,0,,,2,2.8,0,0,0,0,-5.080002,5.080002,31,32,27,19,8,-8,-0.799999952316284,0.799999952316284,0,0,0,0,0,0,0,0,0,0,0,0
Jack Della Maddalena,Pete Rodriguez,Jack Della Maddalena,2022-01-22,1,0,0,0,8,5,5.080002,-5.080002,15,-15,5.080002,-5.080002,1,0,18,6,12,-12,3,-3,0,0,0,0,0,0,0,0,0,0,0,0
Mike Jackson,Pete Rodriguez,Pete Rodriguez,2022-10-15,0,1,12,-12,0.5,5,12.70001,-12.70001,15,-15,7.62001,-7.62001,0,15,3,6,-3,3,-4.5,4.5,0,0,0,1,0,0,-1,1,0,266,-266,266
Phil Baroni,Pete Sell,Pete Sell,2005-02-05,0,1,6,-6,0.8333333,1.428571,-5.080002,5.080002,0,0,-7.619995,7.619995,376,262,33,17,16,-16,-0.595238149166107,0.595238149166107,0,0,1,0,0,0,1,-1,231,0,231,-231
Nate Quarry,Pete Sell,Nate Quarry,2005-08-06,1,0,10,-10,3,1.428571,2.540009,-2.540009,15,-15,-7.619995,7.619995,1,0,16,17,-1,1,1.57142853736877,-1.57142853736877,1,1,0,0,0,0,0,0,119,182,-63,63
Thales Leites,Pete Sell,Thales Leites,2007-04-07,1,0,1,-1,3.111111,1.428571,5.080002,-5.080002,15,-15,7.619995,-7.619995,654,36,37,17,20,-20,1.68253970146179,-1.68253970146179,0,0,0,1,0,0,-1,1,0,609,-609,609
Nate Quarry,Pete Sell,Nate Quarry,2007-09-19,1,0,10,-10,3,1.428571,2.540009,-2.540009,15,-15,-7.619995,7.619995,23,151,16,17,-1,1,1.57142853736877,-1.57142853736877,2,0,0,1,2,-2,-1,1,774,165,609,-609
Joshua Burkman,Pete Sell,Pete Sell,2008-10-25,0,1,2,-2,1.75,1.428571,-2.539993,2.539993,0,0,-7.619995,7.619995,232,82,44,17,27,-27,0.321428537368774,-0.321428537368774,0,0,0,2,0,0,-2,2,126,402,-276,276
Matt Brown,Pete Sell,Matt Brown,2009-03-07,1,0,2,-2,1.368421,1.428571,2.540009,-2.540009,0,0,0,0,35,21,45,17,28,-28,-6.01503849029541e-02,6.01503849029541e-02,1,1,0,2,0,0,-2,2,112,133,-21,21
Zach Light,Pete Spratt,Pete Spratt,2002-06-22,0,1,-3,3,0.8181818,1.086957,-2.539993,2.539993,0,0,0,0,123,3,20,48,-28,28,-0.268774688243866,0.268774688243866,0,0,0,0,0,0,0,0,0,0,0,0
Carlos Newton,Pete Spratt,Carlos Newton,2002-11-22,1,0,-5,5,1.142857,1.086957,0,0,0,0,0,0,78,2,30,48,-18,18,5.59006929397583e-02,-5.59006929397583e-02,0,1,0,0,-1,1,0,0,0,153,-153,153
Robbie Lawler,Pete Spratt,Pete Spratt,2003-04-25,0,1,-11,11,1.875,1.086957,5.080002,-5.080002,0,0,9.960007,-9.960007,137,99,46,48,-2,2,0.78804349899292,-0.78804349899292,1,0,0,0,1,-1,0,0,350,154,196,-196
Josh Koscheck,Pete Spratt,Josh Koscheck,2005-08-06,1,0,-7,7,1.545455,1.086957,2.540009,-2.540009,0,0,7.419998,-7.419998,90,0,28,48,-20,20,0.458498001098633,-0.458498001098633,1,1,0,0,0,0,0,0,119,834,-715,715
Jeremy Jackson,Pete Spratt,Pete Spratt,2006-11-11,0,1,-11,11,1.8,1.086957,2.540009,-2.540009,0,0,2,-2,202,66,14,48,-34,34,0.713043451309204,-0.713043451309204,0,0,0,0,0,0,0,0,0,462,-462,462
Marcus Davis,Pete Spratt,Marcus Davis,2007-04-07,1,0,-3,3,2,1.086957,2.540009,-2.540009,0,0,-0.1999969,0.1999969,331,20,33,48,-15,15,0.91304349899292,-0.91304349899292,1,1,1,0,0,0,1,-1,179,147,32,-32
Tamdan McCrory,Pete Spratt,Tamdan McCrory,2007-06-12,1,0,-16,16,2.8,1.086957,17.78,-17.78,15,-15,15.03999,-15.03999,99,270,19,48,-29,29,1.7130434513092,-1.7130434513092,0,0,0,0,0,0,0,0,0,66,-66,66
Mark Coleman,Pete Williams,Pete Williams,1998-05-15,0,1,11,-11,1.6,2,-5.080002,5.080002,-30,30,-2.5,2.5,0,0,26,18,8,-8,-0.399999976158142,0.399999976158142,0,0,0,0,0,0,0,0,292,0,292,-292
Tsuyoshi Kohsaka,Pete Williams,Tsuyoshi Kohsaka,1998-10-16,1,0,5,-5,1.421053,2,-10.16,10.16,-10,10,-10,10,0,0,46,18,28,-28,-0.578947424888611,0.578947424888611,1,1,0,0,0,0,0,0,217,154,63,-63
Jason Godsey,Pete Williams,Pete Williams,1999-03-05,0,1,,,1,2,-2.539993,2.539993,-5,5,-2,2,0,0,32,18,14,-14,-1,1,0,0,0,0,0,0,0,0,0,140,-140,140
Travis Fulton,Pete Williams,Pete Williams,1999-05-07,0,1,-2,2,4.773585,2,-7.619995,7.619995,5,-5,-7,7,0,0,306,18,288,-288,2.77358484268188,-2.77358484268188,0,1,0,0,-1,1,0,0,0,63,-63,63
Kevin Randleman,Pete Williams,Kevin Randleman,1999-11-19,1,0,4,-4,1.0625,2,-12.7,12.7,-30,30,-13,13,1060,70,33,18,15,-15,-0.9375,0.9375,0,2,0,0,-2,2,0,0,196,196,0,0
Semmy Schilt,Pete Williams,Semmy Schilt,2001-05-04,1,0,2,-2,1.857143,2,17.78,-17.78,30,-30,18,-18,22,287,40,18,22,-22,-0.142857193946838,0.142857193946838,0,0,0,0,0,0,0,0,0,532,-532,532
Ricco Rodriguez,Pete Williams,Ricco Rodriguez,2001-11-02,1,0,-2,2,2.12,2,2.539993,-2.539993,30,-30,-15,15,436,46,78,18,60,-60,0.119999885559082,-0.119999885559082,0,0,0,1,0,0,-1,1,0,182,-182,182
Frank Mir,Pete Williams,Frank Mir,2002-03-22,1,0,-4,4,1.636364,2,0,0,29,-29,7.660004,-7.660004,2,19,29,18,11,-11,-0.363636374473572,0.363636374473572,1,0,0,2,1,-1,-2,2,140,140,0,0
Amir Sadollah,Peter Sobotta,Amir Sadollah,2010-11-13,1,0,7,-7,1.2,2.428571,-5.080002,5.080002,0,0,0,0,47,204,11,24,-13,13,-1.22857141494751,1.22857141494751,0,0,0,0,0,0,0,0,0,0,0,0
Pawel Pawlak,Peter Sobotta,Peter Sobotta,2014-05-31,0,1,-2,2,4,2.428571,0,0,0,0,-5.080002,5.080002,0,478,15,24,-9,9,1.57142853736877,-1.57142853736877,0,0,0,0,0,0,0,0,0,1295,-1295,1295
Steve Kennedy,Peter Sobotta,Peter Sobotta,2015-06-20,0,1,4,-4,3,2.428571,-2.540009,2.540009,0,0,-7.5,7.5,29,81,32,24,8,-8,0.571428537368774,-0.571428537368774,0,1,0,0,-1,1,0,0,0,385,-385,385
Kyle Noke,Peter Sobotta,Kyle Noke,2015-11-14,1,0,7,-7,2.2,2.428571,2.539993,-2.539993,0,0,2.539993,-2.539993,0,14,32,24,8,-8,-0.22857141494751,0.22857141494751,1,2,0,0,-1,1,0,0,189,147,42,-42
Nicolas Dalby,Peter Sobotta,Peter Sobotta,2016-09-03,0,1,2,-2,5.5,2.428571,-2.540009,2.540009,0,0,-2.539993,2.539993,28,622,26,24,2,-2,3.07142853736877,-3.07142853736877,1,0,0,1,1,-1,-1,1,462,294,168,-168
Ben Saunders,Peter Sobotta,Peter Sobotta,2017-05-28,0,1,4,-4,1.692308,2.428571,5.080002,-5.080002,0,0,5.080002,-5.080002,0,63,35,24,11,-11,-0.736263751983643,0.736263751983643,0,1,1,1,-1,1,0,0,2906,267,2639,-2639
Leon Edwards,Peter Sobotta,Leon Edwards,2018-03-17,1,0,-5,5,7,2.428571,5.080002,-5.080002,0,0,-2.539993,2.539993,501,64,24,24,0,0,4.57142853736877,-4.57142853736877,3,2,0,1,1,-1,-1,1,364,293,71,-71
Alex Oliveira,Peter Sobotta,Alex Oliveira,2020-07-25,1,0,-1,1,1.833333,2.428571,-2.540009,2.540009,0,0,2.539993,-2.539993,26,47,34,24,10,-10,-0.595238089561462,0.595238089561462,0,0,0,2,0,0,-2,2,455,861,-406,406
Teruto Ishihara,Petr Yan,Petr Yan,2018-06-23,0,1,1,-1,1.428571,3.2,0,0,0,0,5.080002,-5.080002,18,4,17,21,-4,4,-1.77142858505249,1.77142858505249,0,0,0,0,0,0,0,0,133,0,133,-133
Jin Soo Son,Petr Yan,Petr Yan,2018-09-15,0,1,0,0,2.25,3.2,-2.539993,2.539993,0,0,5.080002,-5.080002,155,13,13,21,-8,8,-0.950000047683716,0.950000047683716,0,1,0,0,-1,1,0,0,0,84,-84,84
Douglas Silva de Andrade,Petr Yan,Petr Yan,2018-12-29,0,1,8,-8,5.8,3.2,0,0,0,0,2.540009,-2.540009,0,217,34,21,13,-13,2.60000014305115,-2.60000014305115,1,2,0,0,-1,1,0,0,329,105,224,-224
John Dodson,Petr Yan,Petr Yan,2019-02-23,0,1,8,-8,1.833333,3.2,-10.15999,10.15999,0,0,-2.539993,2.539993,37,89,34,21,13,-13,-1.36666667461395,1.36666667461395,0,3,0,0,-3,3,0,0,168,56,112,-112
Jimmie Rivera,Petr Yan,Petr Yan,2019-06-08,0,1,3,-3,4.6,3.2,-7.619995,7.619995,0,0,2.540009,-2.540009,39,39,28,21,7,-7,1.39999985694885,-1.39999985694885,0,4,0,0,-4,4,0,0,111,105,6,-6
Urijah Faber,Petr Yan,Petr Yan,2019-12-14,0,1,14,-14,3.181818,3.2,-2.539993,2.539993,0,0,0,0,16,86,46,21,25,-25,-1.81818008422852e-02,1.81818008422852e-02,2,5,0,0,-3,3,0,0,154,189,-35,35
Jose Aldo,Petr Yan,Petr Yan,2020-07-11,0,1,6,-6,3.875,3.2,0,0,0,0,7.62001,-7.62001,0,290,39,21,18,-18,0.674999952316284,-0.674999952316284,0,6,3,0,-6,6,3,-3,210,210,0,0
Aljamain Sterling,Petr Yan,Aljamain Sterling,2021-03-06,1,0,3,-3,5.75,3.2,0,0,0,0,10.16,-10.16,205,252,27,21,6,-6,2.54999995231628,-2.54999995231628,1,7,0,0,-6,6,0,0,2425,238,2187,-2187
Cory Sandhagen,Petr Yan,Petr Yan,2021-10-30,0,1,1,-1,4.25,3.2,10.16,-10.16,0,0,7.62001,-7.62001,20,69,21,21,0,0,1.04999995231628,-1.04999995231628,0,0,0,0,0,0,0,0,511,238,273,-273
Aljamain Sterling,Petr Yan,Aljamain Sterling,2022-04-09,1,0,3,-3,5.75,3.2,0,0,0,0,10.16,-10.16,511,352,27,21,6,-6,2.54999995231628,-2.54999995231628,2,1,0,0,1,-1,0,0,399,161,238,-238
"Sean O'Malley",Petr Yan,"Sean O'Malley",2022-10-22,1,0,-2,2,17,3.2,10.16,-10.16,0,0,12.70001,-12.70001,2,344,18,21,-3,3,13.7999999523163,-13.7999999523163,1,0,1,0,1,-1,1,-1,315,196,119,-119
Merab Dvalishvili,Petr Yan,Merab Dvalishvili,2023-03-11,1,0,2,-2,4,3.2,-2.539993,2.539993,0,0,2.540009,-2.540009,413,110,20,21,-1,1,0.799999952316284,-0.799999952316284,6,0,0,0,6,-6,0,0,532,140,392,-392
Tim Boetsch,Phil Davis,Phil Davis,2010-11-20,0,1,3,-3,1.615385,4.25,-5.080002,5.080002,-20,20,-12.7,12.7,7,286,34,21,13,-13,-2.63461542129517,2.63461542129517,1,0,1,0,1,-1,1,-1,105,0,105,-105
Ryan Bader,Phil Davis,Ryan Bader,2015-01-24,1,0,1,-1,4.6,4.25,0,0,0,0,-12.7,12.7,45,89,28,21,7,-7,0.349999904632568,-0.349999904632568,3,1,2,0,2,-2,2,-2,161,1526,-1365,1365
Ulysses Gomez,Phil Harris,Phil Harris,2013-02-16,0,1,0,0,1.8,1.833333,5.080002,-5.080002,0,0,4.899994,-4.899994,8,9,14,34,-20,20,-3.3333420753479e-02,3.3333420753479e-02,0,0,1,0,0,0,1,-1,196,0,196,-196
Kyle Daukaus,Phil Hawes,Phil Hawes,2021-05-08,0,1,-4,4,2.75,2.4,7.619995,-7.619995,0,0,-2.540009,2.540009,253,334,15,17,-2,2,0.349999904632568,-0.349999904632568,1,0,0,0,1,-1,0,0,168,0,168,-168
Chris Curtis,Phil Hawes,Chris Curtis,2021-11-06,1,0,2,-2,3,2.4,-5.080002,5.080002,0,0,-5.080002,5.080002,3,0,40,17,23,-23,0.599999904632568,-0.599999904632568,0,1,0,0,-1,1,0,0,0,182,-182,182
Roman Dolidze,Phil Hawes,Roman Dolidze,2022-10-29,1,0,1,-1,6,2.4,5.080002,-5.080002,0,0,-2.540009,2.540009,2,46,14,17,-3,3,3.59999990463257,-3.59999990463257,1,0,0,1,1,-1,-1,1,511,357,154,-154
Ikram Aliskerov,Phil Hawes,Ikram Aliskerov,2023-05-06,1,0,-4,4,14,2.4,0,0,0,0,-2.540009,2.540009,0,0,15,17,-2,2,11.5999999046326,-11.5999999046326,0,0,0,2,0,0,-2,2,0,189,-189,189
Fabiano Iha,Phil Johns,Fabiano Iha,2001-02-23,1,0,-2,2,1.8,2.142857,15.24001,-15.24001,-15,15,3,-3,51,16,14,44,-30,30,-0.342857122421265,0.342857122421265,1,0,0,0,1,-1,0,0,69,0,69,-69
Gabe Green,Phil Rowe,Gabe Green,2021-02-13,1,0,-3,3,2.2,2.5,-12.7,12.7,0,0,-17.78,17.78,193,343,16,14,2,-2,-0.299999952316284,0.299999952316284,0,0,0,0,0,0,0,0,259,0,259,-259
Orion Cosce,Phil Rowe,Phil Rowe,2021-07-31,0,1,-4,4,4,2.5,-10.16,10.16,0,0,-22.86,22.86,394,12,10,14,-4,4,1.5,-1.5,0,0,0,0,0,0,0,0,0,168,-168,168
Niko Price,Phil Rowe,Phil Rowe,2022-12-03,0,1,1,-1,2.142857,2.5,-7.619995,7.619995,0,0,-10.16,10.16,89,89,22,14,8,-8,-0.357142925262451,0.357142925262451,1,1,1,0,0,0,1,-1,1148,490,658,-658
Neil Magny,Phil Rowe,Neil Magny,2023-06-24,1,0,3,-3,2.333333,2.5,0,0,0,0,0,0,271,278,40,14,26,-26,-0.166666746139526,0.166666746139526,1,2,1,0,-1,1,1,-1,231,203,28,-28
Rob Broughton,Philip De Fries,Philip De Fries,2011-11-05,0,1,3,-3,2.285714,2,-7.619995,7.619995,15,-15,-12.7,12.7,161,659,23,18,5,-5,0.285714387893677,-0.285714387893677,0,0,0,0,0,0,0,0,42,0,42,-42
Andrei Arlovski,Philipe Lins,Andrei Arlovski,2020-05-13,1,0,7,-7,1.545455,3.4,2.539993,-2.539993,35,-35,-2.539993,2.539993,0,7,56,22,34,-34,-1.85454559326172,1.85454559326172,0,0,7,0,0,0,7,-7,193,0,193,-193
Tanner Boser,Philipe Lins,Tanner Boser,2020-06-27,1,0,-6,6,2.1,3.4,0,0,0,0,-7.619995,7.619995,1,0,31,22,9,-9,-1.30000019073486,1.30000019073486,0,0,0,0,0,0,0,0,189,45,144,-144
Maxim Grishin,Philipe Lins,Philipe Lins,2023-06-03,0,1,2,-2,3.2,3.4,2.539993,-2.539993,0,0,0,0,36,504,42,22,20,-20,-0.200000047683716,0.200000047683716,1,0,0,1,1,-1,-1,1,476,1071,-595,595
Efrain Escudero,Phillipe Nover,Efrain Escudero,2008-12-13,1,0,-2,2,2.333333,1.375,0,0,10,-10,-2.540009,2.540009,560,76,40,19,21,-21,0.958333253860474,-0.958333253860474,0,0,0,0,0,0,0,0,0,0,0,0
Kyle Bradley,Phillipe Nover,Kyle Bradley,2009-05-23,1,0,1,-1,1.583333,1.375,0,0,10,-10,-2.540009,2.540009,9,0,31,19,12,-12,0.208333373069763,-0.208333373069763,0,0,2,0,0,0,2,-2,248,161,87,-87
Rob Emerson,Phillipe Nover,Rob Emerson,2010-02-06,1,0,2,-2,1.5,1.375,0,0,10,-10,-5.080002,5.080002,548,81,30,19,11,-11,0.125,-0.125,0,0,0,1,0,0,-1,1,364,259,105,-105
Yui Chul Nam,Phillipe Nover,Phillipe Nover,2015-05-16,0,1,2,-2,2.25,1.375,0,0,0,0,-4.880005,4.880005,394,380,26,19,7,-7,0.875,-0.875,1,0,0,1,1,-1,-1,1,441,1925,-1484,1484
Renan Barao,Phillipe Nover,Renan Barao,2016-09-24,1,0,-3,3,3.777778,1.375,-7.619995,7.619995,0,0,-5.080002,5.080002,91,0,43,19,24,-24,2.40277767181396,-2.40277767181396,0,1,2,1,-1,1,1,-1,118,497,-379,379
Ricky Glenn,Phillipe Nover,Ricky Glenn,2017-02-11,1,0,-6,6,3.142857,1.375,7.62001,-7.62001,10,-10,-5.080002,5.080002,272,0,29,19,10,-10,1.76785707473755,-1.76785707473755,0,0,0,1,0,0,-1,1,0,140,-140,140
Kay Hansen,Piera Rodriguez,Piera Rodriguez,2022-04-09,0,1,-7,7,1.166667,9,-2.540009,2.540009,0,0,0,0,194,313,13,10,3,-3,-7.83333337306976,7.83333337306976,0,0,0,0,0,0,0,0,77,0,77,-77
Sam Hughes,Piera Rodriguez,Piera Rodriguez,2022-10-15,0,1,1,-1,1.6,9,5.080002,-5.080002,0,0,2.539993,-2.539993,30,116,13,10,3,-3,-7.39999997615814,7.39999997615814,2,1,1,0,1,-1,1,-1,147,189,-42,42
Gillian Robertson,Piera Rodriguez,Gillian Robertson,2023-04-15,1,0,-3,3,1.5,9,5.080002,-5.080002,0,0,0,0,383,54,20,10,10,-10,-7.5,7.5,0,2,0,0,-2,2,0,0,847,182,665,-665
Martin Day,Pingyuan Liu,Pingyuan Liu,2018-11-24,0,1,5,-5,1.333333,1.857143,10.16,-10.16,10,-10,2.539993,-2.539993,133,285,14,20,-6,6,-0.523809432983398,0.523809432983398,0,0,0,0,0,0,0,0,0,0,0,0
Kyung Ho Kang,Pingyuan Liu,Kyung Ho Kang,2019-12-21,1,0,6,-6,2.111111,1.857143,7.619995,-7.619995,0,0,2.539993,-2.539993,743,17,28,20,8,-8,0.253968358039856,-0.253968358039856,1,1,0,0,0,0,0,0,315,392,-77,77
Yves Edwards,Piotr Hallmann,Piotr Hallmann,2014-06-07,0,1,11,-11,1.909091,3,0,0,0,0,5.080002,-5.080002,43,330,64,24,40,-40,-1.09090912342072,1.09090912342072,0,0,2,0,0,0,2,-2,490,0,490,-490
Maia Stevenson,Polyana Viana,Polyana Viana,2018-02-03,0,1,10,-10,1.2,2.166667,-2.540009,2.540009,0,0,-12.7,12.7,89,106,11,19,-8,8,-0.966666698455811,0.966666698455811,0,0,0,0,0,0,0,0,0,0,0,0
JJ Aldrich,Polyana Viana,JJ Aldrich,2018-08-04,1,0,-1,1,2,2.166667,0,0,10,-10,0,0,357,62,18,19,-1,1,-0.166666746139526,0.166666746139526,2,1,0,0,1,-1,0,0,202,182,20,-20
Hannah Cifers,Polyana Viana,Hannah Cifers,2019-03-02,1,0,0,0,1.428571,2.166667,-10.16,10.16,0,0,-12.7,12.7,278,0,17,19,-2,2,-0.738095283508301,0.738095283508301,0,0,0,0,0,0,0,0,0,210,-210,210
Veronica Hardy,Polyana Viana,Veronica Hardy,2019-08-10,1,0,-4,4,1.75,2.166667,-2.540009,2.540009,10,-10,-7.619995,7.619995,4,43,11,19,-8,8,-0.416666746139526,0.416666746139526,0,0,0,0,0,0,0,0,168,161,7,-7
Mallory Martin,Polyana Viana,Polyana Viana,2021-02-13,0,1,-1,1,1.4,2.166667,-2.540009,2.540009,0,0,-10.15999,10.15999,145,18,12,19,-7,7,-0.766666769981384,0.766666769981384,0,0,0,0,0,0,0,0,0,553,-553,553
Tabatha Ricci,Polyana Viana,Tabatha Ricci,2022-05-21,1,0,-2,2,9,2.166667,-10.16,10.16,0,0,-15.23999,15.23999,571,9,10,19,-9,9,6.83333325386047,-6.83333325386047,0,1,0,0,-1,1,0,0,0,462,-462,462
Iasmin Lucindo,Polyana Viana,Iasmin Lucindo,2023-08-12,1,0,-10,10,3,2.166667,-5.080002,5.080002,0,0,-2.539993,2.539993,193,118,20,19,1,-1,0.833333253860474,-0.833333253860474,1,0,0,0,1,-1,0,0,112,448,-336,336
Evan Elder,Preston Parsons,Preston Parsons,2022-04-23,0,1,-1,1,4,2.5,-2.539993,2.539993,-15,15,2.540009,-2.540009,107,468,10,14,-4,4,1.5,-1.5,0,0,0,0,0,0,0,0,0,0,0,0
Trevin Giles,Preston Parsons,Trevin Giles,2023-03-25,1,0,3,-3,3.2,2.5,2.540009,-2.540009,0,0,7.62001,-7.62001,254,316,21,14,7,-7,0.700000047683716,-0.700000047683716,0,1,1,0,-1,1,1,-1,427,336,91,-91
Oskar Piechota,Punahele Soriano,Punahele Soriano,2019-12-14,0,1,2,-2,3.666667,3,2.540009,-2.540009,0,0,10.15999,-10.15999,18,74,14,12,2,-2,0.666666746139526,-0.666666746139526,0,0,0,0,0,0,0,0,126,0,126,-126
Brendan Allen,Punahele Soriano,Brendan Allen,2021-07-24,1,0,-3,3,4.4,3,7.62001,-7.62001,0,0,7.619995,-7.619995,0,21,27,12,15,-15,1.40000009536743,-1.40000009536743,1,1,1,0,0,0,1,-1,91,588,-497,497
Nick Maximov,Punahele Soriano,Nick Maximov,2022-02-05,1,0,-5,5,4,3,2.540009,-2.540009,0,0,10.15999,-10.15999,525,97,10,12,-2,2,1,-1,0,0,0,0,0,0,0,0,0,196,-196,196
Dalcha Lungiambula,Punahele Soriano,Punahele Soriano,2022-07-16,0,1,5,-5,1.833333,3,-7.619995,7.619995,0,0,10.15999,-10.15999,99,4,17,12,5,-5,-1.16666662693024,1.16666662693024,2,0,0,0,2,-2,0,0,542,161,381,-381
Roman Kopylov,Punahele Soriano,Roman Kopylov,2023-01-14,1,0,1,-1,6,3,2.540009,-2.540009,0,0,7.619995,-7.619995,10,6,14,12,2,-2,3,-3,0,1,0,0,-1,1,0,0,1162,182,980,-980
Katsunori Kikuno,Quinn Mulhern,Katsunori Kikuno,2014-01-04,1,0,3,-3,3,4.5,-17.78,17.78,-10,10,-28.36,28.36,501,1,32,22,10,-10,-1.5,1.5,0,0,0,0,0,0,0,0,0,0,0,0
Marvin Eastman,Quinton Jackson,Quinton Jackson,2007-02-03,0,1,7,-7,1.2,3.083333,-10.16,10.16,-20,20,0,0,31,61,33,49,-16,16,-1.88333320617676,1.88333320617676,0,0,1,0,0,0,1,-1,834,0,834,-834
Dan Henderson,Quinton Jackson,Quinton Jackson,2007-09-08,0,1,8,-8,2.133333,3.083333,-5.080002,5.080002,-20,20,2.540009,-2.540009,548,580,47,49,-2,2,-0.949999809265137,0.949999809265137,1,1,0,0,0,0,0,0,3403,217,3186,-3186
Forrest Griffin,Quinton Jackson,Forrest Griffin,2008-07-05,1,0,-1,1,2.714286,3.083333,5.080002,-5.080002,0,0,10.16,-10.16,287,190,26,49,-23,23,-0.36904764175415,0.36904764175415,2,2,1,0,0,0,1,-1,287,301,-14,14
Rashad Evans,Quinton Jackson,Rashad Evans,2010-05-29,1,0,-1,1,2.375,3.083333,-2.539993,2.539993,0,0,5.080002,-5.080002,462,56,27,49,-22,22,-0.708333253860474,0.708333253860474,1,0,1,0,1,-1,1,-1,147,693,-546,546
Matt Hamill,Quinton Jackson,Quinton Jackson,2011-05-28,0,1,2,-2,1.5,3.083333,0,0,0,0,7.619995,-7.619995,75,62,20,49,-29,29,-1.58333325386047,1.58333325386047,6,0,0,0,6,-6,0,0,217,364,-147,147
Ryan Bader,Quinton Jackson,Ryan Bader,2012-02-25,1,0,-5,5,4.6,3.083333,2.540009,-2.540009,0,0,2.540009,-2.540009,527,21,28,49,-21,21,1.51666665077209,-1.51666665077209,1,1,0,0,0,0,0,0,98,273,-175,175
Karine Gevorgyan,Rachael Ostovich,Rachael Ostovich,2017-12-01,0,1,2,-2,1,0.6666667,2.539993,-2.539993,0,0,2.540009,-2.540009,22,36,6,10,-4,4,0.333333313465118,-0.333333313465118,0,0,0,0,0,0,0,0,0,0,0,0
Montana De La Rosa,Rachael Ostovich,Montana De La Rosa,2018-07-06,1,0,-4,4,1.5,0.6666667,10.15999,-10.15999,0,0,15.24001,-15.24001,254,2,20,10,10,-10,0.833333313465118,-0.833333313465118,1,1,0,0,0,0,0,0,217,217,0,0
Gina Mazany,Rachael Ostovich,Gina Mazany,2020-11-28,1,0,3,-3,1.166667,0.6666667,7.619995,-7.619995,0,0,15.24001,-15.24001,413,11,13,10,3,-3,0.499999940395355,-0.499999940395355,1,0,0,0,1,-1,0,0,1099,876,223,-223
Nurullo Aliev,Rafael Alves,Nurullo Aliev,2023-02-25,1,0,-10,10,9,1.666667,5.080002,-5.080002,0,0,10.16,-10.16,651,78,9,32,-23,23,7.33333337306976,-7.33333337306976,0,0,0,0,0,0,0,0,0,0,0,0
Matt Andersen,Rafael Carino,Rafael Carino,1996-05-17,0,1,,,1.75,2,-15.23999,15.23999,-15,15,-14.28,14.28,0,0,22,3,19,-19,-0.25,0.25,0,0,0,0,0,0,0,0,0,0,0,0
Ryan Bader,Rafael Cavalcante,Ryan Bader,2014-06-14,1,0,-3,3,4.6,1.714286,2.540009,-2.540009,0,0,0,0,500,31,28,19,9,-9,2.88571417331696,-2.88571417331696,1,0,2,0,1,-1,2,-2,190,0,190,-190
Kyle Bradley,Rafael Dos Anjos,Rafael Dos Anjos,2010-01-11,0,1,2,-2,1.583333,2.133333,2.539993,-2.539993,-15,15,2.539993,-2.539993,24,497,31,47,-16,16,-0.550000071525574,0.550000071525574,1,0,2,0,1,-1,2,-2,233,0,233,-233
Mark Bocek,Rafael Dos Anjos,Rafael Dos Anjos,2012-11-17,0,1,3,-3,2.4,2.133333,0,0,-15,15,12.7,-12.7,222,249,17,47,-30,30,0.266666650772095,-0.266666650772095,1,1,1,0,0,0,1,-1,343,1041,-698,698
Donald Cerrone,Rafael Dos Anjos,Rafael Dos Anjos,2013-08-28,0,1,2,-2,2.117647,2.133333,12.7,-12.7,-15,15,7.619995,-7.619995,60,230,53,47,6,-6,-1.56862735748291e-02,1.56862735748291e-02,1,2,1,0,-1,1,1,-1,95,284,-189,189
Nate Diaz,Rafael Dos Anjos,Rafael Dos Anjos,2014-12-13,0,1,-1,1,1.692308,2.133333,10.16,-10.16,0,0,15.23999,-15.23999,0,468,35,47,-12,12,-0.441025733947754,0.441025733947754,1,3,1,0,-2,2,1,-1,378,472,-94,94
Donald Cerrone,Rafael Dos Anjos,Rafael Dos Anjos,2015-12-19,0,1,1,-1,2.117647,2.133333,12.7,-12.7,-15,15,7.619995,-7.619995,0,9,53,47,6,-6,-1.56862735748291e-02,1.56862735748291e-02,6,4,1,0,2,-2,1,-1,210,371,-161,161
Eddie Alvarez,Rafael Dos Anjos,Eddie Alvarez,2016-07-07,1,0,1,-1,4.833333,2.133333,2.539993,-2.539993,-15,15,-2.540009,2.540009,20,22,35,47,-12,12,2.70000004768372,-2.70000004768372,2,5,0,0,-3,3,0,0,172,201,-29,29
Colby Covington,Rafael Dos Anjos,Colby Covington,2018-06-09,1,0,-3,3,5.666667,2.133333,7.619995,-7.619995,0,0,5.080002,-5.080002,757,134,20,47,-27,27,3.53333306312561,-3.53333306312561,7,0,0,1,7,-7,-1,1,224,702,-478,478
Michael Chiesa,Rafael Dos Anjos,Michael Chiesa,2020-01-25,1,0,-3,3,2.571429,2.133333,12.7,-12.7,0,0,12.7,-12.7,613,41,25,47,-22,22,0.438095092773438,-0.438095092773438,2,0,1,1,2,-2,0,0,203,595,-392,392
Bryan Barberena,Rafael Dos Anjos,Rafael Dos Anjos,2022-12-03,0,1,-5,5,1.636364,2.133333,10.16,-10.16,0,0,5.080002,-5.080002,35,396,29,47,-18,18,-0.496969819068909,0.496969819068909,3,0,2,1,3,-3,1,-1,154,1043,-889,889
Marc Diakiese,Rafael Fiziev,Rafael Fiziev,2020-07-18,0,1,0,0,2.285714,4,5.080002,-5.080002,0,0,5.080002,-5.080002,22,169,23,15,8,-8,-1.71428561210632,1.71428561210632,2,0,0,0,2,-2,0,0,294,0,294,-294
Rafael Dos Anjos,Rafael Fiziev,Rafael Fiziev,2022-07-09,0,1,8,-8,2.133333,4,0,0,15,-15,-2.539993,2.539993,373,179,47,15,32,-32,-1.86666655540466,1.86666655540466,2,1,1,0,1,-1,1,-1,126,721,-595,595
Rich Attonito,Rafael Natal,Rich Attonito,2010-09-15,1,0,6,-6,2,2.333333,-5.080002,5.080002,-15,15,-12.7,12.7,195,96,15,30,-15,15,-0.333333253860474,0.333333253860474,1,0,0,0,1,-1,0,0,88,0,88,-88
Paul Bradley,Rafael Natal,Rafael Natal,2011-08-06,0,1,0,0,2.875,2.333333,-7.62001,7.62001,-15,15,-17.58,17.58,155,4,31,30,1,-1,0.541666746139526,-0.541666746139526,0,0,0,0,0,0,0,0,0,325,-325,325
Michael Kuiper,Rafael Natal,Rafael Natal,2012-02-04,0,1,-7,7,3,2.333333,0,0,0,0,-10.16,10.16,223,384,20,30,-10,10,0.666666746139526,-0.666666746139526,0,1,0,0,-1,1,0,0,0,182,-182,182
Andrew Craig,Rafael Natal,Andrew Craig,2012-07-11,1,0,-3,3,2.25,2.333333,2.539993,-2.539993,-15,15,-2.540009,2.540009,50,90,13,30,-17,17,-8.33332538604736e-02,8.33332538604736e-02,1,2,0,0,-1,1,0,0,131,158,-27,27
Tim Kennedy,Rafael Natal,Tim Kennedy,2013-11-06,1,0,4,-4,3,2.333333,-2.540009,2.540009,0,0,-7.619995,7.619995,2,0,24,30,-6,6,0.666666746139526,-0.666666746139526,0,0,0,1,0,0,-1,1,0,483,-483,483
Ed Herman,Rafael Natal,Ed Herman,2014-05-10,1,0,2,-2,1.6875,2.333333,2.539993,-2.539993,20,-20,0,0,178,286,43,30,13,-13,-0.645833253860474,0.645833253860474,0,0,1,2,0,0,-1,1,175,185,-10,10
Chris Camozzi,Rafael Natal,Rafael Natal,2014-09-05,0,1,-4,4,1.846154,2.333333,5.080002,-5.080002,0,0,-5.080002,5.080002,165,164,37,30,7,-7,-0.487179398536682,0.487179398536682,0,0,0,2,0,0,-2,2,62,118,-56,56
Uriah Hall,Rafael Natal,Rafael Natal,2015-05-23,0,1,-2,2,1.636364,2.333333,0,0,0,0,5.080002,-5.080002,52,175,29,30,-1,1,-0.696969628334045,0.696969628334045,3,1,0,2,2,-2,-2,2,125,260,-135,135
Kevin Casey,Rafael Natal,Rafael Natal,2016-01-30,0,1,1,-1,1.8,2.333333,-2.540009,2.540009,0,0,0,0,130,332,14,30,-16,16,-0.533333301544189,0.533333301544189,0,2,1,2,-2,2,-1,1,1022,252,770,-770
Tim Boetsch,Rafael Natal,Tim Boetsch,2016-11-12,1,0,2,-2,1.615385,2.333333,0,0,0,0,-7.619995,7.619995,4,0,34,30,4,-4,-0.71794867515564,0.71794867515564,1,3,4,2,-2,2,2,-2,122,287,-165,165
Eryk Anders,Rafael Natal,Eryk Anders,2017-07-22,1,0,-4,4,1.875,2.333333,2.539993,-2.539993,0,0,-5.080002,5.080002,46,0,23,30,-7,7,-0.458333253860474,0.458333253860474,0,0,0,3,0,0,-3,3,0,252,-252,252
Nik Lentz,Rafaello Oliveira,Nik Lentz,2009-09-19,1,0,-2,2,2.5,2.125,0,0,-10,10,-7.619995,7.619995,198,339,42,25,17,-17,0.375,-0.375,0,0,0,0,0,0,0,0,0,0,0,0
John Gunderson,Rafaello Oliveira,Rafaello Oliveira,2010-01-02,0,1,3,-3,2.1875,2.125,2.539993,-2.539993,0,0,-5.080002,5.080002,22,682,51,25,26,-26,0.0625,-0.0625,0,0,0,0,0,0,0,0,0,105,-105,105
Yves Edwards,Rafaello Oliveira,Yves Edwards,2011-10-01,1,0,6,-6,1.909091,2.125,2.539993,-2.539993,0,0,5.080002,-5.080002,35,43,64,25,39,-39,-0.215909123420715,0.215909123420715,0,1,2,0,-1,1,2,-2,112,637,-525,525
Yoislandy Izquierdo,Rafaello Oliveira,Rafaello Oliveira,2012-07-07,0,1,-2,2,2.5,2.125,7.619995,-7.619995,0,0,2.660004,-2.660004,0,661,14,25,-11,11,0.375,-0.375,0,0,0,1,0,0,-1,1,84,280,-196,196
Edson Barboza,Rafaello Oliveira,Edson Barboza,2013-07-06,1,0,-4,4,2.090909,2.125,7.619995,-7.619995,-10,10,10.16,-10.16,13,2,34,25,9,-9,-3.40909957885742e-02,3.40909957885742e-02,1,1,1,1,0,0,0,0,168,364,-196,196
Erik Koch,Rafaello Oliveira,Erik Koch,2014-02-22,1,0,-7,7,2.666667,2.125,5.080002,-5.080002,15,-15,0,0,24,0,22,25,-3,3,0.541666746139526,-0.541666746139526,0,0,1,2,0,0,-1,1,175,231,-56,56
Jerry Bohlander,Rainy Martinez,Jerry Bohlander,1997-02-07,1,0,,,2.75,0,-2.540009,2.540009,0,0,0,0,0,0,15,2,13,-13,2.75,-2.75,1,0,1,0,1,-1,1,-1,0,0,0,0
Sam Alvey,Ramazan Emeev,Ramazan Emeev,2017-10-21,0,1,1,-1,1.833333,3.333333,10.16,-10.16,15,-15,-2.539993,2.539993,2,252,51,26,25,-25,-1.49999988079071,1.49999988079071,1,0,1,0,1,-1,1,-1,77,0,77,-77
Jack Della Maddalena,Ramazan Emeev,Jack Della Maddalena,2022-06-11,1,0,-10,10,8,3.333333,2.539993,-2.539993,0,0,-7.619995,7.619995,3,25,18,26,-8,8,4.66666674613953,-4.66666674613953,1,1,0,0,0,0,0,0,140,1694,-1554,1554
Lyoto Machida,Rameau Thierry Sokoudjou,Lyoto Machida,2007-12-29,1,0,6,-6,3,1,7.619995,-7.619995,-20,20,-10.15999,10.15999,334,22,32,36,-4,4,2,-2,1,0,0,0,1,-1,0,0,98,0,98,-98
Kazuhiro Nakamura,Rameau Thierry Sokoudjou,Rameau Thierry Sokoudjou,2008-05-24,0,1,4,-4,1.615385,1,2.539993,-2.539993,0,0,-20.31999,20.31999,0,3,34,36,-2,2,0.615384578704834,-0.615384578704834,0,0,0,0,0,0,0,0,0,147,-147,147
Luiz Cane,Rameau Thierry Sokoudjou,Luiz Cane,2008-10-18,1,0,3,-3,2.428571,1,10.16,-10.16,-20,20,-2.539993,2.539993,13,0,24,36,-12,12,1.42857146263123,-1.42857146263123,1,1,0,0,0,0,0,0,133,147,-14,14
Josiane Nunes,Ramona Pascual,Josiane Nunes,2022-02-26,1,0,-5,5,10,1.2,-12.7,12.7,10,-10,2.539993,-2.539993,43,221,11,11,0,0,8.79999995231628,-8.79999995231628,0,0,0,0,0,0,0,0,0,0,0,0
Joselyne Edwards,Ramona Pascual,Joselyne Edwards,2022-06-11,1,0,-7,7,2.6,1.2,2.540009,-2.540009,0,0,10.16,-10.16,52,62,18,11,7,-7,1.39999985694885,-1.39999985694885,0,0,0,0,0,0,0,0,490,105,385,-385
Tony Ferguson,Ramsey Nijem,Tony Ferguson,2011-06-04,1,0,4,-4,2.888889,1.5,0,0,0,0,2.539993,-2.539993,74,0,35,15,20,-20,1.38888883590698,-1.38888883590698,0,0,0,0,0,0,0,0,0,0,0,0
Danny Downes,Ramsey Nijem,Ramsey Nijem,2011-10-29,0,1,2,-2,2.666667,1.5,2.540009,-2.540009,0,0,-7.619995,7.619995,31,764,11,15,-4,4,1.16666674613953,-1.16666674613953,0,0,0,1,0,0,-1,1,147,147,0,0
CJ Keith,Ramsey Nijem,Ramsey Nijem,2012-06-22,0,1,1,-1,2,1.5,2.540009,-2.540009,0,0,-12.5,12.5,24,64,12,15,-3,3,0.5,-0.5,0,1,0,1,-1,1,-1,1,0,237,-237,237
Myles Jury,Ramsey Nijem,Myles Jury,2013-04-20,1,0,-1,1,4.25,1.5,-2.539993,2.539993,-10,10,-5.080002,5.080002,137,139,21,15,6,-6,2.75,-2.75,1,2,0,1,-1,1,-1,1,323,302,21,-21
Justin Edwards,Ramsey Nijem,Ramsey Nijem,2014-01-15,0,1,5,-5,1.8,1.5,-2.539993,2.539993,0,0,-12.7,12.7,6,285,14,15,-1,1,0.299999952316284,-0.299999952316284,0,0,1,2,0,0,-1,1,140,270,-130,130
Beneil Dariush,Ramsey Nijem,Ramsey Nijem,2014-04-11,0,1,-2,2,4.4,1.5,-2.539993,2.539993,0,0,-7.619995,7.619995,30,98,27,15,12,-12,2.90000009536743,-2.90000009536743,0,1,0,2,-1,1,-2,2,0,86,-86,86
Diego Ferreira,Ramsey Nijem,Diego Ferreira,2014-08-30,1,0,3,-3,3.6,1.5,-5.080002,5.080002,0,0,-2.539993,2.539993,47,101,23,15,8,-8,2.09999990463257,-2.09999990463257,1,2,0,2,-1,1,-2,2,63,141,-78,78
Andrew Holbrook,Ramsey Nijem,Andrew Holbrook,2015-07-25,1,0,2,-2,4,1.5,0,0,0,0,-12.7,12.7,203,518,15,15,0,0,2.5,-2.5,0,0,0,3,0,0,-3,3,0,329,-329,329
Aisling Daly,Randa Markos,Randa Markos,2015-04-25,0,1,-2,2,2.666667,0.9166667,-5.080002,5.080002,0,0,2.539993,-2.539993,413,331,22,23,-1,1,1.75000005960464,-1.75000005960464,0,0,0,0,0,0,0,0,0,0,0,0
Karolina Kowalkiewicz,Randa Markos,Karolina Kowalkiewicz,2015-12-19,1,0,0,0,2.142857,0.9166667,-2.539993,2.539993,0,0,2.539993,-2.539993,89,319,22,23,-1,1,1.22619038820267,-1.22619038820267,0,1,0,0,-1,1,0,0,0,238,-238,238
Jocelyn Jones-Lybarger,Randa Markos,Randa Markos,2016-06-18,0,1,0,0,1.5,0.9166667,7.619995,-7.619995,0,0,2.539993,-2.539993,110,119,10,23,-13,13,0.583333313465118,-0.583333313465118,0,0,0,0,0,0,0,0,189,182,7,-7
Cortney Casey,Randa Markos,Cortney Casey,2016-08-20,1,0,-2,2,1,0.9166667,7.619995,-7.619995,10,-10,10.15999,-10.15999,84,112,20,23,-3,3,8.33333134651184e-02,-8.33333134651184e-02,1,1,0,0,0,0,0,0,38,63,-25,25
Carla Esparza,Randa Markos,Randa Markos,2017-02-19,0,1,-2,2,2.857143,0.9166667,-7.619995,7.619995,0,0,0,0,166,18,27,23,4,-4,1.94047623872757,-1.94047623872757,1,0,1,0,1,-1,1,-1,302,183,119,-119
Alexa Grasso,Randa Markos,Alexa Grasso,2017-08-05,1,0,-8,8,5.333333,0.9166667,2.540009,-2.540009,10,-10,7.619995,-7.619995,130,239,19,23,-4,4,4.41666680574417,-4.41666680574417,0,1,0,0,-1,1,0,0,182,167,15,-15
Juliana Lima,Randa Markos,Randa Markos,2018-01-27,0,1,3,-3,1.8,0.9166667,2.540009,-2.540009,0,0,5.080002,-5.080002,190,552,14,23,-9,9,0.883333265781403,-0.883333265781403,0,0,0,0,0,0,0,0,204,175,29,-29
Angela Hill,Randa Markos,Randa Markos,2019-03-23,0,1,1,-1,1.153846,0.9166667,-2.539993,2.539993,0,0,2.539993,-2.539993,42,172,28,23,5,-5,0.237179458141327,-0.237179458141327,1,1,0,0,0,0,0,0,392,420,-28,28
Claudia Gadelha,Randa Markos,Claudia Gadelha,2019-07-06,1,0,-3,3,3.6,0.9166667,0,0,0,0,0,0,7,0,23,23,0,0,2.68333321809769,-2.68333321809769,0,2,0,0,-2,2,0,0,210,105,105,-105
Mackenzie Dern,Randa Markos,Mackenzie Dern,2020-09-19,1,0,-8,8,4.333333,0.9166667,0,0,0,0,0,0,105,96,16,23,-7,7,3.41666680574417,-3.41666680574417,0,0,0,0,0,0,0,0,343,441,-98,98
Bryan Barberena,Randy Brown,Randy Brown,2019-06-22,0,1,2,-2,1.636364,3.4,-7.619995,7.619995,0,0,-15.23999,15.23999,59,158,29,22,7,-7,-1.763636469841,1.763636469841,0,0,1,0,0,0,1,-1,125,0,125,-125
Warlley Alves,Randy Brown,Randy Brown,2019-11-16,0,1,-1,1,2.5,3.4,-10.16,10.16,0,0,-15.23999,15.23999,258,72,21,22,-1,1,-0.900000095367432,0.900000095367432,1,1,1,0,0,0,1,-1,189,147,42,-42
Guido Cannetti,Randy Costa,Guido Cannetti,2022-10-01,1,0,14,-14,1.25,1.5,-7.619995,7.619995,0,0,-12.7,12.7,9,0,18,10,8,-8,-0.25,0.25,1,0,1,0,1,-1,1,-1,203,0,203,-203
Vitor Belfort,Randy Couture,Randy Couture,1997-10-17,0,1,-14,14,1.857143,1.727273,-2.539993,2.539993,-20,20,-2.539993,2.539993,0,0,40,30,10,-10,0.129870057106018,-0.129870057106018,2,0,0,0,2,-2,0,0,252,0,252,-252
Josh Barnett,Randy Couture,Josh Barnett,2002-03-22,1,0,-14,14,4.375,1.727273,5.080002,-5.080002,45,-45,7.619995,-7.619995,115,438,43,30,13,-13,2.64772725105286,-2.64772725105286,2,1,1,0,1,-1,1,-1,140,1617,-1477,1477
Vitor Belfort,Randy Couture,Vitor Belfort,2004-01-31,1,0,-14,14,1.857143,1.727273,-2.539993,2.539993,-20,20,-2.539993,2.539993,27,0,40,30,10,-10,0.129870057106018,-0.129870057106018,1,0,1,1,1,-1,0,0,239,680,-441,441
Vitor Belfort,Randy Couture,Randy Couture,2004-08-21,0,1,-14,14,1.857143,1.727273,-2.539993,2.539993,-20,20,-2.539993,2.539993,1,846,40,30,10,-10,0.129870057106018,-0.129870057106018,2,0,1,2,2,-2,-1,1,203,203,0,0
Mark Coleman,Randy Couture,Randy Couture,2010-02-06,0,1,-1,1,1.6,1.727273,0,0,0,0,0,0,0,217,26,30,-4,4,-0.127272725105286,0.127272725105286,0,1,2,2,-1,1,0,0,385,1995,-1610,1610
Mike Brown,Rani Yahya,Rani Yahya,2011-01-22,0,1,9,-9,2.888889,2.545455,0,0,10,-10,7.62001,-7.62001,217,464,35,39,-4,4,0.34343433380127,-0.34343433380127,0,0,0,0,0,0,0,0,21,0,21,-21
Chad Mendes,Rani Yahya,Chad Mendes,2011-08-06,1,0,0,0,3.6,2.545455,0,0,10,-10,-2.539993,2.539993,284,0,23,39,-16,16,1.05454540252686,-1.05454540252686,1,1,0,0,0,0,0,0,182,196,-14,14
Josh Grispi,Rani Yahya,Rani Yahya,2012-08-04,0,1,-4,4,2.8,2.545455,12.7,-12.7,10,-10,17.78001,-17.78001,6,148,19,39,-20,20,0.254545450210571,-0.254545450210571,0,0,1,0,0,0,1,-1,427,364,63,-63
Mizuto Hirota,Rani Yahya,Rani Yahya,2013-03-02,0,1,3,-3,1.8,2.545455,2.539993,-2.539993,20,-20,0,0,189,539,28,39,-11,11,-0.745454549789429,0.745454549789429,0,1,0,0,-1,1,0,0,0,210,-210,210
Josh Clopton,Rani Yahya,Rani Yahya,2013-08-03,0,1,4,-4,3,2.545455,0,0,10,-10,-2.179993,2.179993,199,503,8,39,-31,31,0.454545497894287,-0.454545497894287,0,2,0,0,-2,2,0,0,609,154,455,-455
Tom Niinimaki,Rani Yahya,Tom Niinimaki,2013-11-30,1,0,2,-2,2.75,2.545455,7.619995,-7.619995,10,-10,5.080002,-5.080002,546,210,30,39,-9,9,0.204545497894287,-0.204545497894287,0,3,0,0,-3,3,0,0,0,119,-119,119
Johnny Bedford,Rani Yahya,Rani Yahya,2014-09-13,0,1,1,-1,1.615385,2.545455,10.16,-10.16,0,0,10.16,-10.16,275,79,34,39,-5,5,-0.930069923400879,0.930069923400879,0,0,1,0,0,0,1,-1,77,287,-210,210
Masanori Kanehara,Rani Yahya,Rani Yahya,2015-07-15,0,1,2,-2,2.166667,2.545455,2.539993,-2.539993,0,0,0,0,282,319,38,39,-1,1,-0.378787755966187,0.378787755966187,0,1,0,0,-1,1,0,0,0,305,-305,305
Matthew Lopez,Rani Yahya,Rani Yahya,2016-07-13,0,1,-2,2,2.5,2.545455,2.539993,-2.539993,0,0,5.080002,-5.080002,125,459,14,39,-25,25,-4.54545021057129e-02,4.54545021057129e-02,0,2,0,0,-2,2,0,0,0,364,-364,364
Michinori Tanaka,Rani Yahya,Rani Yahya,2016-09-24,0,1,-7,7,3.666667,2.545455,-2.539993,2.539993,0,0,0,0,354,423,14,39,-25,25,1.12121224403381,-1.12121224403381,0,3,0,0,-3,3,0,0,0,73,-73,73
Joe Soto,Rani Yahya,Joe Soto,2017-03-11,1,0,-3,3,2.571429,2.545455,0,0,0,0,-5.079987,5.079987,280,57,25,39,-14,14,2.59740352630615e-02,-2.59740352630615e-02,0,4,0,0,-4,4,0,0,434,168,266,-266
Henry Briones,Rani Yahya,Rani Yahya,2017-08-05,0,1,4,-4,2,2.545455,5.080002,-5.080002,0,0,5.080002,-5.080002,0,99,24,39,-15,15,-0.545454502105713,0.545454502105713,0,0,1,0,0,0,1,-1,273,147,126,-126
Russell Doane,Rani Yahya,Rani Yahya,2018-02-24,0,1,-2,2,1.875,2.545455,2.539993,-2.539993,0,0,7.62001,-7.62001,22,599,23,39,-16,16,-0.670454502105713,0.670454502105713,1,1,0,0,0,0,0,0,252,203,49,-49
Luke Sanders,Rani Yahya,Rani Yahya,2018-08-25,0,1,-1,1,2.6,2.545455,0,0,0,0,0,0,22,4,18,39,-21,21,5.45454025268555e-02,-5.45454025268555e-02,1,2,1,0,-1,1,1,-1,133,182,-49,49
Ricky Simon,Rani Yahya,Ricky Simon,2019-02-09,1,0,-8,8,5,2.545455,0,0,0,0,5.080002,-5.080002,230,0,24,39,-15,15,2.45454549789429,-2.45454549789429,0,3,0,0,-3,3,0,0,0,168,-168,168
Ray Rodriguez,Rani Yahya,Rani Yahya,2021-03-13,0,1,-3,3,2,2.545455,2.539993,-2.539993,0,0,7.62001,-7.62001,0,420,24,39,-15,15,-0.545454502105713,0.545454502105713,0,0,0,0,0,0,0,0,0,763,-763,763
Kyung Ho Kang,Rani Yahya,Rani Yahya,2021-11-20,0,1,-3,3,2.111111,2.545455,7.619995,-7.619995,0,0,15.24001,-15.24001,65,636,28,39,-11,11,-0.434343338012695,0.434343338012695,2,1,0,0,1,-1,0,0,700,252,448,-448
Montel Jackson,Rani Yahya,Montel Jackson,2023-04-22,1,0,-8,8,6.5,2.545455,10.16,-10.16,0,0,20.32001,-20.32001,77,8,15,39,-24,24,3.95454549789429,-3.95454549789429,1,2,0,0,-1,1,0,0,763,518,245,-245
Ciryl Gane,Raphael Pessoa,Ciryl Gane,2019-08-10,1,0,-1,1,6,5,2.539993,-2.539993,-17,17,7.62001,-7.62001,33,1,14,12,2,-2,1,-1,0,0,0,0,0,0,0,0,0,0,0,0
Jeff Hughes,Raphael Pessoa,Raphael Pessoa,2019-10-26,0,1,1,-1,2.5,5,-2.539993,2.539993,-12,12,-2.539993,2.539993,76,6,14,12,2,-2,-2.5,2.5,0,0,0,0,0,0,0,0,0,77,-77,77
Tanner Boser,Raphael Pessoa,Tanner Boser,2020-07-25,1,0,-3,3,2.1,5,-2.539993,2.539993,-57,57,-7.619995,7.619995,6,0,31,12,19,-19,-2.90000009536743,2.90000009536743,1,1,0,0,0,0,0,0,28,273,-245,245
Roxanne Modafferi,Raquel Pennington,Raquel Pennington,2013-11-30,0,1,6,-6,1.190476,1.666667,0,0,-10,10,5.080002,-5.080002,101,282,46,24,22,-22,-0.476190447807312,0.476190447807312,0,0,0,0,0,0,0,0,0,0,0,0
Jessica Andrade,Raquel Pennington,Jessica Andrade,2014-03-15,1,0,-3,3,2,1.666667,-15.23999,15.23999,-20,20,-12.7,12.7,380,80,36,24,12,-12,0.333333373069763,-0.333333373069763,1,1,1,0,0,0,1,-1,140,105,35,-35
Ashlee Evans-Smith,Raquel Pennington,Raquel Pennington,2014-12-06,0,1,1,-1,1,1.666667,2.540009,-2.540009,0,0,0,0,189,83,12,24,-12,12,-0.666666626930237,0.666666626930237,0,0,0,0,0,0,0,0,0,266,-266,266
Holly Holm,Raquel Pennington,Holly Holm,2015-02-28,1,0,7,-7,2.142857,1.666667,2.540009,-2.540009,0,0,5.080002,-5.080002,3,15,22,24,-2,2,0.476190447807312,-0.476190447807312,0,1,0,0,-1,1,0,0,0,84,-84,84
Jessica Andrade,Raquel Pennington,Raquel Pennington,2015-09-05,0,1,-4,4,2,1.666667,-15.23999,15.23999,-20,20,-12.7,12.7,208,184,36,24,12,-12,0.333333373069763,-0.333333373069763,1,0,1,0,1,-1,1,-1,52,189,-137,137
Bethe Correia,Raquel Pennington,Raquel Pennington,2016-04-16,0,1,5,-5,1.833333,1.666667,-5.079987,5.079987,0,0,-7.619995,7.619995,125,63,17,24,-7,7,0.166666746139526,-0.166666746139526,0,1,1,0,-1,1,1,-1,259,224,35,-35
Amanda Nunes,Raquel Pennington,Amanda Nunes,2018-05-12,1,0,0,0,4.6,1.666667,2.540009,-2.540009,0,0,5.080002,-5.080002,269,133,28,24,4,-4,2.93333327770233,-2.93333327770233,4,2,1,0,2,-2,1,-1,245,756,-511,511
Germaine de Randamie,Raquel Pennington,Germaine de Randamie,2018-11-10,1,0,4,-4,2.5,1.666667,5.080002,-5.080002,0,0,10.16,-10.16,66,365,14,24,-10,10,0.833333373069763,-0.833333373069763,3,0,1,1,3,-3,0,0,637,182,455,-455
Irene Aldana,Raquel Pennington,Raquel Pennington,2019-07-20,0,1,1,-1,2,1.666667,5.080002,-5.080002,0,0,2.540009,-2.540009,2,328,21,24,-3,3,0.333333373069763,-0.333333373069763,3,0,0,1,3,-3,-1,1,70,252,-182,182
Holly Holm,Raquel Pennington,Holly Holm,2020-01-18,1,0,7,-7,2.142857,1.666667,2.540009,-2.540009,0,0,5.080002,-5.080002,435,61,22,24,-2,2,0.476190447807312,-0.476190447807312,0,1,1,1,-1,1,0,0,196,182,14,-14
Pannie Kianzad,Raquel Pennington,Raquel Pennington,2021-09-18,0,1,-4,4,2.428571,1.666667,0,0,0,0,-2.539993,2.539993,334,376,24,24,0,0,0.761904835700989,-0.761904835700989,0,0,0,1,0,0,-1,1,0,609,-609,609
Macy Chiasson,Raquel Pennington,Raquel Pennington,2021-12-18,0,1,-3,3,3,1.666667,10.16,-10.16,0,0,12.70001,-12.70001,78,69,12,24,-12,12,1.33333337306976,-1.33333337306976,2,1,0,1,1,-1,-1,1,273,91,182,-182
Aspen Ladd,Raquel Pennington,Raquel Pennington,2022-04-09,0,1,-6,6,3,1.666667,-2.539993,2.539993,0,0,-2.539993,2.539993,176,102,12,24,-12,12,1.33333337306976,-1.33333337306976,2,2,0,1,0,0,-1,1,854,112,742,-742
Stephan Bonnar,Rashad Evans,Rashad Evans,2006-06-28,0,1,3,-3,1.666667,2.375,10.15999,-10.15999,0,0,10.16,-10.16,4,655,24,27,-3,3,-0.708333373069763,0.708333373069763,3,0,0,0,3,-3,0,0,83,0,83,-83
Michael Bisping,Rashad Evans,Rashad Evans,2007-11-17,0,1,0,0,3.333333,2.375,2.539993,-2.539993,-20,20,0,0,34,462,39,27,12,-12,0.958333253860474,-0.958333253860474,4,1,0,0,3,-3,0,0,70,507,-437,437
Phil Davis,Rashad Evans,Rashad Evans,2012-01-28,0,1,-5,5,4.25,2.375,5.080002,-5.080002,0,0,10.16,-10.16,127,426,21,27,-6,6,1.875,-1.875,4,2,0,0,2,-2,0,0,308,1533,-1225,1225
Ryan Bader,Rashad Evans,Ryan Bader,2015-10-03,1,0,-4,4,4.6,2.375,5.080002,-5.080002,0,0,-2.539993,2.539993,64,56,28,27,1,-1,2.22499990463257,-2.22499990463257,4,3,2,0,1,-1,2,-2,252,1344,-1092,1092
Sam Alvey,Rashad Evans,Sam Alvey,2017-08-05,1,0,-6,6,1.833333,2.375,5.080002,-5.080002,-20,20,0,0,5,269,51,27,24,-24,-0.541666626930237,0.541666626930237,0,0,1,0,0,0,1,-1,105,672,-567,567
Rodrigo Damm,Rashid Magomedov,Rashid Magomedov,2014-05-31,0,1,5,-5,1.444444,10,-5.080002,5.080002,0,0,2.539993,-2.539993,108,42,22,22,0,0,-8.55555558204651,8.55555558204651,3,0,0,0,3,-3,0,0,105,0,105,-105
Gilbert Burns,Rashid Magomedov,Rashid Magomedov,2015-11-07,0,1,-1,1,3.666667,10,2.540009,-2.540009,15,-15,2.539993,-2.539993,125,69,28,22,6,-6,-6.33333325386047,6.33333325386047,3,1,0,0,2,-2,0,0,231,525,-294,294
Beneil Dariush,Rashid Magomedov,Beneil Dariush,2016-11-05,1,0,-4,4,4.4,10,2.540009,-2.540009,0,0,5.080002,-5.080002,250,163,27,22,5,-5,-5.59999990463257,5.59999990463257,5,2,1,0,3,-3,1,-1,154,364,-210,210
Bobby Green,Rashid Magomedov,Rashid Magomedov,2017-04-15,0,1,-2,2,2.142857,10,2.540009,-2.540009,0,0,2.539993,-2.539993,148,0,44,22,22,-22,-7.85714292526245,7.85714292526245,0,0,1,0,0,0,1,-1,315,161,154,-154
Jay Perrin,Raul Rosas Jr.,Raul Rosas Jr.,2022-12-10,0,1,11,-11,1.428571,8,-5.080002,5.080002,0,0,0,0,0,132,17,9,8,-8,-6.57142853736877,6.57142853736877,0,0,0,0,0,0,0,0,0,0,0,0
Christian Rodriguez,Raul Rosas Jr.,Christian Rodriguez,2023-04-08,1,0,7,-7,9,8,-5.080002,5.080002,0,0,10.16,-10.16,450,290,10,9,1,-1,1,-1,1,1,0,0,0,0,0,0,161,119,42,-42
Terrence Mitchell,Raul Rosas Jr.,Raul Rosas Jr.,2023-09-16,0,1,15,-15,3.5,8,2.540009,-2.540009,0,0,17.78001,-17.78001,0,17,18,9,9,-9,-4.5,4.5,0,0,1,0,0,0,1,-1,70,161,-91,91
Kai Kara-France,Raulian Paiva,Kai Kara-France,2019-02-09,1,0,2,-2,2.181818,4.2,-10.16,10.16,-10,10,0,0,20,100,35,26,9,-9,-2.01818156242371,2.01818156242371,0,0,0,0,0,0,0,0,0,0,0,0
Rogerio Bontorin,Raulian Paiva,Rogerio Bontorin,2019-08-10,1,0,4,-4,4,4.2,-7.619995,7.619995,-10,10,-5.080002,5.080002,79,0,20,26,-6,6,-0.199999809265137,0.199999809265137,1,0,0,0,1,-1,0,0,189,182,7,-7
Mark De La Rosa,Raulian Paiva,Raulian Paiva,2020-02-15,0,1,1,-1,2.2,4.2,-5.080002,5.080002,0,0,-10.15999,10.15999,0,108,16,26,-10,10,-1.99999976158142,1.99999976158142,0,0,0,1,0,0,-1,1,168,189,-21,21
"Sean O'Malley",Raulian Paiva,"Sean O'Malley",2021-12-11,1,0,1,-1,17,4.2,7.619995,-7.619995,0,0,7.62001,-7.62001,2,0,18,26,-8,8,12.8000001907349,-12.8000001907349,0,1,1,1,-1,1,0,0,483,665,-182,182
Sergey Morozov,Raulian Paiva,Sergey Morozov,2022-06-25,1,0,7,-7,3.8,4.2,-5.080002,5.080002,0,0,-5.080002,5.080002,275,13,24,26,-2,2,-0.399999856948853,0.399999856948853,0,0,0,2,0,0,-2,2,133,196,-63,63
Rogerio Bontorin,Ray Borg,Ray Borg,2020-02-15,0,1,1,-1,4,2.6,2.540009,-2.540009,-10,10,10.15999,-10.15999,103,683,20,18,2,-2,1.40000009536743,-1.40000009536743,2,0,0,0,2,-2,0,0,189,0,189,-189
Brian Kelleher,Ray Rodriguez,Brian Kelleher,2020-09-05,1,0,2,-2,1.714286,2,-2.539993,2.539993,0,0,-10.16,10.16,0,12,38,24,14,-14,-0.285714268684387,0.285714268684387,0,0,1,0,0,0,1,-1,91,0,91,-91
Patrick Smith,Ray Wizard,Patrick Smith,1994-03-11,1,0,,,1.176471,0,,,,,6,-6,0,0,37,1,36,-36,1.17647063732147,-1.17647063732147,0,0,0,0,0,0,0,0,0,0,0,0
Dileno Lopes,Reginaldo Vieira,Reginaldo Vieira,2015-08-01,0,1,-2,2,6.333333,2.6,-5.079987,5.079987,0,0,4.899994,-4.899994,163,207,22,18,4,-4,3.73333358764648,-3.73333358764648,0,0,0,0,0,0,0,0,0,0,0,0
Marco Beltran,Reginaldo Vieira,Marco Beltran,2016-07-07,1,0,-3,3,1.333333,2.6,2.540009,-2.540009,-10,10,10.15999,-10.15999,24,206,14,18,-4,4,-1.26666653156281,1.26666653156281,2,1,0,0,1,-1,0,0,222,341,-119,119
Royce Gracie,Remco Pardoel,Royce Gracie,1994-03-11,1,0,,,7.5,1.5,-5.080002,5.080002,-85,85,-4,4,0,0,17,15,2,-2,6,-6,0,0,0,0,0,0,0,0,0,0,0,0
Alberta Cerra Leon,Remco Pardoel,Remco Pardoel,1994-03-11,0,1,,,0,1.5,-17.78,17.78,-22,22,-8,8,0,0,1,15,-14,14,-1.5,1.5,0,0,0,0,0,0,0,0,0,0,0,0
Calvin Kattar,Renato Moicano,Renato Moicano,2018-04-07,0,1,2,-2,3.285714,3.4,0,0,-10,10,0,0,1,0,30,22,8,-8,-0.114285707473755,0.114285707473755,0,0,0,0,0,0,0,0,0,0,0,0
Jose Aldo,Renato Moicano,Jose Aldo,2019-02-02,1,0,3,-3,3.875,3.4,-10.16,10.16,-20,20,-5.080002,5.080002,0,0,39,22,17,-17,0.474999904632568,-0.474999904632568,1,1,3,0,0,0,3,-3,189,301,-112,112
Damir Hadzovic,Renato Moicano,Renato Moicano,2020-03-14,0,1,3,-3,2,3.4,-5.080002,5.080002,0,0,-5.080002,5.080002,0,25,21,22,-1,1,-1.40000009536743,1.40000009536743,2,0,1,1,2,-2,0,0,385,406,-21,21
Rafael Fiziev,Renato Moicano,Rafael Fiziev,2020-12-12,1,0,-4,4,4,3.4,-7.619995,7.619995,0,0,-2.540009,2.540009,4,0,15,22,-7,7,0.599999904632568,-0.599999904632568,1,1,1,1,0,0,0,0,413,273,140,-140
Jai Herbert,Renato Moicano,Renato Moicano,2021-06-26,0,1,1,-1,2.4,3.4,5.080002,-5.080002,0,0,12.7,-12.7,8,455,17,22,-5,5,-1,1,0,0,1,2,0,0,-1,1,336,196,140,-140
Alexander Hernandez,Renato Moicano,Renato Moicano,2022-02-12,0,1,-3,3,2.333333,3.4,-5.080002,5.080002,-10,10,0,0,5,103,20,22,-2,2,-1.06666684150696,1.06666684150696,0,1,0,2,-1,1,-2,2,350,231,119,-119
Rafael Dos Anjos,Renato Moicano,Rafael Dos Anjos,2022-03-05,1,0,5,-5,2.133333,3.4,-7.619995,7.619995,15,-15,-5.080002,5.080002,802,30,47,22,25,-25,-1.26666665077209,1.26666665077209,1,2,1,2,-1,1,-1,1,476,21,455,-455
Maurice Smith,Renato Sobral,Renato Sobral,2000-11-17,0,1,13,-13,0.8571429,3.363636,2.540009,-2.540009,16,-16,0.5,-0.5,0,708,26,48,-22,22,-2.50649338960648,2.50649338960648,0,0,0,0,0,0,0,0,0,0,0,0
Kevin Randleman,Renato Sobral,Kevin Randleman,2002-01-11,1,0,4,-4,1.0625,3.363636,-7.619995,7.619995,0,0,-10.5,10.5,767,0,33,48,-15,15,-2.30113625526428,2.30113625526428,2,1,0,0,1,-1,0,0,581,420,161,-161
Elvis Sinosic,Renato Sobral,Renato Sobral,2002-07-13,0,1,5,-5,0.6363636,3.363636,5.080002,-5.080002,0,0,5.080002,-5.080002,3,778,18,48,-30,30,-2.72727262973785,2.72727262973785,0,0,1,0,0,0,1,-1,113,183,-70,70
Chuck Liddell,Renato Sobral,Chuck Liddell,2002-11-22,1,0,5,-5,2.625,3.363636,2.540009,-2.540009,0,0,2.539993,-2.539993,3,0,29,48,-19,19,-0.738636255264282,0.738636255264282,3,1,0,0,2,-2,0,0,315,132,183,-183
Chuck Liddell,Renato Sobral,Chuck Liddell,2006-08-26,1,0,6,-6,2.625,3.363636,2.540009,-2.540009,0,0,2.539993,-2.539993,25,0,29,48,-19,19,-0.738636255264282,0.738636255264282,6,0,0,1,6,-6,-1,1,735,1373,-638,638
Jason Lambert,Renato Sobral,Jason Lambert,2007-03-03,1,0,0,0,2,3.363636,5.080002,-5.080002,-20,20,0,0,191,237,39,48,-9,9,-1.36363625526428,1.36363625526428,3,0,0,2,3,-3,-2,2,248,189,59,-59
David Heath,Renato Sobral,Renato Sobral,2007-08-25,0,1,0,0,2.571429,3.363636,-5.080002,5.080002,0,0,-7.619995,7.619995,144,303,25,48,-23,23,-0.792207717895508,0.792207717895508,0,0,0,3,0,0,-3,3,126,175,-49,49
Carlos Newton,Renato Verissimo,Renato Verissimo,2004-01-31,0,1,-3,3,1.142857,1.4,-10.16,10.16,0,0,-10,10,211,567,30,12,18,-18,-0.257142782211304,0.257142782211304,1,0,0,0,1,-1,0,0,435,0,435,-435
Matt Hughes,Renato Verissimo,Matt Hughes,2004-06-19,1,0,0,0,5,1.4,-10.16,10.16,0,0,-2.580002,2.580002,809,12,54,12,42,-42,3.60000002384186,-3.60000002384186,0,1,0,0,-1,1,0,0,140,140,0,0
Frank Trigg,Renato Verissimo,Frank Trigg,2004-10-22,1,0,1,-1,2.333333,1.4,-10.16,10.16,0,0,-7.660004,7.660004,301,53,30,12,18,-18,0.933333277702332,-0.933333277702332,0,0,0,0,0,0,0,0,0,125,-125,125
Terry Etim,Renee Forte,Renee Forte,2013-02-16,0,1,2,-2,3.2,2,15.24001,-15.24001,0,0,5.080002,-5.080002,2,645,21,12,9,-9,1.20000004768372,-1.20000004768372,3,0,0,0,3,-3,0,0,469,0,469,-469
Matt Hamill,Rex Holman,Matt Hamill,2007-03-03,1,0,,,1.5,2,-5.080002,5.080002,0,0,-0.9600067,0.9600067,57,0,20,6,14,-14,-0.5,0.5,1,0,0,0,1,-1,0,0,144,0,144,-144
Yoislandy Izquierdo,Reza Madadi,Reza Madadi,2012-04-14,0,1,-5,5,2.5,2.333333,0,0,0,0,-2.419998,2.419998,16,135,14,20,-6,6,0.166666746139526,-0.166666746139526,0,0,0,0,0,0,0,0,0,0,0,0
Michael Johnson,Reza Madadi,Reza Madadi,2013-04-06,0,1,-8,8,1.157895,2.333333,-2.539993,2.539993,0,0,0,0,110,367,41,20,21,-21,-1.17543852329254,1.17543852329254,0,1,0,0,-1,1,0,0,98,357,-259,259
Yan Cabral,Reza Madadi,Reza Madadi,2016-05-08,0,1,-5,5,4.333333,2.333333,0,0,0,0,0,0,189,201,16,20,-4,4,2.00000023841858,-2.00000023841858,0,2,0,0,-2,2,0,0,183,1128,-945,945
Joe Duffy,Reza Madadi,Joe Duffy,2017-03-18,1,0,-9,9,3.2,2.333333,-2.539993,2.539993,0,0,0,0,260,54,21,20,1,-1,0.866666793823242,-0.866666793823242,0,3,0,0,-3,3,0,0,441,314,127,-127
Brian Johnston,Reza Nasri,Brian Johnston,1996-09-20,1,0,,,1,0,10.16,-10.16,25,-25,10,-10,0,0,10,1,9,-9,1,-1,0,0,0,0,0,0,0,0,0,0,0,0
Khamzat Chimaev,Rhys McKee,Khamzat Chimaev,2020-07-25,1,0,2,-2,12,2,0,0,15,-15,-7.619995,7.619995,179,0,12,15,-3,3,10,-10,1,0,0,0,1,-1,0,0,10,0,10,-10
Ange Loosa,Rhys McKee,Ange Loosa,2023-09-02,1,0,3,-3,3.333333,2,-10.16,10.16,0,0,-10.15999,10.15999,367,5,13,15,-2,2,1.33333325386047,-1.33333325386047,0,0,0,1,0,0,-1,1,0,1134,-1134,1134
Matt Grice,Ricardo Lamas,Ricardo Lamas,2011-06-26,0,1,0,0,3,2.5,0,0,0,0,-2.539993,2.539993,0,109,20,28,-8,8,0.5,-0.5,0,0,1,0,0,0,1,-1,715,0,715,-715
Hatsu Hioki,Ricardo Lamas,Ricardo Lamas,2012-06-22,0,1,-2,2,2.9,2.5,7.619995,-7.619995,0,0,5.080002,-5.080002,441,76,39,28,11,-11,0.400000095367432,-0.400000095367432,2,1,0,0,1,-1,0,0,118,362,-244,244
Erik Koch,Ricardo Lamas,Ricardo Lamas,2013-01-26,0,1,-6,6,2.666667,2.5,5.080002,-5.080002,25,-25,0,0,20,195,22,28,-6,6,0.166666746139526,-0.166666746139526,0,2,0,0,-2,2,0,0,0,218,-218,218
Jose Aldo,Ricardo Lamas,Jose Aldo,2014-02-01,1,0,-4,4,3.875,2.5,-2.540009,2.540009,-10,10,-2.539993,2.539993,311,246,39,28,11,-11,1.375,-1.375,5,3,0,0,2,-2,0,0,182,371,-189,189
Hacran Dias,Ricardo Lamas,Ricardo Lamas,2014-06-28,0,1,-2,2,3.833333,2.5,0,0,10,-10,-5.080002,5.080002,214,329,29,28,1,-1,1.33333325386047,-1.33333325386047,0,0,0,0,0,0,0,0,406,147,259,-259
Dennis Bermudez,Ricardo Lamas,Ricardo Lamas,2014-11-15,0,1,-5,5,1.888889,2.5,-5.080002,5.080002,10,-10,-12.7,12.7,60,50,26,28,-2,2,-0.611111164093018,0.611111164093018,7,1,0,0,6,-6,0,0,112,140,-28,28
Max Holloway,Ricardo Lamas,Max Holloway,2016-06-04,1,0,-10,10,3.571429,2.5,7.619995,-7.619995,0,0,-5.080002,5.080002,98,45,32,28,4,-4,1.07142853736877,-1.07142853736877,4,2,0,0,2,-2,0,0,175,567,-392,392
Jason Knight,Ricardo Lamas,Ricardo Lamas,2017-07-29,0,1,-10,10,4,2.5,5.080002,-5.080002,0,0,0,0,0,177,25,28,-3,3,1.5,-1.5,1,0,0,0,1,-1,0,0,77,420,-343,343
Josh Emmett,Ricardo Lamas,Josh Emmett,2017-12-16,1,0,-3,3,4.5,2.5,-5.080002,5.080002,0,0,-2.539993,2.539993,0,0,22,28,-6,6,2,-2,0,1,0,0,-1,1,0,0,252,140,112,-112
Mirsad Bektic,Ricardo Lamas,Mirsad Bektic,2018-06-09,1,0,-9,9,3.25,2.5,0,0,0,0,-2.539993,2.539993,515,54,17,28,-11,11,0.75,-0.75,1,0,1,1,1,-1,0,0,133,175,-42,42
Darren Elkins,Ricardo Lamas,Ricardo Lamas,2018-11-17,0,1,-2,2,2.454545,2.5,5.080002,-5.080002,0,0,0,0,159,152,38,28,10,-10,-4.54545021057129e-02,4.54545021057129e-02,0,0,1,1,0,0,0,0,126,161,-35,35
Calvin Kattar,Ricardo Lamas,Calvin Kattar,2019-06-08,1,0,-6,6,3.285714,2.5,7.619995,-7.619995,0,0,2.540009,-2.540009,2,0,30,28,2,-2,0.785714387893677,-0.785714387893677,0,1,0,1,-1,1,-1,1,427,203,224,-224
Bill Algeo,Ricardo Lamas,Ricardo Lamas,2020-08-29,0,1,-7,7,2.428571,2.5,10.16,-10.16,0,0,5.080002,-5.080002,79,373,24,28,-4,4,-7.14285373687744e-02,7.14285373687744e-02,0,0,0,2,0,0,-2,2,0,448,-448,448
Kyung Ho Kang,Ricardo Ramos,Ricardo Ramos,2018-08-04,0,1,7,-7,2.111111,3.2,0,0,-10,10,2.539993,-2.539993,127,58,28,21,7,-7,-1.0888888835907,1.0888888835907,2,0,0,0,2,-2,0,0,1414,0,1414,-1414
Said Nurmagomedov,Ricardo Ramos,Said Nurmagomedov,2019-02-02,1,0,3,-3,5.666667,3.2,-2.539993,2.539993,-10,10,-5.080002,5.080002,5,0,20,21,-1,1,2.46666646003723,-2.46666646003723,1,1,0,0,0,0,0,0,203,182,21,-21
Journey Newson,Ricardo Ramos,Ricardo Ramos,2019-06-29,0,1,7,-7,2,3.2,-10.15999,10.15999,-10,10,-12.70001,12.70001,10,166,15,21,-6,6,-1.20000004768372,1.20000004768372,0,0,0,1,0,0,-1,1,0,147,-147,147
Eduardo Garagorri,Ricardo Ramos,Ricardo Ramos,2019-11-16,0,1,6,-6,6.5,3.2,0,0,0,0,-5.080002,5.080002,3,66,15,21,-6,6,3.29999995231628,-3.29999995231628,0,1,0,1,-1,1,-1,1,0,140,-140,140
Lerone Murphy,Ricardo Ramos,Lerone Murphy,2020-07-15,1,0,4,-4,13,3.2,0,0,0,0,2.539993,-2.539993,82,57,13,21,-8,8,9.79999995231628,-9.79999995231628,0,2,0,1,-2,2,-1,1,0,242,-242,242
Bill Algeo,Ricardo Ramos,Ricardo Ramos,2021-05-22,0,1,6,-6,2.428571,3.2,7.62001,-7.62001,0,0,2.539993,-2.539993,41,206,24,21,3,-3,-0.77142858505249,0.77142858505249,1,0,0,2,1,-1,-2,2,175,311,-136,136
Danny Chavez,Ricardo Ramos,Ricardo Ramos,2022-06-18,0,1,9,-9,2.2,3.2,-2.539993,2.539993,0,0,-12.70001,12.70001,0,1,16,21,-5,5,-1,1,0,1,0,2,-1,1,-2,2,483,392,91,-91
Charles Jourdain,Ricardo Ramos,Charles Jourdain,2023-09-23,1,0,-1,1,2.5,3.2,0,0,0,0,-7.62001,7.62001,0,118,21,21,0,0,-0.700000047683716,0.700000047683716,0,2,0,2,-2,2,-2,2,385,462,-77,77
Seth Petruzelli,Ricardo Romero,Ricardo Romero,2010-07-03,0,1,-2,2,1.75,3.666667,0,0,0,0,0,0,71,239,22,14,8,-8,-1.91666674613953,1.91666674613953,0,0,0,0,0,0,0,0,0,0,0,0
Kyle Kingsbury,Ricardo Romero,Kyle Kingsbury,2011-02-05,1,0,-4,4,1.833333,3.666667,10.15999,-10.15999,0,0,7.62001,-7.62001,7,0,17,14,3,-3,-1.83333337306976,1.83333337306976,0,1,0,0,-1,1,0,0,784,217,567,-567
Andrei Arlovski,Ricco Rodriguez,Ricco Rodriguez,2001-06-29,0,1,-1,1,1.545455,2.12,-2.539993,2.539993,-25,25,17.58,-17.58,18,445,56,78,-22,22,-0.574545383453369,0.574545383453369,1,0,0,0,1,-1,0,0,224,0,224,-224
Jeff Monson,Ricco Rodriguez,Ricco Rodriguez,2002-01-11,0,1,6,-6,2.307692,2.12,-17.78,17.78,-18,18,9.960007,-9.960007,236,400,86,78,8,-8,0.187692403793335,-0.187692403793335,0,1,0,0,-1,1,0,0,0,196,-196,196
Tsuyoshi Kohsaka,Ricco Rodriguez,Ricco Rodriguez,2002-05-10,0,1,8,-8,1.421053,2.12,-12.7,12.7,-40,40,5,-5,33,430,46,78,-32,32,-0.698947310447693,0.698947310447693,0,2,2,0,-2,2,2,-2,903,119,784,-784
Randy Couture,Ricco Rodriguez,Ricco Rodriguez,2002-09-27,0,1,14,-14,1.727273,2.12,-7.619995,7.619995,-60,60,12.5,-12.5,530,665,30,78,-48,48,-0.392727136611938,0.392727136611938,6,3,0,0,3,-3,0,0,329,140,189,-189
Pedro Rizzo,Ricco Rodriguez,Pedro Rizzo,2003-11-21,1,0,3,-3,1.818182,2.12,-7.619995,7.619995,-24,24,10,-10,352,0,31,78,-47,47,-0.301818013191223,0.301818013191223,3,4,0,0,-1,1,0,0,168,420,-252,252
Roan Carneiro,Rich Clementi,Roan Carneiro,2007-04-05,1,0,-3,3,1.909091,1.956522,5.080002,-5.080002,15,-15,10.15999,-10.15999,710,8,32,68,-36,36,-4.74308729171753e-02,4.74308729171753e-02,0,0,0,0,0,0,0,0,0,0,0,0
Edwin DeWees,Rich Franklin,Rich Franklin,2003-09-26,0,1,-7,7,2.235294,4.142857,0,0,0,0,-5.039993,5.039993,34,119,55,36,19,-19,-1.90756297111511,1.90756297111511,0,0,0,0,0,0,0,0,0,0,0,0
Vitor Belfort,Rich Franklin,Vitor Belfort,2009-09-19,1,0,-2,2,1.857143,4.142857,-2.539993,2.539993,0,0,-5.079987,5.079987,4,0,40,36,4,-4,-2.28571426868439,2.28571426868439,0,1,2,0,-1,1,2,-2,1687,2185,-498,498
Chris Indich,Richard Walsh,Richard Walsh,2014-04-16,0,1,1,-1,1.5,1.8,-5.080002,5.080002,0,0,-5.419998,5.419998,78,623,10,14,-4,4,-0.299999952316284,0.299999952316284,0,0,0,0,0,0,0,0,0,0,0,0
Kiichi Kunimoto,Richard Walsh,Kiichi Kunimoto,2014-09-20,1,0,8,-8,2.571429,1.8,-5.080002,5.080002,0,0,-5.080002,5.080002,365,198,25,14,11,-11,0.77142858505249,-0.77142858505249,1,1,0,0,0,0,0,0,98,157,-59,59
Alan Jouban,Richard Walsh,Alan Jouban,2015-02-28,1,0,7,-7,2.428571,1.8,0,0,0,0,0,0,1,17,24,14,10,-10,0.628571510314941,-0.628571510314941,0,0,0,0,0,0,0,0,0,161,-161,161
Steve Kennedy,Richard Walsh,Richard Walsh,2015-11-14,0,1,6,-6,3,1.8,-2.540009,2.540009,0,0,-2.419998,2.419998,263,268,32,14,18,-18,1.20000004768372,-1.20000004768372,0,0,0,1,0,0,-1,1,147,259,-112,112
Viscardi Andrade,Richard Walsh,Viscardi Andrade,2016-03-19,1,0,5,-5,3.166667,1.8,-2.540009,2.540009,0,0,5.080002,-5.080002,417,112,25,14,11,-11,1.36666679382324,-1.36666679382324,1,1,0,1,0,0,-1,1,133,126,7,-7
Jonathan Meunier,Richard Walsh,Jonathan Meunier,2016-11-26,1,0,2,-2,8,1.8,7.619995,-7.619995,0,0,-2.419998,2.419998,80,173,9,14,-5,5,6.20000004768372,-6.20000004768372,0,0,0,1,0,0,-1,1,0,252,-252,252
Ildemar Alcantara,Richardson Moreira,Ildemar Alcantara,2015-01-31,1,0,2,-2,1.909091,1.75,0,0,0,0,10.12,-10.12,61,158,32,11,21,-21,0.159090876579285,-0.159090876579285,0,0,0,0,0,0,0,0,210,0,210,-210
Luis Pena,Richie Smullen,Luis Pena,2018-07-06,1,0,-1,1,3,3,15.24001,-15.24001,0,0,17.78,-17.78,61,100,12,4,8,-8,0,0,0,0,0,0,0,0,0,0,0,0,0,0
Justin Scoggins,Richie Vaculik,Justin Scoggins,2013-12-06,1,0,-9,9,2.2,2.5,2.539993,-2.539993,0,0,-7.619995,7.619995,246,0,16,14,2,-2,-0.299999952316284,0.299999952316284,0,0,0,0,0,0,0,0,0,0,0,0
"Roldan Sangcha'an",Richie Vaculik,Richie Vaculik,2014-06-28,0,1,-8,8,2,2.5,-5.080002,5.080002,0,0,-10.25999,10.25999,53,427,6,14,-8,8,-0.5,0.5,0,0,0,1,0,0,-1,1,0,204,-204,204
Louis Smolka,Richie Vaculik,Louis Smolka,2014-11-07,1,0,-8,8,1.888889,2.5,7.619995,-7.619995,10,-10,-2.539993,2.539993,67,65,26,14,12,-12,-0.611111164093018,0.611111164093018,0,1,0,1,-1,1,-1,1,0,132,-132,132
Danny Martinez,Richie Vaculik,Danny Martinez,2015-11-14,1,0,-2,2,2.625,2.5,0,0,0,0,-5.080002,5.080002,468,44,29,14,15,-15,0.125,-0.125,0,0,0,2,0,0,-2,2,0,372,-372,372
John Hathaway,Rick Story,John Hathaway,2009-06-13,1,0,-3,3,8.5,2.111111,10.16,-10.16,0,0,10.16,-10.16,410,246,19,28,-9,9,6.38888883590698,-6.38888883590698,0,0,0,0,0,0,0,0,0,0,0,0
Brian Foster,Rick Story,Rick Story,2009-09-19,0,1,0,0,2.7,2.111111,0,0,0,0,0,0,5,263,37,28,9,-9,0.588888883590698,-0.588888883590698,0,0,0,0,0,0,0,0,0,98,-98,98
Jesse Lennox,Rick Story,Rick Story,2010-01-11,0,1,2,-2,3.5,2.111111,0,0,0,0,2.540009,-2.540009,63,263,18,28,-10,10,1.38888883590698,-1.38888883590698,1,1,0,0,0,0,0,0,156,114,42,-42
Nick Osipczak,Rick Story,Rick Story,2010-04-10,0,1,0,0,2,2.111111,12.70001,-12.70001,0,0,12.7,-12.7,147,595,9,28,-19,19,-0.111111164093018,0.111111164093018,1,2,0,0,-1,1,0,0,147,89,58,-58
Dustin Hazelett,Rick Story,Rick Story,2010-08-07,0,1,-1,1,1.714286,2.111111,10.16,-10.16,0,0,12.7,-12.7,0,308,19,28,-9,9,-0.396825432777405,0.396825432777405,1,3,1,0,-2,2,1,-1,630,119,511,-511
Johny Hendricks,Rick Story,Rick Story,2010-12-04,0,1,1,-1,2.25,2.111111,0,0,15,-15,-5.080002,5.080002,377,171,26,28,-2,2,0.138888835906982,-0.138888835906982,1,4,0,0,-3,3,0,0,483,119,364,-364
Thiago Alves,Rick Story,Rick Story,2011-05-28,0,1,1,-1,1.533333,2.111111,0,0,0,0,-2.539993,2.539993,60,459,38,28,10,-10,-0.577777862548828,0.577777862548828,1,5,1,0,-4,4,1,-1,168,175,-7,7
Charlie Brenneman,Rick Story,Charlie Brenneman,2011-06-26,1,0,4,-4,2.375,2.111111,2.540009,-2.540009,-15,15,-2.539993,2.539993,582,167,27,28,-1,1,0.263888835906982,-0.263888835906982,0,6,1,0,-6,6,1,-1,323,29,294,-294
Martin Kampmann,Rick Story,Martin Kampmann,2011-11-19,1,0,2,-2,2.857143,2.111111,7.62001,-7.62001,0,0,2.540009,-2.540009,295,37,27,28,-1,1,0.746031761169434,-0.746031761169434,0,0,1,0,0,0,1,-1,261,146,115,-115
Brock Jardine,Rick Story,Rick Story,2012-06-22,0,1,-1,1,2,2.111111,5.080002,-5.080002,0,0,-0.3399963,0.3399963,46,313,18,28,-10,10,-0.111111164093018,0.111111164093018,0,0,0,0,0,0,0,0,0,216,-216,216
Demian Maia,Rick Story,Demian Maia,2012-10-13,1,0,6,-6,2.545455,2.111111,10.16,-10.16,0,0,2.540009,-2.540009,135,0,39,28,11,-11,0.434343338012695,-0.434343338012695,0,1,1,0,-1,1,1,-1,259,113,146,-146
Quinn Mulhern,Rick Story,Rick Story,2013-03-16,0,1,0,0,4.5,2.111111,15.24001,-15.24001,-15,15,15.66,-15.66,0,7,22,28,-6,6,2.38888883590698,-2.38888883590698,0,0,0,0,0,0,0,0,0,154,-154,154
Mike Pyle,Rick Story,Mike Pyle,2013-05-25,1,0,9,-9,1.928571,2.111111,7.62001,-7.62001,0,0,7.62001,-7.62001,24,568,41,28,13,-13,-0.182539701461792,0.182539701461792,1,1,0,0,0,0,0,0,1347,70,1277,-1277
Brian Ebersole,Rick Story,Rick Story,2013-11-16,0,1,3,-3,2.833333,2.111111,7.62001,-7.62001,0,0,5.080002,-5.080002,25,62,69,28,41,-41,0.722222089767456,-0.722222089767456,0,0,0,0,0,0,0,0,483,175,308,-308
Kelvin Gastelum,Rick Story,Kelvin Gastelum,2014-03-15,1,0,-7,7,2.25,2.111111,0,0,0,0,0,0,89,140,26,28,-2,2,0.138888835906982,-0.138888835906982,2,1,0,0,1,-1,0,0,199,119,80,-80
Leonardo Mafra,Rick Story,Rick Story,2014-07-16,0,1,-4,4,3.25,2.111111,2.540009,-2.540009,-15,15,-2.539993,2.539993,0,345,17,28,-11,11,1.13888883590698,-1.13888883590698,0,0,1,0,0,0,1,-1,753,123,630,-630
Gunnar Nelson,Rick Story,Rick Story,2014-10-04,0,1,-4,4,3.8,2.111111,5.080002,-5.080002,0,0,2.540009,-2.540009,21,36,24,28,-4,4,1.68888878822327,-1.68888878822327,1,1,0,0,0,0,0,0,595,80,515,-515
Tarec Saffiedine,Rick Story,Rick Story,2016-05-29,0,1,-2,2,2.285714,2.111111,2.540009,-2.540009,0,0,-2.539993,2.539993,37,415,23,28,-5,5,0.174603223800659,-0.174603223800659,0,2,0,0,-2,2,0,0,0,603,-603,603
Donald Cerrone,Rick Story,Donald Cerrone,2016-08-20,1,0,2,-2,2.117647,2.111111,10.16,-10.16,-15,15,5.080002,-5.080002,43,102,53,28,25,-25,6.53600692749023e-03,-6.53600692749023e-03,2,3,2,0,-1,1,2,-2,63,83,-20,20
Evan Dunham,Ricky Glenn,Evan Dunham,2016-09-17,1,0,7,-7,2,3.142857,-5.080002,5.080002,0,0,0,0,423,0,27,29,-2,2,-1.14285707473755,1.14285707473755,3,0,1,0,3,-3,1,-1,281,0,281,-281
Dennis Bermudez,Ricky Glenn,Ricky Glenn,2018-07-14,0,1,2,-2,1.888889,3.142857,-15.24001,15.24001,0,0,-10.16,10.16,258,34,26,29,-3,3,-1.25396823883057,1.25396823883057,0,0,2,0,0,0,2,-2,168,665,-497,497
Kevin Aguilar,Ricky Glenn,Kevin Aguilar,2018-11-30,1,0,1,-1,3.4,3.142857,-12.70001,12.70001,0,0,7.619995,-7.619995,127,27,22,29,-7,7,0.257143020629883,-0.257143020629883,0,1,0,0,-1,1,0,0,0,139,-139,139
Christos Giagos,Ricky Glenn,Christos Giagos,2023-04-22,1,0,-1,1,1.818182,3.142857,-5.080002,5.080002,0,0,2.539993,-2.539993,0,0,31,29,2,-2,-1.32467520236969,1.32467520236969,0,0,1,0,0,0,1,-1,301,1604,-1303,1303
Tim Means,Ricky Rainey,Tim Means,2018-11-30,1,0,-1,1,2.2,2,2.540009,-2.540009,0,0,-5.080002,5.080002,33,0,48,18,30,-30,0.200000047683716,-0.200000047683716,0,0,0,0,0,0,0,0,300,0,300,-300
Merab Dvalishvili,Ricky Simon,Ricky Simon,2018-04-21,0,1,2,-2,4,5,0,0,0,0,-2.539993,2.539993,162,166,20,24,-4,4,-1,1,0,0,0,0,0,0,0,0,133,0,133,-133
Montel Jackson,Ricky Simon,Ricky Simon,2018-08-04,0,1,1,-1,6.5,5,10.16,-10.16,0,0,15.24001,-15.24001,45,337,15,24,-9,9,1.5,-1.5,0,1,0,0,-1,1,0,0,0,105,-105,105
Urijah Faber,Ricky Simon,Urijah Faber,2019-07-13,1,0,14,-14,3.181818,5,0,0,0,0,-5.080002,5.080002,8,0,46,24,22,-22,-1.81818175315857,1.81818175315857,1,2,0,0,-1,1,0,0,938,343,595,-595
Rob Font,Ricky Simon,Rob Font,2019-12-07,1,0,5,-5,2.857143,5,5.080002,-5.080002,0,0,5.080002,-5.080002,11,198,27,24,3,-3,-2.14285707473755,2.14285707473755,1,0,0,1,1,-1,-1,1,357,147,210,-210
Ray Borg,Ricky Simon,Ricky Simon,2020-05-13,0,1,-1,1,2.6,5,-5.080002,5.080002,0,0,-15.23999,15.23999,30,323,18,24,-6,6,-2.40000009536743,2.40000009536743,1,0,0,1,1,-1,-1,1,298,158,140,-140
Gaetano Pirrello,Ricky Simon,Ricky Simon,2021-01-20,0,1,0,0,2.142857,5,2.539993,-2.539993,0,0,-10.15999,10.15999,0,419,22,24,-2,2,-2.85714292526245,2.85714292526245,0,1,0,1,-1,1,-1,1,0,252,-252,252
Brian Kelleher,Ricky Simon,Ricky Simon,2021-02-13,0,1,6,-6,1.714286,5,0,0,0,0,-7.619995,7.619995,12,494,38,24,14,-14,-3.28571426868439,3.28571426868439,1,2,1,1,-1,1,0,0,161,24,137,-137
Raphael Assuncao,Ricky Simon,Ricky Simon,2021-12-18,0,1,10,-10,2.8,5,-2.539993,2.539993,0,0,-7.619995,7.619995,0,242,38,24,14,-14,-2.20000004768372,2.20000004768372,0,3,2,1,-3,3,1,-1,560,308,252,-252
Jack Shore,Ricky Simon,Ricky Simon,2022-07-16,0,1,-2,2,17,5,5.080002,-5.080002,0,0,5.080002,-5.080002,13,246,18,24,-6,6,12,-12,1,4,0,1,-3,3,-1,1,119,210,-91,91
Brady Hiestand,Ricky Turcios,Ricky Turcios,2021-08-28,0,1,-6,6,4,4.333333,-2.539993,2.539993,0,0,0,0,460,152,10,16,-6,6,-0.333333492279053,0.333333492279053,0,0,0,0,0,0,0,0,0,0,0,0
Kevin Natividad,Ricky Turcios,Ricky Turcios,2022-11-19,0,1,0,0,2.25,4.333333,-7.619995,7.619995,0,0,-2.539993,2.539993,300,377,13,16,-3,3,-2.08333349227905,2.08333349227905,0,1,0,0,-1,1,0,0,0,448,-448,448
Steve Cantwell,Riki Fukuda,Riki Fukuda,2012-02-25,0,1,-6,6,1.166667,2.666667,5.080002,-5.080002,0,0,5.080002,-5.080002,12,216,13,33,-20,20,-1.50000011920929,1.50000011920929,0,0,0,0,0,0,0,0,140,0,140,-140
Tom DeBlass,Riki Fukuda,Riki Fukuda,2012-11-10,0,1,-1,1,4.5,2.666667,0,0,0,0,0.5800018,-0.5800018,0,418,11,33,-22,22,1.83333325386047,-1.83333325386047,0,1,0,0,-1,1,0,0,210,259,-49,49
Bryan Battle,Rinat Fakhretdinov,Rinat Fakhretdinov,2022-12-17,0,1,-3,3,5.5,21,2.539993,-2.539993,0,0,7.619995,-7.619995,0,851,13,22,-9,9,-15.5,15.5,3,0,0,0,3,-3,0,0,133,0,133,-133
Toshiomi Kazama,Rinya Nakamura,Rinya Nakamura,2023-02-04,0,1,-2,2,2.5,8,0,0,0,0,2.539993,-2.539993,0,3,14,8,6,-6,-5.5,5.5,0,0,0,0,0,0,0,0,0,0,0,0
Fernie Garcia,Rinya Nakamura,Rinya Nakamura,2023-08-26,0,1,3,-3,2.5,8,0,0,0,0,-2.540009,2.540009,0,566,14,8,6,-6,-5.5,5.5,0,1,0,0,-1,1,0,0,280,203,77,-77
Kevin Burns,Roan Carneiro,Kevin Burns,2008-06-07,1,0,-2,2,1.714286,1.909091,-2.539993,2.539993,0,0,-5.079987,5.079987,54,423,19,32,-13,13,-0.194805145263672,0.194805145263672,0,0,0,0,0,0,0,0,0,0,0,0
Derek Brunson,Roan Carneiro,Derek Brunson,2016-02-21,1,0,-5,5,2.555556,1.909091,5.080002,-5.080002,15,-15,2.540009,-2.540009,42,0,32,32,0,0,0.646464705467224,-0.646464705467224,2,0,1,0,2,-2,1,-1,386,2815,-2429,2429
Rafael Dos Anjos,Rob Emerson,Rafael Dos Anjos,2009-09-19,1,0,-4,4,2.133333,1.5,-2.539993,2.539993,15,-15,0,0,258,20,47,30,17,-17,0.633333444595337,-0.633333444595337,0,0,1,0,0,0,1,-1,171,0,171,-171
Thomas Almeida,Rob Font,Rob Font,2018-01-20,0,1,-4,4,4.4,2.857143,-2.540009,2.540009,10,-10,-2.539993,2.539993,4,62,27,27,0,0,1.54285717010498,-1.54285717010498,0,0,1,0,0,0,1,-1,182,0,182,-182
Raphael Assuncao,Rob Font,Raphael Assuncao,2018-07-07,1,0,4,-4,2.8,2.857143,-7.619995,7.619995,0,0,-12.7,12.7,272,0,38,27,11,-11,-5.7142972946167e-02,5.7142972946167e-02,3,1,1,0,2,-2,1,-1,238,168,70,-70
Jose Aldo,Rob Font,Jose Aldo,2021-12-04,1,0,1,-1,3.875,2.857143,-2.540009,2.540009,0,0,-2.539993,2.539993,546,128,39,27,12,-12,1.01785707473755,-1.01785707473755,2,0,4,0,2,-2,4,-4,119,1246,-1127,1127
Jason Lambert,Rob MacDonald,Jason Lambert,2006-03-04,1,0,3,-3,2,1.25,0,0,-20,20,-7.619995,7.619995,60,20,39,9,30,-30,0.75,-0.75,0,0,0,0,0,0,0,0,0,0,0,0
Siyar Bahadurzada,Rob Wilkinson,Siyar Bahadurzada,2017-09-02,1,0,8,-8,3,5.5,-10.16,10.16,-15,15,-17.78,17.78,29,138,32,13,19,-19,-2.5,2.5,1,0,0,0,1,-1,0,0,546,0,546,-546
Israel Adesanya,Rob Wilkinson,Israel Adesanya,2018-02-10,1,0,3,-3,8,5.5,2.539993,-2.539993,0,0,0,0,0,246,27,13,14,-14,2.5,-2.5,0,0,0,1,0,0,-1,1,0,161,-161,161
Ricardo Almeida,Rob Yundt,Ricardo Almeida,2008-02-02,1,0,4,-4,2.6,1.8,-2.539993,2.539993,-15,15,-3.999329e-02,3.999329e-02,19,5,18,14,4,-4,0.799999952316284,-0.799999952316284,0,0,1,0,0,0,1,-1,2213,0,2213,-2213
Rob Kimmons,Rob Yundt,Rob Kimmons,2008-06-21,1,0,-1,1,2.777778,1.8,-7.619995,7.619995,0,0,-2.580002,2.580002,93,132,34,14,20,-20,0.977777719497681,-0.977777719497681,0,0,0,0,0,0,0,0,0,140,-140,140
Steve Berger,Robbie Lawler,Robbie Lawler,2002-06-22,0,1,9,-9,0.9130435,1.875,0,0,0,0,5.039993,-5.039993,26,122,44,46,-2,2,-0.96195650100708,0.96195650100708,0,0,0,0,0,0,0,0,414,0,414,-414
Tiki Ghosn,Robbie Lawler,Robbie Lawler,2002-11-22,0,1,5,-5,1.428571,1.875,-2.539993,2.539993,0,0,-7.960007,7.960007,0,2,17,46,-29,29,-0.446428537368774,0.446428537368774,0,1,0,0,-1,1,0,0,637,153,484,-484
Nick Diaz,Robbie Lawler,Nick Diaz,2004-04-02,1,0,-2,2,2.6,1.875,5.080002,-5.080002,0,0,5.079987,-5.079987,49,0,36,46,-10,10,0.724999904632568,-0.724999904632568,1,2,0,0,-1,1,0,0,189,497,-308,308
Josh Koscheck,Robbie Lawler,Robbie Lawler,2013-02-23,0,1,5,-5,1.545455,1.875,-2.539993,2.539993,0,0,-2.540009,2.540009,194,14,28,46,-18,18,-0.329545497894287,0.329545497894287,1,0,1,1,1,-1,0,0,385,3249,-2864,2864
Johny Hendricks,Robbie Lawler,Johny Hendricks,2014-03-15,1,0,-1,1,2.25,1.875,-5.080002,5.080002,15,-15,-12.70001,12.70001,248,0,26,46,-20,20,0.375,-0.375,0,1,0,1,-1,1,-1,1,119,385,-266,266
Jake Ellenberger,Robbie Lawler,Robbie Lawler,2014-05-24,0,1,-3,3,2.066667,1.875,-5.080002,5.080002,0,0,-7.62001,7.62001,46,70,46,46,0,0,0.191666603088379,-0.191666603088379,0,0,1,1,0,0,0,0,301,70,231,-231
Matt Brown,Robbie Lawler,Robbie Lawler,2014-07-26,0,1,1,-1,1.368421,1.875,2.540009,-2.540009,0,0,2.539993,-2.539993,70,237,45,46,-1,1,-0.506578922271729,0.506578922271729,8,1,0,1,7,-7,-1,1,77,63,14,-14
Johny Hendricks,Robbie Lawler,Robbie Lawler,2014-12-06,0,1,-1,1,2.25,1.875,-5.080002,5.080002,15,-15,-12.70001,12.70001,620,62,26,46,-20,20,0.375,-0.375,1,2,0,1,-1,1,-1,1,266,133,133,-133
Carlos Condit,Robbie Lawler,Robbie Lawler,2016-01-02,0,1,-2,2,2.285714,1.875,7.62001,-7.62001,0,0,2.539993,-2.539993,10,42,46,46,0,0,0.410714387893677,-0.410714387893677,0,3,1,1,-3,3,0,0,658,392,266,-266
Donald Cerrone,Robbie Lawler,Robbie Lawler,2017-07-29,0,1,-1,1,2.117647,1.875,5.080002,-5.080002,-15,15,-2.540009,2.540009,94,21,53,46,7,-7,0.242647171020508,-0.242647171020508,0,4,3,1,-4,4,2,-2,182,574,-392,392
Rafael Dos Anjos,Robbie Lawler,Rafael Dos Anjos,2017-12-16,1,0,-2,2,2.133333,1.875,-7.619995,7.619995,0,0,-10.16,10.16,473,264,47,46,1,-1,0.258333444595337,-0.258333444595337,2,5,1,1,-3,3,0,0,98,140,-42,42
Ben Askren,Robbie Lawler,Ben Askren,2019-03-02,1,0,-2,2,9.5,1.875,0,0,0,0,-2.540009,2.540009,119,33,21,46,-25,25,7.625,-7.625,0,0,0,1,0,0,-1,1,0,441,-441,441
Colby Covington,Robbie Lawler,Colby Covington,2019-08-03,1,0,-6,6,5.666667,1.875,0,0,0,0,-5.080002,5.080002,523,0,20,46,-26,26,3.79166650772095,-3.79166650772095,8,0,0,1,8,-8,-1,1,420,154,266,-266
Nick Diaz,Robbie Lawler,Robbie Lawler,2021-09-25,0,1,-1,1,2.6,1.875,5.080002,-5.080002,0,0,5.079987,-5.079987,0,14,36,46,-10,10,0.724999904632568,-0.724999904632568,0,0,0,1,0,0,-1,1,3115,784,2331,-2331
Bryan Barberena,Robbie Lawler,Bryan Barberena,2022-07-02,1,0,-7,7,1.636364,1.875,2.540009,-2.540009,0,0,-5.080002,5.080002,0,0,29,46,-17,17,-0.238636374473572,0.238636374473572,2,1,2,1,1,-1,1,-1,98,280,-182,182
Mike Lullo,Robert Peralta,Robert Peralta,2011-09-17,0,1,7,-7,2.666667,2.25,0,0,0,0,-7.339996,7.339996,287,38,11,26,-15,15,0.416666746139526,-0.416666746139526,0,0,0,0,0,0,0,0,0,0,0,0
Akira Corassani,Robert Peralta,Akira Corassani,2013-04-06,1,0,3,-3,2,2.25,0,0,0,0,-7.619995,7.619995,270,131,18,26,-8,8,-0.25,0.25,1,1,0,0,0,0,0,0,189,567,-378,378
Estevan Payan,Robert Peralta,Robert Peralta,2013-12-28,0,1,4,-4,1.333333,2.25,5.080002,-5.080002,0,0,-2.339996,2.339996,225,185,28,26,2,-2,-0.916666626930237,0.916666626930237,0,0,0,0,0,0,0,0,217,266,-49,49
Rony Jason,Robert Peralta,Robert Peralta,2014-05-31,0,1,2,-2,2,2.25,-2.540009,2.540009,0,0,5.080002,-5.080002,104,153,21,26,-5,5,-0.25,0.25,1,1,1,0,0,0,1,-1,69,154,-85,85
Clay Guida,Robert Peralta,Clay Guida,2015-04-04,1,0,4,-4,1.9,2.25,-2.540009,2.540009,10,-10,-2.539993,2.539993,671,0,58,26,32,-32,-0.350000023841858,0.350000023841858,1,2,1,0,-1,1,1,-1,358,308,50,-50
Joseph Morales,Robert Sanchez,Joseph Morales,2017-08-05,1,0,-9,9,4.5,4,0,0,0,0,7.619995,-7.619995,61,142,11,10,1,-1,0.5,-0.5,0,0,0,0,0,0,0,0,0,0,0,0
Jarred Brooks,Robert Sanchez,Jarred Brooks,2018-09-08,1,0,-7,7,6.5,4,-7.619995,7.619995,0,0,-10.16,10.16,498,283,15,10,5,-5,2.5,-2.5,0,0,1,0,0,0,1,-1,99,399,-300,300
Jimy Hettes,Robert Whiteford,Jimy Hettes,2013-10-26,1,0,-4,4,3.666667,3.5,0,0,0,0,5.080002,-5.080002,260,70,14,18,-4,4,0.166666746139526,-0.166666746139526,1,0,0,0,1,-1,0,0,666,0,666,-666
Daniel Pineda,Robert Whiteford,Robert Whiteford,2014-03-15,0,1,-2,2,1.866667,3.5,-5.080002,5.080002,0,0,0,0,70,465,43,18,25,-25,-1.63333332538605,1.63333332538605,2,0,0,0,2,-2,0,0,743,140,603,-603
Paul Redmond,Robert Whiteford,Robert Whiteford,2015-07-18,0,1,-4,4,1.714286,3.5,2.540009,-2.540009,0,0,4.740005,-4.740005,0,4,19,18,1,-1,-1.78571426868439,1.78571426868439,0,1,0,0,-1,1,0,0,0,490,-490,490
Darren Elkins,Robert Whiteford,Darren Elkins,2015-10-24,1,0,-1,1,2.454545,3.5,2.540009,-2.540009,0,0,5.080002,-5.080002,511,51,38,18,20,-20,-1.04545450210571,1.04545450210571,1,2,1,0,-1,1,1,-1,364,98,266,-266
Lucas Martins,Robert Whiteford,Lucas Martins,2016-04-10,1,0,-5,5,6.333333,3.5,7.62001,-7.62001,0,0,7.62001,-7.62001,0,96,22,18,4,-4,2.83333349227905,-2.83333349227905,1,0,0,0,1,-1,0,0,634,169,465,-465
Brad Scott,Robert Whittaker,Robert Whittaker,2012-12-14,0,1,2,-2,1.833333,3.571429,2.539993,-2.539993,-15,15,7.619995,-7.619995,255,22,17,32,-15,15,-1.73809516429901,1.73809516429901,0,0,0,0,0,0,0,0,0,0,0,0
Colton Smith,Robert Whittaker,Robert Whittaker,2013-05-25,0,1,3,-3,1.75,3.571429,0,0,-30,30,-5.080002,5.080002,3,14,11,32,-21,21,-1.82142853736877,1.82142853736877,0,1,0,0,-1,1,0,0,0,162,-162,162
Court McGee,Robert Whittaker,Court McGee,2013-08-28,1,0,6,-6,1.833333,3.571429,-2.540009,2.540009,-15,15,5.080002,-5.080002,34,0,34,32,2,-2,-1.73809516429901,1.73809516429901,1,2,0,0,-1,1,0,0,186,95,91,-91
Stephen Thompson,Robert Whittaker,Stephen Thompson,2014-02-22,1,0,8,-8,2.833333,3.571429,0,0,-15,15,5.080002,-5.080002,7,0,23,32,-9,9,-0.738095283508301,0.738095283508301,0,0,0,0,0,0,0,0,0,178,-178,178
Mike Rhodes,Robert Whittaker,Robert Whittaker,2014-06-28,0,1,1,-1,2,3.571429,2.539993,-2.539993,-15,15,2.540009,-2.540009,37,142,15,32,-17,17,-1.57142853736877,1.57142853736877,0,0,0,1,0,0,-1,1,154,126,28,-28
Clint Hester,Robert Whittaker,Robert Whittaker,2014-11-07,0,1,4,-4,1.833333,3.571429,5.080002,-5.080002,20,-20,10.16,-10.16,46,138,17,32,-15,15,-1.73809516429901,1.73809516429901,1,1,0,1,0,0,-1,1,573,132,441,-441
Brad Tavares,Robert Whittaker,Robert Whittaker,2015-05-09,0,1,3,-3,2.222222,3.571429,2.539993,-2.539993,0,0,2.540009,-2.540009,0,4,29,32,-3,3,-1.34920620918274,1.34920620918274,2,2,0,1,0,0,-1,1,952,183,769,-769
Uriah Hall,Robert Whittaker,Robert Whittaker,2015-11-14,0,1,7,-7,1.636364,3.571429,0,0,0,0,15.24001,-15.24001,50,283,29,32,-3,3,-1.93506491184235,1.93506491184235,1,3,0,1,-2,2,-1,1,49,189,-140,140
Rafael Natal,Robert Whittaker,Robert Whittaker,2016-04-23,0,1,8,-8,2.333333,3.571429,0,0,0,0,10.16,-10.16,0,2,30,32,-2,2,-1.2380952835083,1.2380952835083,4,4,0,1,0,0,-1,1,448,161,287,-287
Derek Brunson,Robert Whittaker,Robert Whittaker,2016-11-26,0,1,7,-7,2.555556,3.571429,2.539993,-2.539993,0,0,10.16,-10.16,72,7,32,32,0,0,-1.01587295532227,1.01587295532227,4,5,1,1,-1,1,0,0,70,217,-147,147
Jacare Souza,Robert Whittaker,Robert Whittaker,2017-04-15,0,1,11,-11,2.6,3.571429,2.539993,-2.539993,0,0,-2.539993,2.539993,49,25,36,32,4,-4,-0.971428632736206,0.971428632736206,0,6,0,1,-6,6,-1,1,0,140,-140,140
Yoel Romero,Robert Whittaker,Robert Whittaker,2017-07-08,0,1,14,-14,2.6,3.571429,0,0,0,0,0,0,315,94,18,32,-14,14,-0.971428632736206,0.971428632736206,4,7,0,1,-3,3,-1,1,238,84,154,-154
Yoel Romero,Robert Whittaker,Robert Whittaker,2018-06-09,0,1,14,-14,2.6,3.571429,0,0,0,0,0,0,261,37,18,32,-14,14,-0.971428632736206,0.971428632736206,0,8,0,1,-8,8,-1,1,336,336,0,0
Israel Adesanya,Robert Whittaker,Israel Adesanya,2019-10-05,1,0,2,-2,8,3.571429,10.15999,-10.15999,0,0,17.78,-17.78,4,0,27,32,-5,5,4.42857146263123,-4.42857146263123,6,9,0,1,-3,3,-1,1,175,483,-308,308
Darren Till,Robert Whittaker,Robert Whittaker,2020-07-25,0,1,-2,2,3.6,3.571429,0,0,0,0,2.540009,-2.540009,35,149,23,32,-9,9,2.85713672637939e-02,-2.85713672637939e-02,0,0,0,2,0,0,-2,2,686,294,392,-392
Jared Cannonier,Robert Whittaker,Robert Whittaker,2020-10-24,0,1,7,-7,2.833333,3.571429,-2.540009,2.540009,0,0,10.16,-10.16,30,130,23,32,-9,9,-0.738095283508301,0.738095283508301,2,1,2,2,1,-1,0,0,392,91,301,-301
Kelvin Gastelum,Robert Whittaker,Robert Whittaker,2021-04-17,0,1,-1,1,2.25,3.571429,-7.62001,7.62001,-15,15,-5.080002,5.080002,26,259,26,32,-6,6,-1.32142853736877,1.32142853736877,1,2,0,2,-1,1,-2,2,63,175,-112,112
Israel Adesanya,Robert Whittaker,Israel Adesanya,2022-02-12,1,0,1,-1,8,3.571429,10.15999,-10.15999,0,0,17.78,-17.78,0,220,27,32,-5,5,4.42857146263123,-4.42857146263123,1,3,0,2,-2,2,-2,2,245,301,-56,56
Marvin Vettori,Robert Whittaker,Robert Whittaker,2022-09-03,0,1,-3,3,2.714286,3.571429,0,0,0,0,2.540009,-2.540009,28,12,26,32,-6,6,-0.857142925262451,0.857142925262451,0,0,0,2,0,0,-2,2,0,203,-203,203
Dricus Du Plessis,Robert Whittaker,Dricus Du Plessis,2023-07-08,1,0,-3,3,10,3.571429,2.539993,-2.539993,0,0,7.619995,-7.619995,57,23,22,32,-10,10,6.42857146263123,-6.42857146263123,4,1,0,2,3,-3,-2,2,210,308,-98,98
Dave Berry,Roberto Traven,Roberto Traven,1996-09-20,0,1,,,0,1.5,-5.080002,5.080002,,,-0.1999969,0.1999969,0,0,1,10,-9,9,-1.5,1.5,0,0,0,0,0,0,0,0,0,0,0,0
Frank Mir,Roberto Traven,Frank Mir,2001-11-02,1,0,-11,11,1.636364,1.5,0,0,37,-37,7.660004,-7.660004,37,0,29,10,19,-19,0.136363625526428,-0.136363625526428,0,1,0,0,-1,1,0,0,0,1869,-1869,1869
Taylor Lapilus,Rocky Lee,Taylor Lapilus,2015-04-11,1,0,-5,5,6.333333,1.5,-7.619995,7.619995,-10,10,7.419998,-7.419998,121,225,22,5,17,-17,4.83333349227905,-4.83333349227905,0,0,0,0,0,0,0,0,0,0,0,0
Brian Stann,Rodney Wallace,Brian Stann,2009-12-05,1,0,1,-1,2,1.733333,10.16,-10.16,0,0,5.080002,-5.080002,281,359,18,41,-23,23,0.266666650772095,-0.266666650772095,0,0,0,0,0,0,0,0,0,0,0,0
Jared Hamman,Rodney Wallace,Jared Hamman,2010-03-27,1,0,0,0,2.333333,1.733333,15.24001,-15.24001,-20,20,7.619995,-7.619995,427,318,20,41,-21,21,0.599999904632568,-0.599999904632568,0,0,0,0,0,0,0,0,0,112,-112,112
Phil Davis,Rodney Wallace,Phil Davis,2010-08-07,1,0,-3,3,4.25,1.733333,12.70001,-12.70001,0,0,17.78,-17.78,684,0,21,41,-20,20,2.51666665077209,-2.51666665077209,2,0,0,0,2,-2,0,0,119,133,-14,14
Diego Rivas,Rodolfo Rubio Perez,Diego Rivas,2014-11-08,1,0,-5,5,5,0.625,7.619995,-7.619995,0,0,7.259995,-7.259995,407,193,12,26,-14,14,4.375,-4.375,0,0,0,0,0,0,0,0,0,0,0,0
Oskar Piechota,Rodolfo Vieira,Rodolfo Vieira,2019-08-10,0,1,0,0,3.666667,4.5,0,0,0,0,7.619995,-7.619995,0,330,14,11,3,-3,-0.833333253860474,0.833333253860474,2,0,0,0,2,-2,0,0,538,0,538,-538
Saparbeg Safarov,Rodolfo Vieira,Rodolfo Vieira,2020-03-07,0,1,3,-3,3,4.5,2.539993,-2.539993,0,0,12.7,-12.7,0,114,12,11,1,-1,-1.5,1.5,0,1,1,0,-1,1,1,-1,1184,210,974,-974
Anthony Hernandez,Rodolfo Vieira,Anthony Hernandez,2021-02-13,1,0,-4,4,5.5,4.5,0,0,0,0,5.080002,-5.080002,85,240,13,11,2,-2,1,-1,0,2,1,0,-2,2,1,-1,273,343,-70,70
Dustin Stoltzfus,Rodolfo Vieira,Rodolfo Vieira,2021-07-17,0,1,-2,2,2.8,4.5,0,0,0,0,5.080002,-5.080002,9,130,19,11,8,-8,-1.70000004768372,1.70000004768372,0,0,0,0,0,0,0,0,0,154,-154,154
Chris Curtis,Rodolfo Vieira,Chris Curtis,2022-06-25,1,0,2,-2,3,4.5,-5.080002,5.080002,0,0,5.080002,-5.080002,35,125,40,11,29,-29,-1.5,1.5,1,1,0,0,0,0,0,0,231,343,-112,112
Cody Brundage,Rodolfo Vieira,Rodolfo Vieira,2023-04-29,0,1,-5,5,1.8,4.5,0,0,0,0,-2.539993,2.539993,64,259,14,11,3,-3,-2.70000004768372,2.70000004768372,0,0,1,0,0,0,1,-1,133,308,-175,175
Antonio Carvalho,Rodrigo Damm,Antonio Carvalho,2012-11-17,1,0,1,-1,2.5,1.444444,5.080002,-5.080002,-10,10,-2.539993,2.539993,0,10,21,22,-1,1,1.05555558204651,-1.05555558204651,1,0,0,0,1,-1,0,0,119,0,119,-119
"Don'Tale Mayes",Rodrigo Nascimento,Rodrigo Nascimento,2020-05-16,0,1,1,-1,2,9,10.15999,-10.15999,14,-14,2.540009,-2.540009,93,143,15,10,5,-5,-7,7,0,0,0,0,0,0,0,0,0,0,0,0
Chris Daukaus,Rodrigo Nascimento,Chris Daukaus,2020-10-10,1,0,4,-4,1.714286,9,2.539993,-2.539993,-41,41,-10.16,10.16,24,0,19,10,9,-9,-7.28571426868439,7.28571426868439,1,1,0,0,0,0,0,0,56,147,-91,91
Tanner Boser,Rodrigo Nascimento,Rodrigo Nascimento,2022-09-17,0,1,2,-2,2.1,9,0,0,-41,41,-12.7,12.7,58,481,31,10,21,-21,-6.90000009536743,6.90000009536743,1,0,0,1,1,-1,-1,1,448,707,-259,259
Ilir Latifi,Rodrigo Nascimento,Rodrigo Nascimento,2023-05-20,0,1,10,-10,1.888889,9,-10.16,10.16,-16,16,-17.78,17.78,230,0,26,10,16,-16,-7.11111116409302,7.11111116409302,1,1,1,1,0,0,0,0,231,245,-14,14
Tony Fryklund,Rodrigo Ruas,Tony Fryklund,2002-06-22,1,0,7,-7,1.555556,0.8,5.080002,-5.080002,0,0,6,-6,415,4,23,9,14,-14,0.75555557012558,-0.75555557012558,0,0,0,0,0,0,0,0,1791,0,1791,-1791
Matt Hamill,Roger Hollett,Matt Hamill,2012-09-22,1,0,2,-2,1.5,2.6,5.080002,-5.080002,0,0,9.039993,-9.039993,362,0,20,18,2,-2,-1.09999990463257,1.09999990463257,0,0,0,0,0,0,0,0,483,0,483,-483
Jason Dent,Roger Huerta,Roger Huerta,2006-09-23,0,1,3,-3,1.692308,2.555556,2.540009,-2.540009,0,0,2.539993,-2.539993,15,650,35,32,3,-3,-0.863247871398926,0.863247871398926,0,0,0,0,0,0,0,0,0,0,0,0
John Halverson,Roger Huerta,Roger Huerta,2007-02-03,0,1,11,-11,2,2.555556,0,0,0,0,2.199997,-2.199997,0,12,24,32,-8,8,-0.555555582046509,0.555555582046509,0,1,0,0,-1,1,0,0,0,133,-133,133
Leonard Garcia,Roger Huerta,Roger Huerta,2007-04-07,0,1,4,-4,1.384615,2.555556,2.540009,-2.540009,-10,10,-5.080002,5.080002,65,608,31,32,-1,1,-1.17094016075134,1.17094016075134,0,2,0,0,-2,2,0,0,0,63,-63,63
Doug Evans,Roger Huerta,Roger Huerta,2007-06-23,0,1,2,-2,1.3,2.555556,0,0,0,0,0.1999969,-0.1999969,172,183,23,32,-9,9,-1.25555562973022,1.25555562973022,0,3,0,0,-3,3,0,0,0,77,-77,77
Alberto Crane,Roger Huerta,Roger Huerta,2007-08-25,0,1,7,-7,3,2.555556,-10.15999,10.15999,0,0,-9.800003,9.800003,225,392,20,32,-12,12,0.444444417953491,-0.444444417953491,0,4,0,0,-4,4,0,0,0,63,-63,63
Clay Guida,Roger Huerta,Roger Huerta,2007-12-08,0,1,2,-2,1.9,2.555556,-5.080002,5.080002,0,0,0,0,353,50,58,32,26,-26,-0.655555605888367,0.655555605888367,0,5,0,0,-5,5,0,0,317,105,212,-212
Kenny Florian,Roger Huerta,Kenny Florian,2008-08-09,1,0,7,-7,2.333333,2.555556,2.540009,-2.540009,-10,10,10.16,-10.16,147,78,20,32,-12,12,-0.222222328186035,0.222222328186035,4,6,1,0,-2,2,1,-1,129,245,-116,116
Patrick Cummins,Roger Narvaez,Patrick Cummins,2014-06-07,1,0,3,-3,1.428571,2.666667,-2.539993,2.539993,20,-20,-2.960007,2.960007,235,0,17,11,6,-6,-1.2380952835083,1.2380952835083,0,0,0,0,0,0,0,0,0,0,0,0
Luke Barnatt,Roger Narvaez,Roger Narvaez,2014-11-22,0,1,-5,5,3.25,2.666667,7.619995,-7.619995,0,0,-0.4199982,0.4199982,9,221,17,11,6,-6,0.583333253860474,-0.583333253860474,0,0,0,1,0,0,-1,1,175,168,7,-7
Shinsho Anzai,Roger Zapata,Shinsho Anzai,2015-09-26,1,0,0,0,3.333333,2,-10.16,10.16,0,0,-5.199997,5.199997,415,24,13,6,7,-7,1.33333325386047,-1.33333325386047,0,0,1,0,0,0,1,-1,399,0,399,-399
Luiz Cane,Rogerio Nogueira,Rogerio Nogueira,2009-11-21,0,1,-5,5,2.428571,2.3,0,0,-20,20,5.080002,-5.080002,0,2,24,33,-9,9,0.128571510314941,-0.128571510314941,3,0,0,0,3,-3,0,0,217,0,217,-217
Jason Brilz,Rogerio Nogueira,Rogerio Nogueira,2010-05-29,0,1,1,-1,3.666667,2.3,-7.62001,7.62001,0,0,-10.16,10.16,297,173,28,33,-5,5,1.36666679382324,-1.36666679382324,1,1,0,0,0,0,0,0,69,189,-120,120
Ryan Bader,Rogerio Nogueira,Ryan Bader,2010-09-25,1,0,-7,7,4.6,2.3,0,0,0,0,-2.539993,2.539993,223,6,28,33,-5,5,2.29999995231628,-2.29999995231628,4,2,0,0,2,-2,0,0,217,119,98,-98
Phil Davis,Rogerio Nogueira,Phil Davis,2011-03-26,1,0,-8,8,4.25,2.3,0,0,0,0,10.16,-10.16,369,0,21,33,-12,12,1.95000004768372,-1.95000004768372,3,0,0,0,3,-3,0,0,231,182,49,-49
Rashad Evans,Rogerio Nogueira,Rogerio Nogueira,2013-02-02,0,1,-3,3,2.375,2.3,-5.080002,5.080002,0,0,0,0,15,0,27,33,-6,6,7.50000476837158e-02,-7.50000476837158e-02,0,0,1,0,0,0,1,-1,287,679,-392,392
Anthony Johnson,Rogerio Nogueira,Anthony Johnson,2014-07-26,1,0,-8,8,3.666667,2.3,0,0,0,0,7.619995,-7.619995,1,0,28,33,-5,5,1.36666679382324,-1.36666679382324,0,1,0,0,-1,1,0,0,1708,539,1169,-1169
Patrick Cummins,Rogerio Nogueira,Rogerio Nogueira,2016-05-14,0,1,-4,4,1.428571,2.3,0,0,0,0,2.539993,-2.539993,11,12,17,33,-16,16,-0.871428489685059,0.871428489685059,0,0,2,1,0,0,1,-1,189,658,-469,469
Ryan Bader,Rogerio Nogueira,Ryan Bader,2016-11-19,1,0,-7,7,4.6,2.3,0,0,0,0,-2.539993,2.539993,680,0,28,33,-5,5,2.29999995231628,-2.29999995231628,1,1,3,1,0,0,2,-2,77,189,-112,112
Sam Alvey,Rogerio Nogueira,Rogerio Nogueira,2018-09-22,0,1,-10,10,1.833333,2.3,0,0,-20,20,0,0,0,3,51,33,18,-18,-0.466666579246521,0.466666579246521,2,0,1,2,2,-2,-1,1,113,672,-559,559
Alex Caceres,Roland Delorme,Alex Caceres,2013-09-21,1,0,-4,4,1.5,1.8,2.540009,-2.540009,10,-10,5.080002,-5.080002,264,103,35,14,21,-21,-0.299999952316284,0.299999952316284,2,0,0,0,2,-2,0,0,315,0,315,-315
Harold Howard,Roland Payne,Harold Howard,1994-09-09,1,0,,,0.3333333,0,12.70001,-12.70001,35,-35,14,-14,0,0,4,1,3,-3,0.333333343267441,-0.333333343267441,0,0,1,0,0,0,1,-1,0,0,0,0
Alex Caceres,Rolando Dy,Alex Caceres,2017-06-17,1,0,2,-2,1.5,1.285714,5.080002,-5.080002,0,0,10.16,-10.16,108,85,35,16,19,-19,0.214285731315613,-0.214285731315613,0,0,1,0,0,0,1,-1,140,0,140,-140
Jon Delos Reyes,"Roldan Sangcha'an",Jon Delos Reyes,2015-05-16,1,0,3,-3,1.6,2,5.080002,-5.080002,0,0,5.179993,-5.179993,260,135,13,6,7,-7,-0.399999976158142,0.399999976158142,0,0,1,0,0,0,1,-1,238,0,238,-238
Joey Beltran,Rolles Gracie,Joey Beltran,2010-02-06,1,0,-3,3,1.214286,2,-7.619995,7.619995,-57,57,-5.5,5.5,84,102,31,12,19,-19,-0.785714268684387,0.785714268684387,0,0,0,0,0,0,0,0,0,0,0,0
John Allan,Roman Dolidze,Roman Dolidze,2020-12-05,0,1,-5,5,1.857143,6,-2.540009,2.540009,20,-20,-2.539993,2.539993,15,436,20,14,6,-6,-4.14285719394684,4.14285719394684,0,0,0,0,0,0,0,0,0,0,0,0
Kyle Daukaus,Roman Dolidze,Roman Dolidze,2022-06-18,0,1,-4,4,2.75,6,2.539993,-2.539993,0,0,0,0,0,36,15,14,1,-1,-3.25,3.25,1,1,0,0,0,0,0,0,119,560,-441,441
Albert Duraev,Roman Kopylov,Albert Duraev,2021-10-30,1,0,2,-2,3.2,6,-2.540009,2.540009,0,0,0,0,333,25,21,14,7,-7,-2.79999995231628,2.79999995231628,0,0,0,0,0,0,0,0,0,0,0,0
Alessio Di Chirico,Roman Kopylov,Roman Kopylov,2022-09-03,0,1,1,-1,1.857143,6,0,0,0,0,-2.539993,2.539993,62,1,20,14,6,-6,-4.14285719394684,4.14285719394684,0,0,1,0,0,0,1,-1,371,308,63,-63
Josh Fremd,Roman Kopylov,Roman Kopylov,2023-09-16,0,1,-3,3,2.2,6,10.15999,-10.15999,0,0,2.539993,-2.539993,50,3,16,14,2,-2,-3.79999995231628,3.79999995231628,1,1,0,0,0,0,0,0,35,378,-343,343
Mitch Gagnon,Roman Salazar,Mitch Gagnon,2014-10-04,1,0,3,-3,2.4,1.666667,-5.079987,5.079987,0,0,-7.899994,7.899994,57,0,17,16,1,-1,0.733333468437195,-0.733333468437195,3,0,0,0,3,-3,0,0,171,0,171,-171
Uriah Hall,Ron Stallings,Uriah Hall,2015-01-18,1,0,-1,1,1.636364,1.75,-5.080002,5.080002,15,-15,10.16,-10.16,32,0,29,22,7,-7,-0.113636374473572,0.113636374473572,2,0,0,0,2,-2,0,0,197,0,197,-197
Justin Jones,Ron Stallings,Ron Stallings,2015-04-04,0,1,-5,5,4.5,1.75,-7.62001,7.62001,15,-15,-7.5,7.5,563,48,11,22,-11,11,2.75,-2.75,0,0,0,1,0,0,-1,1,0,76,-76,76
Joe Riggs,Ron Stallings,Joe Riggs,2015-09-05,1,0,0,0,2.588235,1.75,-5.080002,5.080002,15,-15,-12.7,12.7,239,26,61,22,39,-39,0.838235378265381,-0.838235378265381,0,1,1,1,-1,1,0,0,266,154,112,-112
Royce Gracie,Ron van Clief,Royce Gracie,1994-12-16,1,0,-23,23,7.5,0,7.619995,-7.619995,-15,15,14,-14,0,0,17,1,16,-16,7.5,-7.5,6,0,0,0,6,-6,0,0,0,0,0,0
Chris Condo,Ron Waterman,Ron Waterman,1999-05-07,0,1,,,0,2.666667,-5.080002,5.080002,55,-55,-5,5,0,0,1,22,-21,21,-2.66666674613953,2.66666674613953,0,0,0,0,0,0,0,0,0,0,0,0
Andre Roberts,Ron Waterman,Andre Roberts,1999-07-16,1,0,1,-1,7,2.666667,0,0,65,-65,0,0,28,28,16,22,-6,6,4.33333325386047,-4.33333325386047,0,1,0,0,-1,1,0,0,0,70,-70,70
Satoshi Honma,Ron Waterman,Ron Waterman,2000-04-14,0,1,-3,3,0.6666667,2.666667,-2.540009,2.540009,-75,75,-2,2,0,717,10,22,-12,12,-2.00000005960464,2.00000005960464,0,0,0,1,0,0,-1,1,0,273,-273,273
Liz Carmouche,Ronda Rousey,Ronda Rousey,2013-02-23,0,1,3,-3,1.857143,6,-2.539993,2.539993,-10,10,0,0,52,227,20,14,6,-6,-4.14285719394684,4.14285719394684,0,0,0,0,0,0,0,0,0,0,0,0
Sara McMann,Ronda Rousey,Ronda Rousey,2014-02-22,0,1,6,-6,2.166667,6,-2.539993,2.539993,0,0,0,0,0,44,19,14,5,-5,-3.83333325386047,3.83333325386047,0,1,0,0,-1,1,0,0,0,364,-364,364
Alexis Davis,Ronda Rousey,Ronda Rousey,2014-07-05,0,1,2,-2,1.909091,6,-2.539993,2.539993,0,0,5.080002,-5.080002,0,4,32,14,18,-18,-4.09090912342072,4.09090912342072,2,2,0,0,0,0,0,0,133,133,0,0
Bethe Correia,Ronda Rousey,Ronda Rousey,2015-08-01,0,1,4,-4,1.833333,6,-5.079987,5.079987,0,0,-5.080002,5.080002,0,4,17,14,3,-3,-4.16666662693024,4.16666662693024,2,3,0,0,-1,1,0,0,462,392,70,-70
Holly Holm,Ronda Rousey,Holly Holm,2015-11-14,1,0,6,-6,2.142857,6,2.540009,-2.540009,0,0,7.619995,-7.619995,15,4,22,14,8,-8,-3.85714292526245,3.85714292526245,2,4,0,0,-2,2,0,0,122,105,17,-17
Amanda Nunes,Ronda Rousey,Amanda Nunes,2016-12-30,1,0,-1,1,4.6,6,2.540009,-2.540009,0,0,7.619995,-7.619995,0,0,28,14,14,-14,-1.40000009536743,1.40000009536743,2,0,1,1,2,-2,0,0,174,412,-238,238
Vince Cachero,Ronnie Lawrence,Ronnie Lawrence,2021-02-27,0,1,3,-3,1.75,4,-5.080002,5.080002,10,-10,0,0,36,469,11,10,1,-1,-2.25,2.25,0,0,0,0,0,0,0,0,210,0,210,-210
Saidyokub Kakhramonov,Ronnie Lawrence,Saidyokub Kakhramonov,2022-07-09,1,0,-4,4,3.333333,4,0,0,0,0,2.539993,-2.539993,739,4,13,10,3,-3,-0.666666746139526,0.666666746139526,0,1,0,0,-1,1,0,0,0,497,-497,497
Andrew Craig,Ronny Markes,Ronny Markes,2013-01-19,0,1,3,-3,2.25,3.4,0,0,-15,15,2.539993,-2.539993,179,529,13,22,-9,9,-1.15000009536743,1.15000009536743,2,0,0,0,2,-2,0,0,192,0,192,-192
Dennis Bermudez,Rony Jason,Dennis Bermudez,2016-08-06,1,0,-3,3,1.888889,2,-2.539993,2.539993,10,-10,-17.78,17.78,426,52,26,21,5,-5,-0.111111164093018,0.111111164093018,1,0,1,0,1,-1,1,-1,167,0,167,-167
Melvin Guillard,Ronys Torres,Melvin Guillard,2010-02-06,1,0,-8,8,1.777778,7,5.080002,-5.080002,0,0,7.339996,-7.339996,96,343,50,40,10,-10,-5.22222220897675,5.22222220897675,2,0,0,0,2,-2,0,0,231,0,231,-231
Darrell Horcher,Roosevelt Roberts,Roosevelt Roberts,2018-11-30,0,1,7,-7,3.25,3.333333,-10.16,10.16,0,0,-7.619995,7.619995,56,5,17,13,4,-4,-8.33332538604736e-02,8.33332538604736e-02,1,0,1,0,1,-1,1,-1,523,0,523,-523
Thomas Gifford,Roosevelt Roberts,Roosevelt Roberts,2019-04-27,0,1,1,-1,1.555556,3.333333,-2.540009,2.540009,0,0,5.080002,-5.080002,101,551,23,13,10,-10,-1.77777767181396,1.77777767181396,0,1,0,0,-1,1,0,0,0,148,-148,148
Vinc Pichel,Roosevelt Roberts,Vinc Pichel,2019-06-29,1,0,11,-11,4.666667,3.333333,-10.16,10.16,0,0,-2.539993,2.539993,361,155,17,13,4,-4,1.33333325386047,-1.33333325386047,2,2,0,0,0,0,0,0,518,63,455,-455
Jim Miller,Roosevelt Roberts,Jim Miller,2020-06-20,1,0,10,-10,2.117647,3.333333,-15.24001,15.24001,0,0,-5.080002,5.080002,108,26,53,13,40,-40,-1.21568608283997,1.21568608283997,0,0,0,0,0,0,0,0,553,357,196,-196
Ignacio Bahamondes,Roosevelt Roberts,Ignacio Bahamondes,2021-08-21,1,0,-4,4,2.8,3.333333,2.539993,-2.539993,0,0,5.080002,-5.080002,98,104,19,13,6,-6,-0.533333301544189,0.533333301544189,0,0,0,0,0,0,0,0,133,427,-294,294
Mike Guymon,Rory MacDonald,Rory MacDonald,2010-01-11,0,1,15,-15,2.5,4.75,0,0,0,0,-5.079987,5.079987,8,170,21,23,-2,2,-2.25,2.25,0,0,0,0,0,0,0,0,0,0,0,0
Carlos Condit,Rory MacDonald,Carlos Condit,2010-06-12,1,0,6,-6,2.285714,4.75,5.080002,-5.080002,0,0,-2.539993,2.539993,247,228,46,23,23,-23,-2.46428561210632,2.46428561210632,1,1,0,0,0,0,0,0,269,152,117,-117
Nate Diaz,Rory MacDonald,Rory MacDonald,2011-04-30,0,1,5,-5,1.692308,4.75,0,0,0,0,0,0,149,315,35,23,12,-12,-3.05769228935242,3.05769228935242,0,0,0,1,0,0,-1,1,119,322,-203,203
Jake Ellenberger,Rory MacDonald,Rory MacDonald,2013-07-27,0,1,4,-4,2.066667,4.75,-7.62001,7.62001,0,0,-12.7,12.7,63,0,46,23,23,-23,-2.68333339691162,2.68333339691162,2,1,1,1,1,-1,0,0,133,819,-686,686
Robbie Lawler,Rory MacDonald,Robbie Lawler,2013-11-16,1,0,7,-7,1.875,4.75,-2.540009,2.540009,0,0,-5.079987,5.079987,141,185,46,23,23,-23,-2.875,2.875,1,2,0,1,-1,1,-1,1,112,112,0,0
Robbie Lawler,Rory MacDonald,Robbie Lawler,2015-07-11,1,0,8,-8,1.875,4.75,-2.540009,2.540009,0,0,-5.079987,5.079987,11,2,46,23,23,-23,-2.875,2.875,2,0,0,1,2,-2,-1,1,602,602,0,0
Brodie Farber,Rory Markham,Rory Markham,2008-07-19,0,1,2,-2,2.285714,2.833333,2.539993,-2.539993,0,0,7.660004,-7.660004,3,1,23,23,0,0,-0.547618865966797,0.547618865966797,0,0,0,0,0,0,0,0,0,0,0,0
Dan Hardy,Rory Markham,Dan Hardy,2009-02-21,1,0,0,0,2.5,2.833333,0,0,0,0,7.62001,-7.62001,2,0,35,23,12,-12,-0.333333253860474,0.333333253860474,0,1,0,0,-1,1,0,0,0,217,-217,217
Nate Diaz,Rory Markham,Nate Diaz,2010-03-27,1,0,-4,4,1.692308,2.833333,0,0,0,0,12.7,-12.7,74,0,35,23,12,-12,-1.14102554321289,1.14102554321289,0,0,0,1,0,0,-1,1,75,399,-324,324
Ross Pointon,Rory Singer,Rory Singer,2006-06-24,0,1,-4,4,0.3529412,1.222222,-15.24001,15.24001,-15,15,-20.58,20.58,20,0,23,20,3,-3,-0.869281023740768,0.869281023740768,0,0,0,0,0,0,0,0,0,0,0,0
Josh Haynes,Rory Singer,Rory Singer,2006-10-10,0,1,-1,1,1.272727,1.222222,-12.70001,12.70001,-15,15,-17.58,17.58,174,76,25,20,5,-5,5.05050420761108e-02,-5.05050420761108e-02,0,1,0,0,-1,1,0,0,0,108,-108,108
Yushin Okami,Rory Singer,Yushin Okami,2006-12-30,1,0,-5,5,2.833333,1.222222,0,0,-15,15,-5.080002,5.080002,408,30,46,20,26,-26,1.61111104488373,-1.61111104488373,1,2,0,0,-1,1,0,0,77,81,-4,4
Jason MacDonald,Rory Singer,Jason MacDonald,2007-06-16,1,0,1,-1,1.5625,1.222222,2.539993,-2.539993,0,0,7.619995,-7.619995,379,48,41,20,21,-21,0.340277791023254,-0.340277791023254,0,0,0,1,0,0,-1,1,0,168,-168,168
Carla Esparza,Rose Namajunas,Carla Esparza,2014-12-12,1,0,5,-5,2.857143,2,-10.16,10.16,-10,10,-5.080002,5.080002,302,24,27,18,9,-9,0.857142925262451,-0.857142925262451,0,0,0,0,0,0,0,0,0,0,0,0
Angela Hill,Rose Namajunas,Rose Namajunas,2015-10-03,0,1,7,-7,1.153846,2,-5.080002,5.080002,-10,10,-2.540009,2.540009,11,71,28,18,10,-10,-0.846153855323792,0.846153855323792,0,0,0,0,0,0,0,0,112,295,-183,183
Karolina Kowalkiewicz,Rose Namajunas,Karolina Kowalkiewicz,2016-07-30,1,0,6,-6,2.142857,2,-5.080002,5.080002,-10,10,-2.540009,2.540009,138,146,22,18,4,-4,0.142857074737549,-0.142857074737549,1,1,0,0,0,0,0,0,224,301,-77,77
Joanna Jedrzejczyk,Rose Namajunas,Rose Namajunas,2017-11-04,0,1,5,-5,3.2,2,2.539993,-2.539993,-10,10,0,0,0,26,21,18,3,-3,1.20000004768372,-1.20000004768372,4,0,0,0,4,-4,0,0,357,462,-105,105
Joanna Jedrzejczyk,Rose Namajunas,Rose Namajunas,2018-04-07,0,1,5,-5,3.2,2,2.539993,-2.539993,-10,10,0,0,0,56,21,18,3,-3,1.20000004768372,-1.20000004768372,0,1,1,0,-1,1,1,-1,154,154,0,0
Jessica Andrade,Rose Namajunas,Jessica Andrade,2019-05-11,1,0,1,-1,2,2,-10.16,10.16,-10,10,-7.62001,7.62001,38,29,36,18,18,-18,0,0,3,2,1,0,1,-1,1,-1,245,399,-154,154
Jessica Andrade,Rose Namajunas,Rose Namajunas,2020-07-11,0,1,0,0,2,2,-10.16,10.16,-10,10,-7.62001,7.62001,29,0,36,18,18,-18,0,0,0,0,2,1,0,0,1,-1,315,427,-112,112
Carla Esparza,Rose Namajunas,Carla Esparza,2022-05-07,1,0,5,-5,2.857143,2,-10.16,10.16,-10,10,-5.080002,5.080002,22,10,27,18,9,-9,0.857142925262451,-0.857142925262451,5,1,2,1,4,-4,1,-1,350,665,-315,315
Manon Fiorot,Rose Namajunas,Manon Fiorot,2023-09-02,1,0,2,-2,11,2,5.079987,-5.079987,0,0,0,0,24,25,12,18,-6,6,9,-9,3,0,0,1,3,-3,-1,1,525,483,42,-42
Alexis Davis,Rosi Sexton,Alexis Davis,2013-06-15,1,0,-7,7,1.909091,2.6,7.619995,-7.619995,0,0,9.720001,-9.720001,405,363,32,18,14,-14,-0.690909028053284,0.690909028053284,0,0,0,0,0,0,0,0,0,0,0,0
Jessica Andrade,Rosi Sexton,Jessica Andrade,2013-10-26,1,0,-14,14,2,2.6,-5.080002,5.080002,-20,20,-5.520004,5.520004,102,34,36,18,18,-18,-0.599999904632568,0.599999904632568,0,0,1,0,0,0,1,-1,91,133,-42,42
Cole Miller,Ross Pearson,Cole Miller,2010-09-15,1,0,1,-1,1.909091,1.25,12.7,-12.7,-10,10,10.16,-10.16,39,20,32,36,-4,4,0.659090876579285,-0.659090876579285,0,0,1,0,0,0,1,-1,966,0,966,-966
Spencer Fisher,Ross Pearson,Ross Pearson,2011-02-26,0,1,8,-8,2.666667,1.25,-2.540009,2.540009,0,0,-2.539993,2.539993,32,116,33,36,-3,3,1.41666674613953,-1.41666674613953,1,0,2,0,1,-1,2,-2,133,164,-31,31
Edson Barboza,Ross Pearson,Edson Barboza,2011-08-27,1,0,-1,1,2.090909,1.25,7.619995,-7.619995,-10,10,15.24001,-15.24001,1,39,34,36,-2,2,0.840909004211426,-0.840909004211426,2,1,0,0,1,-1,0,0,161,182,-21,21
Junior Assuncao,Ross Pearson,Ross Pearson,2011-12-30,0,1,3,-3,2.666667,1.25,2.539993,-2.539993,-10,10,7.62001,-7.62001,339,116,22,36,-14,14,1.41666674613953,-1.41666674613953,1,0,0,0,1,-1,0,0,97,125,-28,28
Ryan Couture,Ross Pearson,Ross Pearson,2013-04-06,0,1,2,-2,2.2,1.25,5.080002,-5.080002,0,0,10.16,-10.16,188,10,16,36,-20,20,0.950000047683716,-0.950000047683716,0,1,0,0,-1,1,0,0,0,463,-463,463
Gray Maynard,Ross Pearson,Ross Pearson,2014-08-16,0,1,6,-6,1.857143,1.25,2.539993,-2.539993,0,0,2.540009,-2.540009,73,8,20,36,-16,16,0.607142806053162,-0.607142806053162,3,2,0,0,1,-1,0,0,1988,497,1491,-1491
Al Iaquinta,Ross Pearson,Al Iaquinta,2014-11-07,1,0,-3,3,2,1.25,5.080002,-5.080002,0,0,2.540009,-2.540009,3,0,21,36,-15,15,0.75,-0.75,1,3,0,0,-2,2,0,0,279,83,196,-196
Evan Dunham,Ross Pearson,Evan Dunham,2015-07-18,1,0,3,-3,2,1.25,5.080002,-5.080002,0,0,2.540009,-2.540009,660,10,27,36,-9,9,0.75,-0.75,1,0,1,1,1,-1,0,0,896,253,643,-643
Paul Felder,Ross Pearson,Ross Pearson,2015-09-05,0,1,1,-1,2.833333,1.25,7.619995,-7.619995,0,0,2.540009,-2.540009,117,183,23,36,-13,13,1.58333325386047,-1.58333325386047,1,0,0,1,1,-1,-1,1,336,49,287,-287
Chad Laprise,Ross Pearson,Ross Pearson,2016-03-19,0,1,-2,2,3.25,1.25,5.080002,-5.080002,15,-15,5.080002,-5.080002,1,0,17,36,-19,19,2,-2,0,1,1,1,-1,1,0,0,209,196,13,-13
Will Brooks,Ross Pearson,Will Brooks,2016-07-08,1,0,-2,2,4.5,1.25,5.080002,-5.080002,0,0,7.62001,-7.62001,273,127,22,36,-14,14,3.25,-3.25,0,2,0,1,-2,2,-1,1,0,111,-111,111
Jorge Masvidal,Ross Pearson,Jorge Masvidal,2016-07-30,1,0,0,0,2.058824,1.25,7.619995,-7.619995,15,-15,12.70001,-12.70001,36,30,52,36,16,-16,0.808823585510254,-0.808823585510254,1,0,0,1,1,-1,-1,1,1197,22,1175,-1175
Dan Hooker,Ross Pearson,Dan Hooker,2017-06-10,1,0,-5,5,1.916667,1.25,10.16,-10.16,0,0,15.24001,-15.24001,1,2,35,36,-1,1,0.666666626930237,-0.666666626930237,0,0,0,1,0,0,-1,1,196,315,-119,119
Mizuto Hirota,Ross Pearson,Ross Pearson,2018-02-10,0,1,3,-3,1.8,1.25,-2.540009,2.540009,0,0,-5.080002,5.080002,6,0,28,36,-8,8,0.549999952316284,-0.549999952316284,0,0,0,2,0,0,-2,2,245,245,0,0
John Makdessi,Ross Pearson,John Makdessi,2018-07-28,1,0,0,0,2,1.25,0,0,0,0,-2.539993,2.539993,0,18,27,36,-9,9,0.75,-0.75,1,1,1,2,0,0,-1,1,224,168,56,-56
Desmond Green,Ross Pearson,Desmond Green,2019-03-30,1,0,-5,5,2.875,1.25,5.080002,-5.080002,0,0,10.16,-10.16,8,0,31,36,-5,5,1.625,-1.625,0,0,0,2,0,0,-2,2,196,245,-49,49
Rich Clementi,Ross Pointon,Rich Clementi,2007-01-25,1,0,4,-4,1.956522,0.3529412,2.539993,-2.539993,-15,15,7.880005,-7.880005,43,0,68,23,45,-45,1.60358056426048,-1.60358056426048,0,0,0,0,0,0,0,0,75,0,75,-75
Dan Henderson,Rousimar Palhares,Dan Henderson,2008-09-06,1,0,10,-10,2.133333,2.375,7.619995,-7.619995,15,-15,7.62001,-7.62001,147,88,47,27,20,-20,-0.241666555404663,0.241666555404663,0,0,0,0,0,0,0,0,189,0,189,-189
Jeremy Horn,Rousimar Palhares,Rousimar Palhares,2009-01-17,0,1,5,-5,4.136364,2.375,12.7,-12.7,15,-15,7.62001,-7.62001,57,663,113,27,86,-86,1.76136350631714,-1.76136350631714,0,0,1,0,0,0,1,-1,210,133,77,-77
Lucio Linhares,Rousimar Palhares,Rousimar Palhares,2009-12-12,0,1,7,-7,2.375,2.375,15.24001,-15.24001,15,-15,7.660004,-7.660004,111,245,27,27,0,0,0,0,0,1,0,0,-1,1,0,0,0,329,-329,329
Tomasz Drwal,Rousimar Palhares,Rousimar Palhares,2010-03-27,0,1,-2,2,4.2,2.375,12.7,-12.7,35,-35,12.7,-12.7,0,7,26,27,-1,1,1.82499980926514,-1.82499980926514,2,2,1,0,0,0,1,-1,189,105,84,-84
Nate Marquardt,Rousimar Palhares,Nate Marquardt,2010-09-15,1,0,1,-1,1.842105,2.375,10.16,-10.16,15,-15,7.62001,-7.62001,17,27,54,27,27,-27,-0.532894730567932,0.532894730567932,0,3,1,0,-3,3,1,-1,221,172,49,-49
David Branch,Rousimar Palhares,Rousimar Palhares,2011-03-03,0,1,-2,2,3.666667,2.375,12.7,-12.7,15,-15,17.78,-17.78,199,26,28,27,1,-1,1.29166674613953,-1.29166674613953,1,0,1,1,1,-1,0,0,169,169,0,0
Dan Miller,Rousimar Palhares,Rousimar Palhares,2011-08-27,0,1,-1,1,1.75,2.375,12.7,-12.7,15,-15,7.62001,-7.62001,38,323,22,27,-5,5,-0.625,0.625,1,1,0,1,0,0,-1,1,364,177,187,-187
Mike Massenzio,Rousimar Palhares,Rousimar Palhares,2012-01-14,0,1,-2,2,1.444444,2.375,15.24001,-15.24001,15,-15,5.080002,-5.080002,2,1,22,27,-5,5,-0.930555582046509,0.930555582046509,0,2,0,1,-2,2,-1,1,217,140,77,-77
Alan Belcher,Rousimar Palhares,Alan Belcher,2012-05-05,1,0,-4,4,2.25,2.375,15.24001,-15.24001,15,-15,10.16,-10.16,134,7,26,27,-1,1,-0.125,0.125,5,3,1,1,2,-2,0,0,231,112,119,-119
Hector Lombard,Rousimar Palhares,Hector Lombard,2012-12-14,1,0,2,-2,3.4,2.375,2.539993,-2.539993,15,-15,0,0,45,0,44,27,17,-17,1.02500009536743,-1.02500009536743,0,0,0,2,0,0,-2,2,0,223,-223,223
Barb Honchak,Roxanne Modafferi,Roxanne Modafferi,2018-07-06,0,1,3,-3,2.5,1.190476,-7.619995,7.619995,0,0,-10.15999,10.15999,0,324,14,46,-32,32,1.30952382087708,-1.30952382087708,0,0,0,0,0,0,0,0,217,0,217,-217
Sijara Eubanks,Roxanne Modafferi,Sijara Eubanks,2018-11-03,1,0,-3,3,1.142857,1.190476,-7.619995,7.619995,0,0,-5.080002,5.080002,358,158,15,46,-31,31,-4.76189851760864e-02,4.76189851760864e-02,1,1,0,0,0,0,0,0,155,120,35,-35
Jennifer Maia,Roxanne Modafferi,Jennifer Maia,2019-07-20,1,0,-6,6,2.333333,1.190476,-7.619995,7.619995,0,0,-12.7,12.7,199,212,30,46,-16,16,1.14285707473755,-1.14285707473755,0,0,0,0,0,0,0,0,0,259,-259,259
Maycee Barber,Roxanne Modafferi,Roxanne Modafferi,2020-01-18,0,1,-16,16,6.5,1.190476,-5.079987,5.079987,0,0,-10.15999,10.15999,136,630,15,46,-31,31,5.30952382087708,-5.30952382087708,2,0,0,0,2,-2,0,0,92,182,-90,90
Andrea Lee,Roxanne Modafferi,Roxanne Modafferi,2020-09-12,0,1,-6,6,1.625,1.190476,-2.539993,2.539993,0,0,0,0,97,289,21,46,-25,25,0.434523820877075,-0.434523820877075,0,1,0,0,-1,1,0,0,217,238,-21,21
Viviane Araujo,Roxanne Modafferi,Viviane Araujo,2021-01-20,1,0,-4,4,2.2,1.190476,-7.619995,7.619995,0,0,-2.539993,2.539993,186,39,16,46,-30,30,1.00952386856079,-1.00952386856079,1,2,0,0,-1,1,0,0,137,130,7,-7
Junior Dos Santos,Roy Nelson,Junior Dos Santos,2010-08-07,1,0,-8,8,2.333333,1.571429,10.15999,-10.15999,-25,25,10.16,-10.16,20,90,30,36,-6,6,0.761904716491699,-0.761904716491699,5,0,0,0,5,-5,0,0,139,0,139,-139
Frank Mir,Roy Nelson,Frank Mir,2011-05-28,1,0,-2,2,1.636364,1.571429,7.619995,-7.619995,1,-1,15.24001,-15.24001,444,240,29,36,-7,7,6.49350881576538e-02,-6.49350881576538e-02,1,0,1,0,1,-1,1,-1,882,294,588,-588
Mirko Filipovic,Roy Nelson,Roy Nelson,2011-10-29,0,1,2,-2,3.181818,1.571429,5.080002,-5.080002,-33,33,0,0,26,255,46,36,10,-10,1.61038970947266,-1.61038970947266,0,0,3,0,0,0,3,-3,224,154,70,-70
Dave Herman,Roy Nelson,Roy Nelson,2012-05-26,0,1,-8,8,3.666667,1.571429,10.15999,-10.15999,-21,21,10.16,-10.16,0,2,28,36,-8,8,2.09523820877075,-2.09523820877075,0,1,1,0,-1,1,1,-1,101,210,-109,109
Matt Mitrione,Roy Nelson,Roy Nelson,2012-12-15,0,1,-2,2,2.4,1.571429,7.619995,-7.619995,2,-2,22.86,-22.86,20,48,17,36,-19,19,0.828571557998657,-0.828571557998657,1,2,0,0,-1,1,0,0,538,203,335,-335
Cheick Kongo,Roy Nelson,Roy Nelson,2013-04-27,0,1,1,-1,2.7,1.571429,10.15999,-10.15999,-23,23,22.86,-22.86,0,71,37,36,1,-1,1.12857151031494,-1.12857151031494,1,3,0,0,-2,2,0,0,546,133,413,-413
Stipe Miocic,Roy Nelson,Stipe Miocic,2013-06-15,1,0,-6,6,5,1.571429,10.15999,-10.15999,-23,23,17.78,-17.78,125,21,24,36,-12,12,3.42857146263123,-3.42857146263123,0,4,1,0,-4,4,1,-1,259,49,210,-210
Daniel Cormier,Roy Nelson,Daniel Cormier,2013-10-19,1,0,-3,3,7.333333,1.571429,-2.540009,2.540009,-28,28,-2.539993,2.539993,232,1,25,36,-11,11,5.76190495491028,-5.76190495491028,1,0,0,0,1,-1,0,0,182,126,56,-56
Mark Hunt,Roy Nelson,Mark Hunt,2014-09-20,1,0,2,-2,0.9285714,1.571429,-5.080002,5.080002,2,-2,-2.539993,2.539993,2,19,27,36,-9,9,-0.642857134342194,0.642857134342194,4,0,0,0,4,-4,0,0,567,336,231,-231
Josh Barnett,Roy Nelson,Josh Barnett,2015-09-26,1,0,-2,2,4.375,1.571429,7.619995,-7.619995,-13,13,12.7,-12.7,502,472,43,36,7,-7,2.80357146263123,-2.80357146263123,0,0,2,1,0,0,1,-1,637,371,266,-266
Derrick Lewis,Roy Nelson,Derrick Lewis,2016-07-07,1,0,-9,9,2.454545,1.571429,7.619995,-7.619995,-3,3,15.24001,-15.24001,2,581,38,36,2,-2,0.883116960525513,-0.883116960525513,2,0,1,1,2,-2,0,0,278,285,-7,7
Jason DeLucia,Royce Gracie,Royce Gracie,1994-03-11,0,1,-3,3,1.571429,7.5,-5.080002,5.080002,15,-15,-11,11,0,0,54,17,37,-37,-5.92857146263123,5.92857146263123,0,0,0,0,0,0,0,0,0,0,0,0
Dave Galera,Royston Wee,Royston Wee,2014-01-04,0,1,8,-8,5,4,10.16,-10.16,0,0,12.82001,-12.82001,5,835,6,5,1,-1,1,-1,0,0,0,0,0,0,0,0,0,0,0,0
Guangyou Ning,Royston Wee,Guangyou Ning,2015-05-16,1,0,5,-5,1.25,4,-7.619995,7.619995,10,-10,-7.619995,7.619995,191,0,9,5,4,-4,-2.75,2.75,1,1,0,0,0,0,0,0,266,497,-231,231
Soa Palelei,Ruan Potts,Soa Palelei,2014-05-10,1,0,0,0,4.4,1.833333,5.079987,-5.079987,18,-18,15.24001,-15.24001,101,6,27,17,10,-10,2.56666672229767,-2.56666672229767,0,0,1,0,0,0,1,-1,2324,0,2324,-2324
Anthony Hamilton,Ruan Potts,Anthony Hamilton,2014-08-30,1,0,-2,2,1.666667,1.833333,7.619995,-7.619995,13,-13,2.539993,-2.539993,350,1,24,17,7,-7,-0.166666746139526,0.166666746139526,0,0,0,1,0,0,-1,1,63,112,-49,49
Derrick Lewis,Ruan Potts,Derrick Lewis,2015-02-28,1,0,-7,7,2.454545,1.833333,2.539993,-2.539993,13,-13,10.16,-10.16,248,100,38,17,21,-21,0.621212124824524,-0.621212124824524,0,0,1,2,0,0,-1,1,176,182,-6,6
Josh Copeland,Ruslan Magomedov,Ruslan Magomedov,2014-11-22,0,1,5,-5,3,14,-5.080002,5.080002,23,-23,-10.12,10.12,10,87,16,15,1,-1,-11,11,0,0,0,0,0,0,0,0,0,0,0,0
Shawn Jordan,Ruslan Magomedov,Ruslan Magomedov,2015-10-03,0,1,2,-2,2.375,14,-7.619995,7.619995,18,-18,-7.619995,7.619995,295,77,27,15,12,-12,-11.625,11.625,2,1,1,0,1,-1,1,-1,119,315,-196,196
Marcus Brimage,Russell Doane,Russell Doane,2014-07-05,0,1,2,-2,1,1.875,-7.619995,7.619995,0,0,2.539993,-2.539993,31,278,14,23,-9,9,-0.875,0.875,0,0,1,0,0,0,1,-1,455,0,455,-455
Iuri Alcantara,Russell Doane,Iuri Alcantara,2014-09-13,1,0,6,-6,3.5,1.875,5.080002,-5.080002,0,0,2.539993,-2.539993,130,518,45,23,22,-22,1.625,-1.625,2,1,0,0,1,-1,0,0,105,70,35,-35
Mirsad Bektic,Russell Doane,Mirsad Bektic,2016-10-08,1,0,-5,5,3.25,1.875,2.540009,-2.540009,10,-10,0,0,201,0,17,23,-6,6,1.375,-1.375,3,0,0,0,3,-3,0,0,497,756,-259,259
Benson Henderson,Rustam Khabilov,Benson Henderson,2014-06-07,1,0,3,-3,3.428571,6,2.539993,-2.539993,15,-15,-7.619995,7.619995,173,178,31,28,3,-3,-2.57142853736877,2.57142853736877,1,0,0,0,1,-1,0,0,133,0,133,-133
Desmond Green,Rustam Khabilov,Rustam Khabilov,2017-09-02,0,1,-3,3,2.875,6,5.080002,-5.080002,0,0,0,0,20,65,31,28,3,-3,-3.125,3.125,0,0,0,0,0,0,0,0,0,1183,-1183,1183
Kajan Johnson,Rustam Khabilov,Rustam Khabilov,2018-09-15,0,1,3,-3,1.769231,6,7.619995,-7.619995,0,0,5.080002,-5.080002,0,250,36,28,8,-8,-4.23076927661896,4.23076927661896,0,1,0,0,-1,1,0,0,49,378,-329,329
Diego Ferreira,Rustam Khabilov,Diego Ferreira,2019-02-23,1,0,2,-2,3.6,6,2.539993,-2.539993,0,0,2.540009,-2.540009,13,62,23,28,-5,5,-2.40000009536743,2.40000009536743,2,2,1,0,0,0,1,-1,77,161,-84,84
Zarrukh Adashev,Ryan Benoit,Zarrukh Adashev,2021-07-31,1,0,-2,2,1,1.25,0,0,0,0,-7.619995,7.619995,45,79,8,18,-10,10,-0.25,0.25,0,0,1,0,0,0,1,-1,413,0,413,-413
Darren Elkins,Ryan Hall,Ryan Hall,2019-07-13,0,1,1,-1,2.454545,4.5,0,0,0,0,2.539993,-2.539993,110,7,38,11,27,-27,-2.04545450210571,2.04545450210571,0,0,2,0,0,0,2,-2,238,0,238,-238
Keith Berish,Ryan Janes,Ryan Janes,2016-12-09,0,1,-4,4,5,3.333333,-7.619995,7.619995,20,-20,2.960007,-2.960007,52,178,6,13,-7,7,1.66666674613953,-1.66666674613953,0,0,0,0,0,0,0,0,0,0,0,0
Wilson Gouveia,Ryan Jensen,Wilson Gouveia,2008-09-17,1,0,-1,1,1.75,2.625,0,0,0,0,0,0,14,220,22,29,-7,7,-0.875,0.875,0,0,1,0,0,0,1,-1,116,0,116,-116
Jesse Forbes,Ryan Jensen,Ryan Jensen,2010-05-29,0,1,-7,7,3,2.625,2.540009,-2.540009,0,0,-2.539993,2.539993,35,1,20,29,-9,9,0.375,-0.375,0,0,1,0,0,0,1,-1,1435,619,816,-816
Francimar Barroso,Ryan Jimmo,Francimar Barroso,2015-05-30,1,0,2,-2,2.714286,3.8,0,0,0,0,5.080002,-5.080002,397,24,26,24,2,-2,-1.08571434020996,1.08571434020996,0,0,0,0,0,0,0,0,433,0,433,-433
Ben Alloway,Ryan LaFlare,Ryan LaFlare,2013-04-06,0,1,3,-3,2.25,4.666667,-5.080002,5.080002,0,0,5.079987,-5.079987,88,582,26,17,9,-9,-2.41666650772095,2.41666650772095,1,0,0,0,1,-1,0,0,113,0,113,-113
John Howard,Ryan LaFlare,Ryan LaFlare,2014-04-11,0,1,1,-1,1.846154,4.666667,-15.24001,15.24001,0,0,-5.080002,5.080002,107,509,37,17,20,-20,-2.82051265239716,2.82051265239716,3,1,0,0,2,-2,0,0,1482,370,1112,-1112
Roan Carneiro,Ryan LaFlare,Ryan LaFlare,2017-02-11,0,1,5,-5,1.909091,4.666667,-5.080002,5.080002,0,0,5.079987,-5.079987,113,309,32,17,15,-15,-2.75757563114166,2.75757563114166,2,2,0,0,0,0,0,0,147,1037,-890,890
Alex Garcia,Ryan LaFlare,Ryan LaFlare,2018-04-21,0,1,-4,4,2.5,4.666667,-10.16,10.16,0,0,-5.080002,5.080002,246,268,21,17,4,-4,-2.16666650772095,2.16666650772095,1,3,1,0,-2,2,1,-1,147,434,-287,287
Chris Gutierrez,Ryan MacDonald,Chris Gutierrez,2019-03-23,1,0,1,-1,3.8,5,-5.080002,5.080002,0,0,-10.16,10.16,8,47,24,12,12,-12,-1.20000004768372,1.20000004768372,0,0,0,0,0,0,0,0,0,0,0,0
Shamar Bailey,Ryan McGillivray,Shamar Bailey,2011-06-04,1,0,4,-4,1.454545,12,-5.080002,5.080002,-15,15,7.5,-7.5,561,0,27,12,15,-15,-10.5454545021057,10.5454545021057,0,0,0,0,0,0,0,0,0,0,0,0
Remco Pardoel,Ryan Parker,Remco Pardoel,1995-09-08,1,0,,,1.5,0,0,0,25,-25,2,-2,0,0,15,1,14,-14,1.5,-1.5,1,0,0,0,1,-1,0,0,546,0,546,-546
Marcus Aurelio,Ryan Roberts,Marcus Aurelio,2008-04-02,1,0,5,-5,2.2,1.75,10.16,-10.16,0,0,22.96001,-22.96001,6,0,32,33,-1,1,0.450000047683716,-0.450000047683716,1,0,0,0,1,-1,0,0,137,0,137,-137
Luis Henrique,Ryan Spann,Ryan Spann,2018-09-22,0,1,-2,2,2,2.333333,-7.619995,7.619995,38,-38,-12.7,12.7,303,308,15,30,-15,15,-0.333333253860474,0.333333253860474,0,0,2,0,0,0,2,-2,567,0,567,-567
Rogerio Nogueira,Ryan Spann,Ryan Spann,2019-05-11,0,1,15,-15,2.3,2.333333,-7.619995,7.619995,0,0,-10.16,10.16,0,44,33,30,3,-3,-3.33333015441895e-02,3.33333015441895e-02,0,1,0,0,-1,1,0,0,1379,231,1148,-1148
Devin Clark,Ryan Spann,Ryan Spann,2019-10-12,0,1,1,-1,1.75,2.333333,-12.7,12.7,0,0,-10.16,10.16,38,68,22,30,-8,8,-0.583333253860474,0.583333253860474,1,2,2,0,-1,1,2,-2,133,154,-21,21
Sam Alvey,Ryan Spann,Ryan Spann,2020-05-09,0,1,6,-6,1.833333,2.333333,-7.619995,7.619995,-20,20,-10.16,10.16,29,181,51,30,21,-21,-0.49999988079071,0.49999988079071,0,3,3,0,-3,3,3,-3,455,210,245,-245
Misha Cirkunov,Ryan Spann,Ryan Spann,2021-03-13,0,1,5,-5,1.666667,2.333333,-5.080002,5.080002,0,0,-5.080002,5.080002,0,13,24,30,-6,6,-0.666666626930237,0.666666626930237,1,4,3,0,-3,3,3,-3,546,308,238,-238
Anthony Smith,Ryan Spann,Anthony Smith,2021-09-18,1,0,3,-3,2.055556,2.333333,-2.540009,2.540009,0,0,-7.62001,7.62001,98,30,55,30,25,-25,-0.277777671813965,0.277777671813965,0,5,1,0,-5,5,1,-1,493,189,304,-304
Ion Cutelaba,Ryan Spann,Ryan Spann,2022-05-14,0,1,-2,2,1.888889,2.333333,-10.16,10.16,0,0,-10.16,10.16,71,4,26,30,-4,4,-0.444444417953491,0.444444417953491,1,0,0,0,1,-1,0,0,959,238,721,-721
Dominick Reyes,Ryan Spann,Ryan Spann,2022-11-12,0,1,1,-1,3,2.333333,-2.540009,2.540009,0,0,-5.080002,5.080002,0,3,16,30,-14,14,0.666666746139526,-0.666666746139526,2,1,0,0,1,-1,0,0,1121,182,939,-939
Nikita Krylov,Ryan Spann,Nikita Krylov,2023-03-11,1,0,0,0,3.333333,2.333333,-5.080002,5.080002,0,0,-5.080002,5.080002,159,32,39,30,9,-9,1,-1,2,2,1,0,0,0,1,-1,140,119,21,-21
Anthony Smith,Ryan Spann,Anthony Smith,2023-08-26,1,0,3,-3,2.055556,2.333333,-2.540009,2.540009,0,0,-7.62001,7.62001,56,79,55,30,25,-25,-0.277777671813965,0.277777671813965,0,0,1,0,0,0,1,-1,105,168,-63,63
Ben Saunders,Ryan Thomas,Ben Saunders,2008-08-09,1,0,2,-2,1.692308,2.5,5.080002,-5.080002,0,0,10.58,-10.58,248,22,35,28,7,-7,-0.807692289352417,0.807692289352417,0,0,0,0,0,0,0,0,0,0,0,0
Matt Brown,Ryan Thomas,Matt Brown,2008-11-15,1,0,3,-3,1.368421,2.5,0,0,0,0,5.5,-5.5,45,262,45,28,17,-17,-1.13157892227173,1.13157892227173,0,0,0,0,0,0,0,0,70,98,-28,28
Roan Carneiro,Ryo Chonan,Ryo Chonan,2008-09-06,0,1,-1,1,1.909091,1.692308,5.080002,-5.080002,0,0,15.23999,-15.23999,319,460,32,35,-3,3,0.216783165931702,-0.216783165931702,1,0,0,0,1,-1,0,0,252,0,252,-252
Brad Blackburn,Ryo Chonan,Brad Blackburn,2008-12-27,1,0,-1,1,1.384615,1.692308,2.540009,-2.540009,0,0,7.619995,-7.619995,22,0,31,35,-4,4,-0.307692289352417,0.307692289352417,1,1,0,0,0,0,0,0,161,112,49,-49
Shana Dobson,Sabina Mazo,Sabina Mazo,2019-08-17,0,1,8,-8,0.8,2.25,-2.539993,2.539993,0,0,-2.540009,2.540009,5,649,9,13,-4,4,-1.44999998807907,1.44999998807907,0,0,0,0,0,0,0,0,490,0,490,-490
JJ Aldrich,Sabina Mazo,Sabina Mazo,2020-01-18,0,1,5,-5,2,2.25,-5.079987,5.079987,0,0,-7.62001,7.62001,3,121,18,13,5,-5,-0.25,0.25,1,1,1,0,0,0,1,-1,98,154,-56,56
Justine Kish,Sabina Mazo,Sabina Mazo,2020-09-12,0,1,9,-9,1.75,2.25,-5.079987,5.079987,0,0,-15.24001,15.24001,32,14,11,13,-2,2,-0.5,0.5,1,2,0,0,-1,1,0,0,231,238,-7,7
Alexis Davis,Sabina Mazo,Alexis Davis,2021-02-27,1,0,13,-13,1.909091,2.25,-2.539993,2.539993,10,-10,-5.080002,5.080002,530,0,32,13,19,-19,-0.340909123420715,0.340909123420715,0,3,1,0,-3,3,1,-1,707,168,539,-539
Mariya Agapova,Sabina Mazo,Mariya Agapova,2021-10-09,1,0,0,0,2.5,2.25,-2.539993,2.539993,0,0,-5.080002,5.080002,5,35,14,13,1,-1,0.25,-0.25,0,0,1,0,0,0,1,-1,413,224,189,-189
Miranda Maverick,Sabina Mazo,Miranda Maverick,2022-03-12,1,0,0,0,2.8,2.25,-10.15999,10.15999,0,0,-12.7,12.7,242,0,19,13,6,-6,0.549999952316284,-0.549999952316284,1,0,0,0,1,-1,0,0,350,154,196,-196
Bryan Barberena,Sage Northcutt,Bryan Barberena,2016-01-30,1,0,7,-7,1.636364,5.5,0,0,0,0,2.540009,-2.540009,195,84,29,13,16,-16,-3.86363637447357,3.86363637447357,0,0,0,0,0,0,0,0,280,0,280,-280
Enrique Marin,Sage Northcutt,Sage Northcutt,2016-07-09,0,1,9,-9,2.5,5.5,-5.080002,5.080002,0,0,-0.3399963,0.3399963,447,264,14,13,1,-1,-3,3,0,0,0,0,0,0,0,0,231,161,70,-70
Mickey Gall,Sage Northcutt,Mickey Gall,2016-12-17,1,0,4,-4,1.4,5.5,5.080002,-5.080002,0,0,7.62001,-7.62001,205,63,12,13,-1,1,-4.10000002384186,4.10000002384186,2,1,0,0,1,-1,0,0,98,161,-63,63
Thibault Gouti,Sage Northcutt,Sage Northcutt,2018-02-18,0,1,9,-9,2.4,5.5,-5.080002,5.080002,-15,15,2.540009,-2.540009,371,113,17,13,4,-4,-3.09999990463257,3.09999990463257,1,0,1,0,1,-1,1,-1,169,428,-259,259
Zhang Lipeng,Sai Wang,Zhang Lipeng,2014-03-01,1,0,-5,5,2.555556,3.333333,-2.540009,2.540009,-15,15,-4.660004,4.660004,209,432,32,26,6,-6,-0.777777671813965,0.777777671813965,0,0,0,0,0,0,0,0,0,0,0,0
Danny Mitchell,Sai Wang,Sai Wang,2014-08-23,0,1,0,0,2.111111,3.333333,5.080002,-5.080002,0,0,4,-4,189,227,28,26,2,-2,-1.22222208976746,1.22222208976746,0,0,0,0,0,0,0,0,0,175,-175,175
Raoni Barcelos,Said Nurmagomedov,Raoni Barcelos,2019-12-21,1,0,5,-5,3.4,5.666667,-2.540009,2.540009,0,0,-7.62001,7.62001,159,14,22,20,2,-2,-2.26666641235352,2.26666641235352,3,0,0,0,3,-3,0,0,224,0,224,-224
Saidyokub Kakhramonov,Said Nurmagomedov,Said Nurmagomedov,2022-12-17,0,1,-3,3,3.333333,5.666667,0,0,0,0,-2.540009,2.540009,472,25,13,20,-7,7,-2.33333325386047,2.33333325386047,1,0,0,0,1,-1,0,0,161,1092,-931,931
Jonathan Martinez,Said Nurmagomedov,Jonathan Martinez,2023-03-11,1,0,-2,2,4.5,5.666667,0,0,0,0,0,0,369,261,22,20,2,-2,-1.16666650772095,1.16666650772095,4,1,0,0,3,-3,0,0,147,84,63,-63
Trevin Jones,Saidyokub Kakhramonov,Saidyokub Kakhramonov,2021-08-21,0,1,6,-6,1.3,3.333333,-2.540009,2.540009,0,0,2.540009,-2.540009,539,67,23,13,10,-10,-2.03333330154419,2.03333330154419,0,0,0,0,0,0,0,0,0,0,0,0
Tony Gravely,Saimon Oliveira,Tony Gravely,2022-01-22,1,0,0,0,2.555556,3.6,2.540009,-2.540009,0,0,-7.62001,7.62001,688,15,32,23,9,-9,-1.04444432258606,1.04444432258606,0,0,1,0,0,0,1,-1,126,0,126,-126
Daniel Marcos,Saimon Oliveira,Daniel Marcos,2023-01-21,1,0,-2,2,15,3.6,7.619995,-7.619995,0,0,-7.62001,7.62001,60,135,15,23,-8,8,11.4000000953674,-11.4000000953674,0,0,0,0,0,0,0,0,0,364,-364,364
Warlley Alves,Salim Touahri,Warlley Alves,2017-10-21,1,0,-2,2,2.5,2.5,2.539993,-2.539993,0,0,0,0,225,17,21,14,7,-7,0,0,0,0,0,0,0,0,0,0,336,0,336,-336
Keita Nakamura,Salim Touahri,Keita Nakamura,2018-12-01,1,0,5,-5,3.4,2.5,2.539993,-2.539993,0,0,2.539993,-2.539993,0,40,44,14,30,-30,0.900000095367432,-0.900000095367432,0,0,0,0,0,0,0,0,224,406,-182,182
Mickey Gall,Salim Touahri,Mickey Gall,2019-08-03,1,0,-2,2,1.4,2.5,10.16,-10.16,0,0,5.080002,-5.080002,301,104,12,14,-2,2,-1.10000002384186,1.10000002384186,0,0,1,0,0,0,1,-1,154,245,-91,91
David Abbott,Sam Adkins,David Abbott,1996-09-20,1,0,,,0.6666667,0.35,-7.619995,7.619995,40,-40,-22.5,22.5,0,0,25,27,-2,2,0.316666692495346,-0.316666692495346,1,0,0,0,1,-1,0,0,0,0,0,0
Klidson Abreu,Sam Alvey,Klidson Abreu,2019-07-20,1,0,-7,7,3.75,1.833333,-5.080002,5.080002,20,-20,-2.539993,2.539993,52,153,19,51,-32,32,1.91666662693024,-1.91666662693024,0,0,0,0,0,0,0,0,147,0,147,-147
Brendan Allen,Sam Alvey,Brendan Allen,2022-02-05,1,0,-9,9,4.4,1.833333,0,0,0,0,0,0,44,7,27,51,-24,24,2.56666672229767,-2.56666672229767,0,0,2,0,0,0,2,-2,63,931,-868,868
Scott Ferrozzo,Sam Fulton,Scott Ferrozzo,1996-09-20,1,0,,,2,0,,,,,10,-10,0,0,6,2,4,-4,2,-2,0,0,0,0,0,0,0,0,0,0,0,0
Stephan Bonnar,Sam Hoger,Stephan Bonnar,2005-08-06,1,0,3,-3,1.666667,2.5,5.079987,-5.079987,0,0,8.660004,-8.660004,589,127,24,14,10,-10,-0.833333373069763,0.833333373069763,0,0,0,0,0,0,0,0,119,0,119,-119
Rashad Evans,Sam Hoger,Rashad Evans,2006-04-06,1,0,1,-1,2.375,2.5,-5.080002,5.080002,0,0,-1.5,1.5,563,3,27,14,13,-13,-0.125,0.125,1,0,0,0,1,-1,0,0,152,243,-91,91
Jaqueline Amorim,Sam Hughes,Sam Hughes,2023-04-08,0,1,-3,3,7,1.6,-5.080002,5.080002,0,0,10.16,-10.16,222,422,8,13,-5,5,5.39999997615814,-5.39999997615814,0,0,0,0,0,0,0,0,0,0,0,0
Yanal Ashmouz,Sam Patterson,Yanal Ashmouz,2023-03-18,1,0,1,-1,7,5,-15.24001,15.24001,0,0,-25.39999,25.39999,7,0,8,12,-4,4,2,-2,0,0,0,0,0,0,0,0,0,0,0,0
Cristiano Marcello,Sam Sicilia,Sam Sicilia,2012-06-01,0,1,8,-8,2.166667,1.875,2.539993,-2.539993,10,-10,12.70001,-12.70001,5,28,19,23,-4,4,0.291666746139526,-0.291666746139526,0,0,0,0,0,0,0,0,0,0,0,0
Rony Jason,Sam Sicilia,Rony Jason,2012-10-13,1,0,2,-2,2,1.875,-2.540009,2.540009,0,0,15.24001,-15.24001,9,86,21,23,-2,2,0.125,-0.125,1,1,0,0,0,0,0,0,112,134,-22,22
Maximo Blanco,Sam Sicilia,Maximo Blanco,2013-04-13,1,0,2,-2,1.5,1.875,0,0,0,0,10.16,-10.16,225,131,20,23,-3,3,-0.375,0.375,0,0,0,1,0,0,-1,1,357,182,175,-175
Godofredo Pepey,Sam Sicilia,Sam Sicilia,2013-11-09,0,1,-1,1,2.166667,1.875,-2.540009,2.540009,0,0,15.24001,-15.24001,11,54,19,23,-4,4,0.291666746139526,-0.291666746139526,1,0,0,1,1,-1,-1,1,294,210,84,-84
Cole Miller,Sam Sicilia,Cole Miller,2014-01-15,1,0,2,-2,1.909091,1.875,12.7,-12.7,0,0,15.24001,-15.24001,25,0,32,23,9,-9,3.40908765792847e-02,-3.40908765792847e-02,2,1,1,1,1,-1,0,0,81,67,14,-14
Aaron Phillips,Sam Sicilia,Sam Sicilia,2014-05-24,0,1,-4,4,2.4,1.875,2.539993,-2.539993,-10,10,10.16,-10.16,68,609,17,23,-6,6,0.525000095367432,-0.525000095367432,0,0,0,1,0,0,-1,1,0,129,-129,129
Katsunori Kikuno,Sam Sicilia,Katsunori Kikuno,2014-09-20,1,0,4,-4,3,1.875,0,0,0,0,-2.539993,2.539993,48,0,32,23,9,-9,1.125,-1.125,1,1,0,1,0,0,-1,1,259,119,140,-140
Akira Corassani,Sam Sicilia,Sam Sicilia,2015-01-24,0,1,4,-4,2,1.875,0,0,0,0,2.540009,-2.540009,2,24,18,23,-5,5,0.125,-0.125,0,0,2,1,0,0,1,-1,112,126,-14,14
Yaotzin Meza,Sam Sicilia,Sam Sicilia,2015-07-15,0,1,5,-5,1.909091,1.875,2.539993,-2.539993,0,0,10.16,-10.16,90,506,32,23,9,-9,3.40908765792847e-02,-3.40908765792847e-02,1,1,0,1,0,0,-1,1,95,172,-77,77
Dooho Choi,Sam Sicilia,Dooho Choi,2015-11-28,1,0,-5,5,3.5,1.875,5.080002,-5.080002,0,0,7.62001,-7.62001,7,0,18,23,-5,5,1.625,-1.625,1,2,0,1,-1,1,-1,1,371,136,235,-235
Gabriel Benitez,Sam Sicilia,Gabriel Benitez,2016-09-17,1,0,-2,2,2.090909,1.875,0,0,10,-10,10.16,-10.16,17,0,34,23,11,-11,0.215909004211426,-0.215909004211426,0,0,1,2,0,0,-1,1,301,294,7,-7
Spencer Fisher,Sam Stout,Sam Stout,2006-03-04,0,1,8,-8,2.666667,1.666667,-5.080002,5.080002,0,0,-5.080002,5.080002,259,60,33,32,1,-1,1.00000011920929,-1.00000011920929,1,0,0,0,1,-1,0,0,47,0,47,-47
Kenny Florian,Sam Stout,Kenny Florian,2006-06-24,1,0,8,-8,2.333333,1.666667,2.540009,-2.540009,-10,10,10.16,-10.16,97,0,20,32,-12,12,0.666666626930237,-0.666666626930237,1,1,1,0,0,0,1,-1,322,112,210,-210
Spencer Fisher,Sam Stout,Spencer Fisher,2007-06-12,1,0,8,-8,2.666667,1.666667,-5.080002,5.080002,0,0,-5.080002,5.080002,9,10,33,32,1,-1,1.00000011920929,-1.00000011920929,0,0,1,0,0,0,1,-1,138,353,-215,215
Per Eklund,Sam Stout,Sam Stout,2008-01-19,0,1,,,2.8,1.666667,2.540009,-2.540009,0,0,5.080002,-5.080002,182,332,19,32,-13,13,1.13333332538605,-1.13333332538605,0,0,0,0,0,0,0,0,0,221,-221,221
Rich Clementi,Sam Stout,Rich Clementi,2008-04-19,1,0,9,-9,1.956522,1.666667,0,0,0,0,5.080002,-5.080002,323,11,68,32,36,-36,0.289855122566223,-0.289855122566223,3,1,0,0,2,-2,0,0,112,91,21,-21
Terry Etim,Sam Stout,Terry Etim,2008-10-18,1,0,-2,2,3.2,1.666667,10.16,-10.16,0,0,7.619995,-7.619995,3,5,21,32,-11,11,1.53333342075348,-1.53333342075348,0,0,0,0,0,0,0,0,406,182,224,-224
Joe Lauzon,Sam Stout,Sam Stout,2010-01-02,0,1,0,0,1.75,1.666667,2.540009,-2.540009,0,0,2.539993,-2.539993,159,145,44,32,12,-12,8.33333730697632e-02,-8.33333730697632e-02,4,0,0,0,4,-4,0,0,329,441,-112,112
Jeremy Stephens,Sam Stout,Jeremy Stephens,2010-05-08,1,0,-3,3,1.473684,1.666667,0,0,-10,10,2.539993,-2.539993,72,48,47,32,15,-15,-0.19298243522644,0.19298243522644,0,1,0,0,-1,1,0,0,402,126,276,-276
Yves Edwards,Sam Stout,Sam Stout,2011-06-11,0,1,7,-7,1.909091,1.666667,0,0,0,0,7.619995,-7.619995,75,2,64,32,32,-32,0.242424249649048,-0.242424249649048,2,0,1,0,2,-2,1,-1,140,399,-259,259
Spencer Fisher,Sam Stout,Sam Stout,2012-06-22,0,1,8,-8,2.666667,1.666667,-5.080002,5.080002,0,0,-5.080002,5.080002,6,232,33,32,1,-1,1.00000011920929,-1.00000011920929,0,1,3,0,-1,1,3,-3,300,377,-77,77
John Makdessi,Sam Stout,John Makdessi,2012-11-17,1,0,-1,1,2,1.666667,-2.539993,2.539993,0,0,-5.080002,5.080002,0,0,27,32,-5,5,0.333333373069763,-0.333333373069763,0,2,0,0,-2,2,0,0,210,148,62,-62
Caros Fodor,Sam Stout,Sam Stout,2013-02-23,0,1,1,-1,1.833333,1.666667,0,0,0,0,10.16,-10.16,127,399,17,32,-15,15,0.166666746139526,-0.166666746139526,0,0,0,0,0,0,0,0,0,98,-98,98
James Krause,Sam Stout,James Krause,2013-06-15,1,0,-2,2,3.111111,1.666667,12.70001,-12.70001,15,-15,7.619995,-7.619995,122,80,37,32,5,-5,1.44444453716278,-1.44444453716278,0,1,0,0,-1,1,0,0,0,112,-112,112
Cody McKenzie,Sam Stout,Sam Stout,2013-12-14,0,1,-4,4,1.6,1.666667,7.62001,-7.62001,0,0,5.080002,-5.080002,104,45,26,32,-6,6,-6.66666030883789e-02,6.66666030883789e-02,0,0,1,0,0,0,1,-1,525,182,343,-343
KJ Noons,Sam Stout,KJ Noons,2014-04-16,1,0,2,-2,1.444444,1.666667,2.540009,-2.540009,0,0,0,0,3,0,22,32,-10,10,-0.222222208976746,0.222222208976746,1,1,0,0,0,0,0,0,179,123,56,-56
Ross Pearson,Sam Stout,Ross Pearson,2015-03-14,1,0,0,0,1.25,1.666667,-2.539993,2.539993,0,0,-2.540009,2.540009,2,1,36,32,4,-4,-0.416666626930237,0.416666626930237,0,0,1,1,0,0,0,0,280,332,-52,52
Frankie Perez,Sam Stout,Frankie Perez,2015-08-23,1,0,-5,5,2.5,1.666667,5.080002,-5.080002,0,0,7.619995,-7.619995,4,0,14,32,-18,18,0.833333373069763,-0.833333373069763,0,0,0,2,0,0,-2,2,0,162,-162,162
Joshua Burkman,Sammy Morgan,Joshua Burkman,2005-11-05,1,0,1,-1,1.75,1.5,0,0,0,0,2.880005,-2.880005,3,0,44,30,14,-14,0.25,-0.25,0,0,0,0,0,0,0,0,0,0,0,0
Clay Guida,Samy Schiavo,Clay Guida,2008-04-02,1,0,-6,6,1.9,1.666667,-2.540009,2.540009,0,0,2.800003,-2.800003,116,0,58,16,42,-42,0.233333349227905,-0.233333349227905,0,0,0,0,0,0,0,0,116,0,116,-116
Per Eklund,Samy Schiavo,Per Eklund,2008-10-18,1,0,,,2.8,1.666667,5.080002,-5.080002,0,0,7.880005,-7.880005,243,318,19,16,3,-3,1.13333332538605,-1.13333332538605,0,0,0,1,0,0,-1,1,273,199,74,-74
Eugene Jackson,Sanae Kikuta,Sanae Kikuta,2000-04-14,0,1,5,-5,1.666667,3.444444,-2.539993,2.539993,-15,15,-2,2,0,217,24,40,-16,16,-1.77777779102325,1.77777779102325,1,0,0,0,1,-1,0,0,147,0,147,-147
Ryan LaFlare,Santiago Ponzinibbio,Ryan LaFlare,2013-11-09,1,0,3,-3,4.666667,4.285714,2.539993,-2.539993,0,0,2.540009,-2.540009,432,31,17,37,-20,20,0.38095235824585,-0.38095235824585,0,0,0,0,0,0,0,0,0,0,0,0
Wendell Oliveira Marques,Santiago Ponzinibbio,Santiago Ponzinibbio,2014-09-13,0,1,4,-4,2.9,4.285714,-5.080002,5.080002,0,0,-5.419998,5.419998,0,1,39,37,2,-2,-1.38571405410767,1.38571405410767,0,0,0,0,0,0,0,0,0,308,-308,308
Lorenz Larkin,Santiago Ponzinibbio,Lorenz Larkin,2015-06-27,1,0,0,0,3,4.285714,-2.540009,2.540009,0,0,-2.539993,2.539993,31,55,24,37,-13,13,-1.2857141494751,1.2857141494751,0,1,1,0,-1,1,1,-1,413,287,126,-126
Court McGee,Santiago Ponzinibbio,Santiago Ponzinibbio,2016-04-16,0,1,2,-2,1.833333,4.285714,-2.540009,2.540009,0,0,5.080002,-5.080002,13,8,34,37,-3,3,-2.45238077640533,2.45238077640533,2,0,0,1,2,-2,-1,1,962,294,668,-668
Zak Cummings,Santiago Ponzinibbio,Santiago Ponzinibbio,2016-08-06,0,1,3,-3,3.571429,4.285714,0,0,35,-35,5.080002,-5.080002,9,0,32,37,-5,5,-0.714285612106323,0.714285612106323,2,1,0,1,1,-1,-1,1,118,112,6,-6
Gunnar Nelson,Santiago Ponzinibbio,Santiago Ponzinibbio,2017-07-16,0,1,-2,2,3.8,4.285714,-2.540009,2.540009,0,0,-2.539993,2.539993,0,3,24,37,-13,13,-0.485714197158813,0.485714197158813,2,2,0,1,0,0,-1,1,434,344,90,-90
Mike Perry,Santiago Ponzinibbio,Santiago Ponzinibbio,2017-12-16,0,1,-5,5,1.75,4.285714,-5.080002,5.080002,0,0,-5.080002,5.080002,29,118,22,37,-15,15,-2.5357141494751,2.5357141494751,2,3,0,1,-1,1,-1,1,91,153,-62,62
Neil Magny,Santiago Ponzinibbio,Santiago Ponzinibbio,2018-11-17,0,1,-1,1,2.333333,4.285714,7.619995,-7.619995,0,0,17.78,-17.78,0,41,40,37,3,-3,-1.95238089561462,1.95238089561462,2,4,0,1,-2,2,-1,1,174,336,-162,162
Li Jingliang,Santiago Ponzinibbio,Li Jingliang,2021-01-16,1,0,-2,2,2.375,4.285714,0,0,0,0,-5.080002,5.080002,2,0,27,37,-10,10,-1.9107141494751,1.9107141494751,0,5,0,1,-5,5,-1,1,315,791,-476,476
Miguel Baeza,Santiago Ponzinibbio,Santiago Ponzinibbio,2021-06-05,0,1,-6,6,3.333333,4.285714,5.080002,-5.080002,0,0,2.540009,-2.540009,0,0,13,37,-24,24,-0.952380895614624,0.952380895614624,2,0,0,2,2,-2,-2,2,189,140,49,-49
Geoff Neal,Santiago Ponzinibbio,Geoff Neal,2021-12-11,1,0,-4,4,3,4.285714,-2.540009,2.540009,0,0,5.080002,-5.080002,3,23,20,37,-17,17,-1.2857141494751,1.2857141494751,0,1,0,2,-1,1,-2,2,357,189,168,-168
Michel Pereira,Santiago Ponzinibbio,Michel Pereira,2022-05-21,1,0,-7,7,2.545455,4.285714,2.539993,-2.539993,15,-15,0,0,1,18,39,37,2,-2,-1.74025964736938,1.74025964736938,2,0,0,2,2,-2,-2,2,315,161,154,-154
Alex Morono,Santiago Ponzinibbio,Santiago Ponzinibbio,2022-12-10,0,1,-4,4,2.875,4.285714,-2.540009,2.540009,0,0,-2.539993,2.539993,8,1,31,37,-6,6,-1.4107141494751,1.4107141494751,2,0,1,2,2,-2,-1,1,133,203,-70,70
Kevin Holland,Santiago Ponzinibbio,Kevin Holland,2023-04-08,1,0,-6,6,2.5,4.285714,7.619995,-7.619995,0,0,20.32001,-20.32001,3,7,35,37,-2,2,-1.7857141494751,1.7857141494751,0,1,1,2,-1,1,-1,1,126,119,7,-7
Tyson Pedro,Saparbeg Safarov,Tyson Pedro,2018-02-10,1,0,-5,5,2.5,3,5.080002,-5.080002,20,-20,2.540009,-2.540009,1,79,14,12,2,-2,-0.5,0.5,1,0,0,0,1,-1,0,0,441,0,441,-441
Nicolae Negumereanu,Saparbeg Safarov,Saparbeg Safarov,2019-03-16,0,1,-8,8,6.5,3,-2.539993,2.539993,20,-20,0,0,0,645,15,12,3,-3,3.5,-3.5,0,0,0,0,0,0,0,0,0,399,-399,399
Sheila Gaff,Sara McMann,Sara McMann,2013-04-27,0,1,-9,9,1.285714,2.166667,-2.539993,2.539993,0,0,0.3600006,-0.3600006,1,227,16,19,-3,3,-0.880952477455139,0.880952477455139,0,0,0,0,0,0,0,0,0,0,0,0
Jessica Eye,Sara McMann,Sara McMann,2016-05-29,0,1,-6,6,1.363636,2.166667,0,0,-10,10,0,0,0,478,26,19,7,-7,-0.803030371665955,0.803030371665955,0,1,0,0,-1,1,0,0,239,1128,-889,889
Alexis Davis,Sara McMann,Sara McMann,2016-12-03,0,1,-4,4,1.909091,2.166667,0,0,0,0,5.080002,-5.080002,370,0,32,19,13,-13,-0.257575869560242,0.257575869560242,1,2,1,0,-1,1,1,-1,588,188,400,-400
Gina Mazany,Sara McMann,Sara McMann,2017-02-19,0,1,-8,8,1.166667,2.166667,0,0,-10,10,5.080002,-5.080002,0,62,13,19,-6,6,-1.00000011920929,1.00000011920929,0,3,0,0,-3,3,0,0,0,78,-78,78
Lina Lansberg,Sara McMann,Sara McMann,2020-01-25,0,1,-2,2,1.25,2.166667,2.539993,-2.539993,0,0,-2.539993,2.539993,0,804,18,19,-1,1,-0.916666746139526,0.916666746139526,0,4,0,0,-4,4,0,0,476,1070,-594,594
Alexis Davis,Sarah Kaufman,Alexis Davis,2015-04-25,1,0,1,-1,1.909091,4.5,2.539993,-2.539993,0,0,5.080002,-5.080002,51,87,32,22,10,-10,-2.59090912342072,2.59090912342072,0,0,1,0,0,0,1,-1,294,0,294,-294
Alexis Dufresne,Sarah Moras,Sarah Moras,2014-07-06,0,1,-3,3,2,0.75,5.080002,-5.080002,0,0,7.820007,-7.820007,653,154,9,14,-5,5,1.25,-1.25,0,0,0,0,0,0,0,0,0,0,0,0
Jessica Andrade,Sarah Moras,Jessica Andrade,2015-07-15,1,0,-4,4,2,0.75,-15.23999,15.23999,-20,20,-12.7,12.7,547,39,36,14,22,-22,1.25,-1.25,0,1,1,0,-1,1,1,-1,143,374,-231,231
Ashlee Evans-Smith,Sarah Moras,Sarah Moras,2017-09-09,0,1,1,-1,1,0.75,2.540009,-2.540009,0,0,0,0,146,7,12,14,-2,2,0.25,-0.25,0,0,0,0,0,0,0,0,147,787,-640,640
Talita Bernardo,Sarah Moras,Talita Bernardo,2018-10-27,1,0,1,-1,1.5,0.75,-7.619995,7.619995,0,0,2.540009,-2.540009,424,88,10,14,-4,4,0.75,-0.75,0,1,1,0,-1,1,1,-1,420,413,7,-7
Macy Chiasson,Sarah Moras,Macy Chiasson,2019-05-04,1,0,-4,4,3,0.75,10.16,-10.16,0,0,12.70001,-12.70001,197,226,12,14,-2,2,2.25,-2.25,2,0,0,0,2,-2,0,0,63,189,-126,126
Liana Jojua,Sarah Moras,Sarah Moras,2019-09-07,0,1,-7,7,1.6,0.75,-7.619995,7.619995,-10,10,-12.7,12.7,140,395,13,14,-1,1,0.850000023841858,-0.850000023841858,0,0,0,1,0,0,-1,1,0,126,-126,126
Sijara Eubanks,Sarah Moras,Sijara Eubanks,2020-05-13,1,0,3,-3,1.142857,0.75,-7.619995,7.619995,-10,10,0,0,254,0,15,14,1,-1,0.392857193946838,-0.392857193946838,0,1,0,1,-1,1,-1,1,361,249,112,-112
Vanessa Melo,Sarah Moras,Vanessa Melo,2021-01-16,1,0,0,0,1.375,0.75,-5.079987,5.079987,0,0,-5.079987,5.079987,4,0,19,14,5,-5,0.625,-0.625,0,0,0,1,0,0,-1,1,189,248,-59,59
Louis Cosce,Sasha Palatnikov,Sasha Palatnikov,2020-11-21,0,1,-6,6,3.5,1.5,-10.16,10.16,0,0,-2.540009,2.540009,53,196,9,10,-1,1,2,-2,0,0,0,0,0,0,0,0,0,0,0,0
Impa Kasanganay,Sasha Palatnikov,Impa Kasanganay,2021-04-10,1,0,-5,5,4.5,1.5,-5.080002,5.080002,0,0,7.619995,-7.619995,174,56,11,10,1,-1,3,-3,1,1,0,0,0,0,0,0,224,140,84,-84
Ramiz Brahimaj,Sasha Palatnikov,Ramiz Brahimaj,2021-08-21,1,0,-4,4,2.5,1.5,-7.619995,7.619995,0,0,0,0,132,0,14,10,4,-4,1,-1,0,0,1,0,0,0,1,-1,287,133,154,-154
Jerry Bohlander,Scott Ferrozzo,Jerry Bohlander,1996-02-16,1,0,-8,8,2.75,2,0,0,-124,124,0,0,0,0,15,6,9,-9,0.75,-0.75,0,0,0,0,0,0,0,0,0,0,0,0
David Abbott,Scott Ferrozzo,Scott Ferrozzo,1996-09-20,0,1,,,0.6666667,2,2.540009,-2.540009,-58,58,-0.5,0.5,0,0,25,6,19,-19,-1.33333331346512,1.33333331346512,2,0,0,0,2,-2,0,0,279,217,62,-62
Vitor Belfort,Scott Ferrozzo,Vitor Belfort,1997-02-07,1,0,-12,12,1.857143,2,2.540009,-2.540009,-138,138,4.960007,-4.960007,0,0,40,6,34,-34,-0.142857193946838,0.142857193946838,0,1,0,0,-1,1,0,0,0,140,-140,140
Anthony Christodoulou,Scott Holtzman,Scott Holtzman,2015-08-08,0,1,-3,3,1.714286,2.333333,0,0,0,0,-13.25999,13.25999,46,254,19,20,-1,1,-0.619047522544861,0.619047522544861,0,0,1,0,0,0,1,-1,196,0,196,-196
Drew Dober,Scott Holtzman,Drew Dober,2016-01-02,1,0,-5,5,2.166667,2.333333,-2.539993,2.539993,0,0,2.540009,-2.540009,315,239,38,20,18,-18,-0.166666507720947,0.166666507720947,0,1,0,0,-1,1,0,0,203,147,56,-56
Josh Emmett,Scott Holtzman,Josh Emmett,2016-12-17,1,0,-2,2,4.5,2.333333,-7.619995,7.619995,-10,10,2.540009,-2.540009,239,195,22,20,2,-2,2.16666674613953,-2.16666674613953,1,0,0,0,1,-1,0,0,223,350,-127,127
Beneil Dariush,Scott Holtzman,Beneil Dariush,2020-08-08,1,0,-5,5,4.4,2.333333,2.540009,-2.540009,0,0,7.62001,-7.62001,117,24,27,20,7,-7,2.06666684150696,-2.06666684150696,3,0,2,0,3,-3,2,-2,154,1330,-1176,1176
Mateusz Gamrot,Scott Holtzman,Mateusz Gamrot,2021-04-10,1,0,-7,7,11.5,2.333333,2.540009,-2.540009,0,0,2.540009,-2.540009,50,0,25,20,5,-5,9.16666674613953,-9.16666674613953,0,0,0,1,0,0,-1,1,175,245,-70,70
Clay Guida,Scott Holtzman,Clay Guida,2022-12-03,1,0,1,-1,1.9,2.333333,-5.080002,5.080002,0,0,2.540009,-2.540009,335,18,58,20,38,-38,-0.433333277702332,0.433333277702332,0,0,2,2,0,0,0,0,224,602,-378,378
Jeff Curran,Scott Jorgensen,Scott Jorgensen,2011-10-29,0,1,5,-5,2,1.25,2.539993,-2.539993,0,0,7.619995,-7.619995,38,467,54,27,27,-27,0.75,-0.75,0,0,0,0,0,0,0,0,2828,0,2828,-2828
Renan Barao,Scott Jorgensen,Renan Barao,2012-02-04,1,0,-4,4,3.777778,1.25,2.539993,-2.539993,10,-10,10.16,-10.16,115,11,43,27,16,-16,2.52777767181396,-2.52777767181396,2,1,0,0,1,-1,0,0,91,98,-7,7
John Albert,Scott Jorgensen,Scott Jorgensen,2012-12-08,0,1,-4,4,1.2,1.25,7.619995,-7.619995,0,0,5.080002,-5.080002,13,268,11,27,-16,16,-4.99999523162842e-02,4.99999523162842e-02,0,0,0,0,0,0,0,0,190,308,-118,118
Urijah Faber,Scott Jorgensen,Urijah Faber,2013-04-13,1,0,3,-3,3.181818,1.25,2.539993,-2.539993,0,0,2.539993,-2.539993,305,129,46,27,19,-19,1.93181824684143,-1.93181824684143,2,1,0,0,1,-1,0,0,49,126,-77,77
Jussier Formiga,Scott Jorgensen,Jussier Formiga,2014-03-23,1,0,-3,3,2.875,1.25,0,0,-10,10,2.539993,-2.539993,45,0,31,27,4,-4,1.625,-1.625,0,0,0,0,0,0,0,0,0,344,-344,344
Manvel Gamburyan,Scott Jorgensen,Manvel Gamburyan,2015-07-15,1,0,2,-2,1.5,1.25,0,0,0,0,2.539993,-2.539993,288,91,25,27,-2,2,0.25,-0.25,1,0,0,0,1,-1,0,0,291,479,-188,188
Sean Daugherty,Scott Morris,Scott Morris,1994-03-11,0,1,,,0,2,5.080002,-5.080002,-35,35,6,-6,0,0,2,3,-1,1,-2,2,0,0,0,0,0,0,0,0,0,0,0,0
Pete Sell,Scott Smith,Scott Smith,2006-11-11,0,1,-3,3,1.428571,1.636364,-2.540009,2.540009,-15,15,12.7,-12.7,37,8,17,29,-12,12,-0.207792162895203,0.207792162895203,0,0,0,0,0,0,0,0,0,0,0,0
Patrick Cote,Scott Smith,Patrick Cote,2007-02-03,1,0,-1,1,2.090909,1.636364,-2.540009,2.540009,-15,15,12.7,-12.7,147,172,34,29,5,-5,0.454545378684998,-0.454545378684998,0,1,0,0,-1,1,0,0,84,84,0,0
Ed Herman,Scott Smith,Ed Herman,2007-06-16,1,0,-2,2,1.6875,1.636364,2.539993,-2.539993,20,-20,17.78,-17.78,383,16,43,29,14,-14,5.11363744735718e-02,-5.11363744735718e-02,1,0,0,0,1,-1,0,0,142,133,9,-9
Christian Aguilera,Sean Brady,Sean Brady,2020-08-29,0,1,1,-1,1.75,15,-2.540009,2.540009,0,0,0,0,0,128,22,16,6,-6,-13.25,13.25,1,0,0,0,1,-1,0,0,77,0,77,-77
Mark Hunt,Sean McCorkle,Sean McCorkle,2010-09-25,0,1,2,-2,0.9285714,2.428571,-22.86,22.86,0,0,-22.86,22.86,34,0,27,24,3,-3,-1.50000005960464,1.50000005960464,0,0,0,0,0,0,0,0,0,0,0,0
Ryan Jimmo,"Sean O'Connell",Ryan Jimmo,2014-04-16,1,0,2,-2,3.8,1.888889,0,0,0,0,-2.540009,2.540009,37,163,24,26,-2,2,1.9111111164093,-1.9111111164093,0,0,1,0,0,0,1,-1,172,0,172,-172
Ilir Latifi,"Sean O'Connell",Ilir Latifi,2016-01-17,1,0,1,-1,1.888889,1.888889,-7.619995,7.619995,25,-25,-2.540009,2.540009,1,0,26,26,0,0,0,0,1,0,0,1,1,-1,-1,1,183,641,-458,458
Steve Bosse,"Sean O'Connell",Steve Bosse,2016-06-18,1,0,2,-2,6,1.888889,-5.080002,5.080002,0,0,-5.080002,5.080002,162,192,14,26,-12,12,4.11111116409302,-4.11111116409302,1,0,1,2,1,-1,-1,1,91,153,-62,62
Corey Anderson,"Sean O'Connell",Corey Anderson,2016-12-09,1,0,-6,6,2.8,1.888889,5.080002,-5.080002,0,0,12.7,-12.7,406,0,19,26,-7,7,0.911111116409302,-0.911111116409302,0,0,1,2,0,0,-1,1,209,174,35,-35
Thomas Almeida,"Sean O'Malley","Sean O'Malley",2021-03-27,0,1,3,-3,4.4,17,-10.16,10.16,10,-10,-5.080002,5.080002,22,5,27,18,9,-9,-12.5999999046326,12.5999999046326,0,0,2,0,0,0,2,-2,161,0,161,-161
Kris Moutinho,"Sean O'Malley","Sean O'Malley",2021-07-10,0,1,2,-2,1.5,17,-10.16,10.16,0,0,-10.16,10.16,9,4,15,18,-3,3,-15.5,15.5,0,1,0,0,-1,1,0,0,0,105,-105,105
Jake Ellenberger,Sean Pierson,Jake Ellenberger,2011-04-30,1,0,-9,9,2.066667,2.333333,-7.62001,7.62001,0,0,-12.7,12.7,8,0,46,20,26,-26,-0.266666650772095,0.266666650772095,2,0,0,0,2,-2,0,0,272,0,272,-272
Dong Hyun Kim,Sean Pierson,Dong Hyun Kim,2011-12-30,1,0,-5,5,5.5,2.333333,5.080002,-5.080002,0,0,0,0,128,129,26,20,6,-6,3.16666674613953,-3.16666674613953,2,0,0,1,2,-2,-1,1,580,244,336,-336
Jake Hecht,Sean Pierson,Sean Pierson,2012-06-08,0,1,-8,8,2.75,2.333333,0,0,0,0,-7.619995,7.619995,172,239,15,20,-5,5,0.416666746139526,-0.416666746139526,0,0,0,1,0,0,-1,1,98,161,-63,63
Lance Benoist,Sean Pierson,Sean Pierson,2012-09-22,0,1,-12,12,3.5,2.333333,-2.540009,2.540009,0,0,-10.15999,10.15999,44,172,9,20,-11,11,1.16666674613953,-1.16666674613953,1,1,0,1,0,0,-1,1,371,106,265,-265
Rashad Evans,Sean Salmon,Rashad Evans,2007-01-25,1,0,-2,2,2.375,0.8571429,5.080002,-5.080002,20,-20,10.5,-10.5,2,52,27,39,-12,12,1.51785713434219,-1.51785713434219,3,0,0,0,3,-3,0,0,124,0,124,-124
Alan Belcher,Sean Salmon,Alan Belcher,2007-05-26,1,0,-6,6,2.25,0.8571429,10.16,-10.16,0,0,10.5,-10.5,0,5,26,39,-13,13,1.39285713434219,-1.39285713434219,0,0,0,1,0,0,-1,1,49,121,-72,72
Tiki Ghosn,Sean Sherk,Sean Sherk,2001-02-23,0,1,-3,3,1.428571,9,10.16,-10.16,15,-15,9.820007,-9.820007,0,555,17,40,-23,23,-7.57142853736877,7.57142853736877,0,0,0,0,0,0,0,0,0,0,0,0
Jutaro Nakao,Sean Sherk,Sean Sherk,2002-03-22,0,1,3,-3,1.315789,9,7.619995,-7.619995,15,-15,7.820007,-7.820007,2,730,44,40,4,-4,-7.68421053886414,7.68421053886414,0,1,0,0,-1,1,0,0,0,392,-392,392
Benji Radach,Sean Sherk,Sean Sherk,2002-09-27,0,1,-6,6,3,9,10.16,-10.16,30,-30,9.820007,-9.820007,7,188,28,40,-12,12,-6,6,1,2,0,0,-1,1,0,0,97,189,-92,92
Matt Hughes,Sean Sherk,Matt Hughes,2003-04-25,1,0,0,0,5,9,7.619995,-7.619995,15,-15,15.24001,-15.24001,899,347,54,40,14,-14,-4,4,4,3,0,0,1,-1,0,0,286,210,76,-76
Nick Diaz,Sean Sherk,Sean Sherk,2006-04-15,0,1,-10,10,2.6,9,17.78,-17.78,15,-15,22.86,-22.86,83,227,36,40,-4,4,-6.40000009536743,6.40000009536743,0,0,0,0,0,0,0,0,70,1086,-1016,1016
Kenny Florian,Sean Sherk,Sean Sherk,2006-10-14,0,1,-3,3,2.333333,9,10.16,-10.16,-10,10,17.78001,-17.78001,33,1188,20,40,-20,20,-6.66666674613953,6.66666674613953,2,1,1,0,1,-1,1,-1,112,182,-70,70
Hermes Franca,Sean Sherk,Sean Sherk,2007-07-07,0,1,-1,1,1.411765,9,0,0,0,0,10.16,-10.16,41,1342,41,40,1,-1,-7.58823525905609,7.58823525905609,2,2,0,0,0,0,0,0,315,266,49,-49
BJ Penn,Sean Sherk,BJ Penn,2008-05-24,1,0,-5,5,1.142857,9,7.619995,-7.619995,0,0,7.62001,-7.62001,7,0,30,40,-10,10,-7.85714280605316,7.85714280605316,2,3,0,0,-1,1,0,0,126,322,-196,196
Tyson Griffin,Sean Sherk,Sean Sherk,2008-10-25,0,1,-11,11,2,9,0,0,-10,10,2.540009,-2.540009,0,151,24,40,-16,16,-7,7,4,0,0,1,4,-4,-1,1,266,154,112,-112
Frankie Edgar,Sean Sherk,Frankie Edgar,2009-05-23,1,0,-8,8,2.090909,9,0,0,-20,20,2.540009,-2.540009,45,25,34,40,-6,6,-6.90909099578857,6.90909099578857,1,1,0,1,0,0,-1,1,308,210,98,-98
Evan Dunham,Sean Sherk,Sean Sherk,2010-09-25,0,1,-9,9,2,9,10.16,-10.16,0,0,7.62001,-7.62001,34,490,27,40,-13,13,-7,7,3,0,0,1,3,-3,-1,1,105,490,-385,385
Tatsuya Kawajiri,Sean Soriano,Tatsuya Kawajiri,2014-01-04,1,0,11,-11,3.272727,1.75,-5.080002,5.080002,0,0,-2.540009,2.540009,248,7,47,22,25,-25,1.52272725105286,-1.52272725105286,0,0,0,0,0,0,0,0,0,0,0,0
Chas Skelly,Sean Soriano,Chas Skelly,2014-09-05,1,0,5,-5,6.333333,1.75,5.080002,-5.080002,0,0,5.080002,-5.080002,600,181,22,22,0,0,4.58333349227905,-4.58333349227905,0,0,0,0,0,0,0,0,0,244,-244,244
Charles Rosa,Sean Soriano,Charles Rosa,2015-01-18,1,0,3,-3,1.75,1.75,0,0,0,0,-2.540009,2.540009,336,187,22,22,0,0,0,0,0,0,0,0,0,0,0,0,106,135,-29,29
Christos Giagos,Sean Soriano,Christos Giagos,2021-05-15,1,0,0,0,1.818182,1.75,2.540009,-2.540009,10,-10,2.539993,-2.539993,59,0,31,22,9,-9,6.81818723678589e-02,-6.81818723678589e-02,1,0,0,0,1,-1,0,0,147,2309,-2162,2162
Shayilan Nuerdanbieke,Sean Soriano,Shayilan Nuerdanbieke,2021-11-20,1,0,-5,5,3.545455,1.75,-2.539993,2.539993,0,0,-2.540009,2.540009,445,105,50,22,28,-28,1.79545450210571,-1.79545450210571,0,0,0,0,0,0,0,0,0,189,-189,189
Rafael Natal,Sean Spencer,Rafael Natal,2013-01-26,1,0,5,-5,2.333333,2,5.080002,-5.080002,15,-15,7.619995,-7.619995,342,11,30,18,12,-12,0.333333253860474,-0.333333253860474,0,0,0,0,0,0,0,0,0,0,0,0
Drew Dober,Sean Spencer,Sean Spencer,2013-11-30,0,1,-1,1,2.166667,2,-5.080002,5.080002,-15,15,-10.16,10.16,184,52,38,18,20,-20,0.166666746139526,-0.166666746139526,0,0,0,0,0,0,0,0,0,308,-308,308
Alex Garcia,Sean Spencer,Alex Garcia,2014-03-15,1,0,0,0,2.5,2,-2.540009,2.540009,0,0,-5.080002,5.080002,273,23,21,18,3,-3,0.5,-0.5,1,1,0,0,0,0,0,0,99,105,-6,6
Cathal Pendred,Sean Spencer,Cathal Pendred,2015-01-18,1,0,0,0,4.25,2,7.619995,-7.619995,0,0,2.539993,-2.539993,268,6,21,18,3,-3,2.25,-2.25,1,0,0,0,1,-1,0,0,106,309,-203,203
Mike Pyle,Sean Spencer,Mike Pyle,2016-02-06,1,0,12,-12,1.928571,2,5.080002,-5.080002,0,0,0,0,113,33,41,18,23,-23,-7.14285373687744e-02,7.14285373687744e-02,3,0,0,0,3,-3,0,0,714,384,330,-330
Yancy Medeiros,Sean Spencer,Yancy Medeiros,2016-09-10,1,0,0,0,1.875,2,0,0,-15,15,2.539993,-2.539993,17,0,23,18,5,-5,-0.125,0.125,0,0,1,1,0,0,0,0,119,217,-98,98
Robert McDaniel,Sean Strickland,Sean Strickland,2014-03-15,0,1,7,-7,2.8,5.6,5.080002,-5.080002,0,0,-2.539993,2.539993,26,155,38,33,5,-5,-2.79999995231628,2.79999995231628,0,0,0,0,0,0,0,0,199,0,199,-199
Luke Barnatt,Sean Strickland,Sean Strickland,2014-05-31,0,1,3,-3,3.25,5.6,12.7,-12.7,0,0,2.540009,-2.540009,30,41,17,33,-16,16,-2.34999990463257,2.34999990463257,3,1,0,0,2,-2,0,0,84,77,7,-7
Santiago Ponzinibbio,Sean Strickland,Santiago Ponzinibbio,2015-02-22,1,0,5,-5,4.285714,5.6,-2.539993,2.539993,-15,15,-7.619995,7.619995,28,82,37,33,4,-4,-1.31428575515747,1.31428575515747,0,2,0,0,-2,2,0,0,0,267,-267,267
Igor Araujo,Sean Strickland,Sean Strickland,2015-07-15,0,1,10,-10,2.777778,5.6,0,0,-15,15,2.540009,-2.540009,18,329,34,33,1,-1,-2.8222222328186,2.8222222328186,0,0,1,0,0,0,1,-1,305,143,162,-162
Alex Garcia,Sean Strickland,Sean Strickland,2016-02-21,0,1,4,-4,2.5,5.6,-10.16,10.16,-15,15,-10.15999,10.15999,209,167,21,33,-12,12,-3.09999990463257,3.09999990463257,1,1,0,0,0,0,0,0,225,221,4,-4
Tom Breese,Sean Strickland,Sean Strickland,2016-06-04,0,1,-1,1,4,5.6,5.080002,-5.080002,0,0,-7.619995,7.619995,11,18,15,33,-18,18,-1.59999990463257,1.59999990463257,3,2,0,0,1,-1,0,0,98,104,-6,6
Court McGee,Sean Strickland,Sean Strickland,2017-11-11,0,1,6,-6,1.833333,5.6,-5.080002,5.080002,-15,15,-2.539993,2.539993,101,163,34,33,1,-1,-3.76666653156281,3.76666653156281,0,3,1,0,-3,3,1,-1,300,525,-225,225
Jack Marshman,Sean Strickland,Sean Strickland,2020-10-31,0,1,1,-1,2.3,5.6,-2.539993,2.539993,0,0,-7.619995,7.619995,0,0,33,33,0,0,-3.29999995231628,3.29999995231628,0,4,1,0,-4,4,1,-1,483,1085,-602,602
Brendan Allen,Sean Strickland,Sean Strickland,2020-11-14,0,1,-5,5,4.4,5.6,2.540009,-2.540009,0,0,-2.539993,2.539993,0,94,27,33,-6,6,-1.19999980926514,1.19999980926514,3,5,0,0,-2,2,0,0,140,14,126,-126
Krzysztof Jotko,Sean Strickland,Sean Strickland,2021-05-01,0,1,1,-1,4,5.6,0,0,0,0,2.540009,-2.540009,0,0,30,33,-3,3,-1.59999990463257,1.59999990463257,0,6,1,0,-6,6,1,-1,1113,168,945,-945
Uriah Hall,Sean Strickland,Sean Strickland,2021-07-31,0,1,7,-7,1.636364,5.6,-2.539993,2.539993,0,0,7.62001,-7.62001,0,422,29,33,-4,4,-3.96363627910614,3.96363627910614,4,7,1,0,-3,3,1,-1,98,91,7,-7
Jack Hermansson,Sean Strickland,Sean Strickland,2022-02-05,0,1,3,-3,2.875,5.6,0,0,0,0,2.540009,-2.540009,31,0,31,33,-2,2,-2.72499990463257,2.72499990463257,1,8,1,0,-7,7,1,-1,259,189,70,-70
Alex Pereira,Sean Strickland,Alex Pereira,2022-07-02,1,0,3,-3,4,5.6,7.619995,-7.619995,20,-20,7.62001,-7.62001,3,0,10,33,-23,23,-1.59999990463257,1.59999990463257,1,9,0,0,-8,8,0,0,112,147,-35,35
Jared Cannonier,Sean Strickland,Jared Cannonier,2022-12-17,1,0,7,-7,2.833333,5.6,-5.080002,5.080002,0,0,2.540009,-2.540009,0,48,23,33,-10,10,-2.76666665077209,2.76666665077209,1,0,2,1,1,-1,1,-1,483,168,315,-315
Nassourdine Imavov,Sean Strickland,Sean Strickland,2023-01-14,0,1,-4,4,3,5.6,5.080002,-5.080002,0,0,-2.539993,2.539993,12,252,16,33,-17,17,-2.59999990463257,2.59999990463257,2,0,0,1,2,-2,-1,1,434,28,406,-406
Abus Magomedov,Sean Strickland,Sean Strickland,2023-07-01,0,1,0,0,5,5.6,2.540009,-2.540009,0,0,5.080002,-5.080002,23,10,30,33,-3,3,-0.599999904632568,0.599999904632568,1,1,0,1,0,0,-1,1,301,168,133,-133
Israel Adesanya,Sean Strickland,Sean Strickland,2023-09-09,0,1,2,-2,8,5.6,7.619995,-7.619995,0,0,10.16,-10.16,0,14,27,33,-6,6,2.40000009536743,-2.40000009536743,1,2,1,1,-1,1,0,0,154,70,84,-84
Kyle Bochniak,Sean Woodson,Sean Woodson,2019-10-18,0,1,5,-5,1.6,10,-17.78001,17.78001,0,0,-20.31999,20.31999,268,0,13,11,2,-2,-8.39999997615814,8.39999997615814,0,0,0,0,0,0,0,0,314,0,314,-314
Julian Erosa,Sean Woodson,Julian Erosa,2020-06-27,1,0,2,-2,2.333333,10,-2.540009,2.540009,0,0,-10.15999,10.15999,73,5,40,11,29,-29,-7.66666674613953,7.66666674613953,0,1,2,0,-1,1,2,-2,595,253,342,-342
Collin Anglin,Sean Woodson,Sean Woodson,2021-11-13,0,1,-1,1,2.666667,10,-12.70001,12.70001,0,0,-17.78,17.78,13,22,11,11,0,0,-7.33333325386047,7.33333325386047,0,0,1,0,0,0,1,-1,105,504,-399,399
Dennis Buzukja,Sean Woodson,Sean Woodson,2023-08-05,0,1,-6,6,2.666667,10,-12.70001,12.70001,0,0,-20.31999,20.31999,150,352,11,11,0,0,-7.33333325386047,7.33333325386047,0,1,0,0,-1,1,0,0,0,630,-630,630
Cody Brundage,Sedriques Dumas,Sedriques Dumas,2023-06-24,0,1,2,-2,1.8,8,-5.080002,5.080002,0,0,-17.78,17.78,113,668,14,9,5,-5,-6.20000004768372,6.20000004768372,0,0,1,0,0,0,1,-1,56,0,56,-56
Josh Barnett,Semmy Schilt,Josh Barnett,2001-06-29,1,0,-4,4,4.375,1.857143,-17.78,17.78,-15,15,-12.88,12.88,215,32,43,40,3,-3,2.51785719394684,-2.51785719394684,0,0,1,0,0,0,1,-1,126,0,126,-126
Cortney Casey,Seo Hee Ham,Seo Hee Ham,2015-11-28,0,1,0,0,1,2.125,12.7,-12.7,10,-10,12.7,-12.7,21,123,20,25,-5,5,-1.125,1.125,0,0,0,0,0,0,0,0,133,0,133,-133
Alistair Overeem,Sergei Pavlovich,Alistair Overeem,2018-11-24,1,0,12,-12,2.473684,18,2.539993,-2.539993,8,-8,-10.16,10.16,116,12,66,19,47,-47,-15.5263156890869,15.5263156890869,2,0,2,0,2,-2,2,-2,504,0,504,-504
Marcelo Golm,Sergei Pavlovich,Sergei Pavlovich,2019-04-20,0,1,0,0,2,18,0,0,-8,8,-22.86,22.86,0,1,9,19,-10,10,-16,16,0,0,0,1,0,0,-1,1,441,147,294,-294
Maurice Greene,Sergei Pavlovich,Sergei Pavlovich,2019-10-26,0,1,6,-6,1.285714,18,10.16,-10.16,1,-1,-10.16,10.16,0,14,16,19,-3,3,-16.7142857313156,16.7142857313156,1,1,0,1,0,0,-1,1,231,189,42,-42
Shamil Abdurakhimov,Sergei Pavlovich,Sergei Pavlovich,2022-03-19,0,1,11,-11,2.5,18,0,0,-22,22,-20.32001,20.32001,0,12,28,19,9,-9,-15.5,15.5,0,2,4,1,-2,2,3,-3,175,875,-700,700
Derrick Lewis,Sergei Pavlovich,Sergei Pavlovich,2022-07-30,0,1,7,-7,2.454545,18,0,0,3,-3,-12.7,12.7,0,2,38,19,19,-19,-15.5454545021057,15.5454545021057,0,3,2,1,-3,3,1,-1,168,133,35,-35
Curtis Blaydes,Sergei Pavlovich,Sergei Pavlovich,2023-04-22,0,1,2,-2,4.25,18,2.539993,-2.539993,8,-8,-10.16,10.16,0,0,21,19,2,-2,-13.75,13.75,2,4,3,1,-2,2,2,-2,392,266,126,-126
Rostem Akman,Sergey Khandozhko,Sergey Khandozhko,2019-06-01,0,1,0,0,3,4.666667,-7.619995,7.619995,0,0,-5.080002,5.080002,200,61,8,34,-26,26,-1.66666650772095,1.66666650772095,0,0,0,0,0,0,0,0,0,0,0,0
Rustam Khabilov,Sergey Khandozhko,Rustam Khabilov,2019-11-09,1,0,6,-6,6,4.666667,-12.7,12.7,-15,15,-2.540009,2.540009,635,7,28,34,-6,6,1.33333349227905,-1.33333349227905,4,1,0,0,3,-3,0,0,1064,161,903,-903
Dwight Grant,Sergey Khandozhko,Sergey Khandozhko,2022-04-23,0,1,8,-8,1.833333,4.666667,0,0,15,-15,5.079987,-5.079987,20,48,17,34,-17,17,-2.83333313465118,2.83333313465118,0,0,1,0,0,0,1,-1,182,896,-714,714
Walt Harris,Serghei Spivac,Walt Harris,2019-05-04,1,0,11,-11,1.3,4,5.080002,-5.080002,-10,10,-2.539993,2.539993,5,0,23,20,3,-3,-2.70000004768372,2.70000004768372,1,0,2,0,1,-1,2,-2,337,0,337,-337
Carlos Felipe,Serghei Spivac,Serghei Spivac,2020-07-18,0,1,0,0,5.5,4,-7.619995,7.619995,-15,15,-7.619995,7.619995,0,292,13,20,-7,7,1.5,-1.5,0,0,0,1,0,0,-1,1,0,441,-441,441
Aleksei Oleinik,Serghei Spivac,Serghei Spivac,2021-06-19,0,1,17,-17,3.529412,4,-2.539993,2.539993,-20,20,5.080002,-5.080002,211,291,77,20,57,-57,-0.470588207244873,0.470588207244873,1,1,1,1,0,0,0,0,406,336,70,-70
Tom Aspinall,Serghei Spivac,Tom Aspinall,2021-09-04,1,0,2,-2,4.333333,4,5.080002,-5.080002,-4,4,0,0,3,0,16,20,-4,4,0.333333492279053,-0.333333492279053,2,2,0,1,0,0,-1,1,329,77,252,-252
Greg Hardy,Serghei Spivac,Serghei Spivac,2022-03-05,0,1,6,-6,1.4,4,5.080002,-5.080002,5,-5,5.080002,-5.080002,0,81,12,20,-8,8,-2.60000002384186,2.60000002384186,0,0,2,2,0,0,0,0,238,182,56,-56
Augusto Sakai,Serghei Spivac,Serghei Spivac,2022-08-06,0,1,4,-4,3.2,4,0,0,5,-5,-2.539993,2.539993,23,397,21,20,1,-1,-0.799999952316284,0.799999952316284,0,1,1,2,-1,1,-1,1,238,154,84,-84
Derrick Lewis,Serghei Spivac,Serghei Spivac,2023-02-04,0,1,9,-9,2.454545,4,0,0,0,0,2.540009,-2.540009,0,152,38,20,18,-18,-1.54545450210571,1.54545450210571,0,2,3,2,-2,2,1,-1,189,182,7,-7
Ciryl Gane,Serghei Spivac,Ciryl Gane,2023-09-02,1,0,5,-5,6,4,2.539993,-2.539993,-15,15,7.62001,-7.62001,9,2,14,20,-6,6,2,-2,0,3,0,2,-3,3,-2,2,182,210,-28,28
Cezar Ferreira,Sergio Moraes,Cezar Ferreira,2012-06-23,1,0,-2,2,1.625,2.333333,2.539993,-2.539993,15,-15,15.23999,-15.23999,53,0,21,20,1,-1,-0.708333253860474,0.708333253860474,0,0,0,0,0,0,0,0,0,0,0,0
Renee Forte,Sergio Moraes,Sergio Moraes,2012-10-13,0,1,-5,5,2,2.333333,-12.70001,12.70001,-15,15,-2.540009,2.540009,58,261,12,20,-8,8,-0.333333253860474,0.333333253860474,0,0,0,0,0,0,0,0,0,112,-112,112
Neil Magny,Sergio Moraes,Sergio Moraes,2013-08-03,0,1,-5,5,2.333333,2.333333,7.619995,-7.619995,0,0,20.31999,-20.31999,21,66,40,20,20,-20,0,0,1,1,0,0,0,0,0,0,161,294,-133,133
Mickael Lebout,Sergio Moraes,Sergio Moraes,2015-04-11,0,1,-5,5,2.285714,2.333333,-2.540009,2.540009,-15,15,2.539993,-2.539993,4,239,23,20,3,-3,-4.76188659667969e-02,4.76188659667969e-02,0,2,0,0,-2,2,0,0,0,616,-616,616
Omari Akhmedov,Sergio Moraes,Sergio Moraes,2015-12-10,0,1,-5,5,3.5,2.333333,0,0,15,-15,2.539993,-2.539993,51,2,27,20,7,-7,1.16666674613953,-1.16666674613953,2,3,0,0,-1,1,0,0,187,243,-56,56
Tim Means,Sergio Moraes,Sergio Moraes,2018-02-03,0,1,-2,2,2.2,2.333333,5.080002,-5.080002,0,0,7.619995,-7.619995,82,0,48,20,28,-28,-0.133333206176758,0.133333206176758,0,4,0,0,-4,4,0,0,77,786,-709,709
Warlley Alves,Sergio Moraes,Warlley Alves,2019-05-11,1,0,-8,8,2.5,2.333333,-2.540009,2.540009,0,0,0,0,1,0,21,20,1,-1,0.166666746139526,-0.166666746139526,0,5,1,0,-5,5,1,-1,259,462,-203,203
James Krause,Sergio Moraes,James Krause,2019-11-16,1,0,-4,4,3.111111,2.333333,5.080002,-5.080002,0,0,2.539993,-2.539993,131,137,37,20,17,-17,0.777777910232544,-0.777777910232544,1,0,0,1,1,-1,-1,1,671,189,482,-482
Will Campuzano,Sergio Pettis,Sergio Pettis,2013-11-16,0,1,7,-7,2.333333,3.6,7.619995,-7.619995,0,0,2.540009,-2.540009,332,123,20,23,-3,3,-1.26666665077209,1.26666665077209,0,0,0,0,0,0,0,0,1029,0,1029,-1029
Alex Caceres,Sergio Pettis,Alex Caceres,2014-01-25,1,0,5,-5,1.5,3.6,10.16,-10.16,20,-20,10.16,-10.16,93,13,35,23,12,-12,-2.09999990463257,2.09999990463257,3,1,0,0,2,-2,0,0,126,70,56,-56
Yaotzin Meza,Sergio Pettis,Sergio Pettis,2014-06-07,0,1,13,-13,1.909091,3.6,7.619995,-7.619995,20,-20,5.080002,-5.080002,81,4,32,23,9,-9,-1.69090902805328,1.69090902805328,0,0,0,0,0,0,0,0,0,133,-133,133
Matt Hobar,Sergio Pettis,Sergio Pettis,2014-12-06,0,1,6,-6,3,3.6,10.16,-10.16,10,-10,2.540009,-2.540009,260,95,12,23,-11,11,-0.599999904632568,0.599999904632568,1,1,1,0,0,0,1,-1,105,182,-77,77
Ryan Benoit,Sergio Pettis,Ryan Benoit,2015-03-14,1,0,4,-4,1.25,3.6,-2.539993,2.539993,0,0,-2.539993,2.539993,22,97,18,23,-5,5,-2.34999990463257,2.34999990463257,0,2,0,0,-2,2,0,0,469,98,371,-371
Chris Cariaso,Sergio Pettis,Sergio Pettis,2015-10-03,0,1,12,-12,2.125,3.6,-7.619995,7.619995,0,0,-12.7,12.7,250,352,25,23,2,-2,-1.47499990463257,1.47499990463257,0,0,0,1,0,0,-1,1,203,203,0,0
Chris Kelades,Sergio Pettis,Sergio Pettis,2016-04-23,0,1,13,-13,3,3.6,2.539993,-2.539993,0,0,-2.539993,2.539993,115,295,12,23,-11,11,-0.599999904632568,0.599999904632568,0,1,0,1,-1,1,-1,1,0,203,-203,203
John Moraga,Sergio Pettis,Sergio Pettis,2017-01-15,0,1,9,-9,2.714286,3.6,0,0,0,0,-7.619995,7.619995,163,84,26,23,3,-3,-0.885714292526245,0.885714292526245,0,2,0,1,-2,2,-1,1,191,267,-76,76
Brandon Moreno,Sergio Pettis,Sergio Pettis,2017-08-05,0,1,0,0,3,3.6,2.539993,-2.539993,0,0,2.540009,-2.540009,468,13,28,23,5,-5,-0.599999904632568,0.599999904632568,2,3,0,1,-1,1,-1,1,105,202,-97,97
Henry Cejudo,Sergio Pettis,Henry Cejudo,2017-12-02,1,0,6,-6,5.333333,3.6,-5.080002,5.080002,10,-10,-12.7,12.7,575,0,19,23,-4,4,1.73333358764648,-1.73333358764648,1,4,1,1,-3,3,0,0,84,119,-35,35
Joseph Benavidez,Sergio Pettis,Sergio Pettis,2018-06-09,0,1,9,-9,3.5,3.6,-5.080002,5.080002,0,0,-10.15999,10.15999,264,0,36,23,13,-13,-9.99999046325684e-02,9.99999046325684e-02,5,0,1,1,5,-5,0,0,553,189,364,-364
Jussier Formiga,Sergio Pettis,Jussier Formiga,2018-10-06,1,0,8,-8,2.875,3.6,-2.539993,2.539993,0,0,-5.080002,5.080002,446,0,31,23,8,-8,-0.724999904632568,0.724999904632568,6,1,0,1,5,-5,-1,1,238,119,119,-119
Rob Font,Sergio Pettis,Rob Font,2018-12-15,1,0,6,-6,2.857143,3.6,5.080002,-5.080002,10,-10,5.080002,-5.080002,291,16,27,23,4,-4,-0.742856979370117,0.742856979370117,0,0,0,1,0,0,-1,1,413,70,343,-343
Tyson Nam,Sergio Pettis,Sergio Pettis,2019-09-21,0,1,9,-9,1.5,3.6,2.539993,-2.539993,0,0,-2.539993,2.539993,46,2,35,23,12,-12,-2.09999990463257,2.09999990463257,0,0,0,1,0,0,-1,1,0,280,-280,280
Thiago Alves,Seth Baczynski,Thiago Alves,2014-04-19,1,0,-2,2,1.533333,1.428571,-15.24001,15.24001,0,0,-12.7,12.7,4,47,38,34,4,-4,0.104761838912964,-0.104761838912964,0,0,1,0,0,0,1,-1,778,0,778,-778
Matt Hamill,Seth Petruzelli,Matt Hamill,2006-10-10,1,0,4,-4,1.5,1.75,2.539993,-2.539993,0,0,0,0,608,11,20,22,-2,2,-0.25,0.25,0,0,0,0,0,0,0,0,0,0,0,0
Wilson Gouveia,Seth Petruzelli,Wilson Gouveia,2007-04-05,1,0,1,-1,1.75,1.75,2.539993,-2.539993,-20,20,0,0,194,14,22,22,0,0,0,0,0,0,0,0,0,0,0,0,285,177,108,-108
Alex Caceres,SeungWoo Choi,Alex Caceres,2021-10-23,1,0,5,-5,1.5,1.833333,-5.080002,5.080002,0,0,-2.540009,2.540009,49,15,35,17,18,-18,-0.333333373069763,0.333333373069763,4,0,1,0,4,-4,1,-1,238,0,238,-238
Klidson Abreu,Shamil Gamzatov,Shamil Gamzatov,2019-11-09,0,1,-3,3,3.75,14,-5.080002,5.080002,0,0,-5.079987,5.079987,106,11,19,15,4,-4,-10.25,10.25,1,0,0,0,1,-1,0,0,112,0,112,-112
Ariel Beck,Shana Dobson,Shana Dobson,2017-12-01,0,1,-1,1,0.8,0.8,0,0,0,0,-7.619995,7.619995,9,0,9,9,0,0,0,0,0,0,0,0,0,0,0,0,0,0,0,0
Priscila Cachoeira,Shana Dobson,Priscila Cachoeira,2020-02-22,1,0,1,-1,2.4,0.8,2.539993,-2.539993,0,0,-10.15999,10.15999,2,0,17,9,8,-8,1.6000000834465,-1.6000000834465,0,1,0,0,-1,1,0,0,287,813,-526,526
Mariya Agapova,Shana Dobson,Shana Dobson,2020-08-22,0,1,-8,8,2.5,0.8,0,0,0,0,-2.539993,2.539993,191,150,14,9,5,-5,1.69999998807907,-1.69999998807907,1,0,0,1,1,-1,-1,1,70,182,-112,112
Makwan Amirkhani,Shane Burgos,Shane Burgos,2019-11-02,0,1,2,-2,1.888889,5,-2.539993,2.539993,0,0,-7.619995,7.619995,259,211,26,18,8,-8,-3.11111116409302,3.11111116409302,5,0,0,0,5,-5,0,0,154,0,154,-154
Edson Barboza,Shane Burgos,Edson Barboza,2021-05-15,1,0,5,-5,2.090909,5,0,0,0,0,0,0,0,3,34,18,16,-16,-2.90909099578857,2.90909099578857,0,1,3,0,-1,1,3,-3,364,560,-196,196
Pat Barry,Shane del Rosario,Pat Barry,2012-12-15,1,0,4,-4,1.142857,5.5,-12.7,12.7,-15,15,-8.039993,8.039993,19,199,15,13,2,-2,-4.35714280605316,4.35714280605316,0,0,2,0,0,0,2,-2,224,0,224,-224
Ray Borg,Shane Howell,Ray Borg,2014-06-28,1,0,-10,10,2.6,1.3,-10.16,10.16,10,-10,-17.98,17.98,105,0,18,23,-5,5,1.29999995231628,-1.29999995231628,0,0,0,0,0,0,0,0,70,0,70,-70
Paddy Holohan,Shane Howell,Paddy Holohan,2015-01-18,1,0,-5,5,6,1.3,5.080002,-5.080002,0,0,-2.740005,2.740005,596,15,14,23,-9,9,4.70000004768372,-4.70000004768372,0,0,0,0,0,0,0,0,106,204,-98,98
Melvin Guillard,Shane Roller,Melvin Guillard,2011-07-02,1,0,-3,3,1.777778,1.571429,-2.540009,2.540009,0,0,-2.540009,2.540009,6,0,50,18,32,-32,0.20634925365448,-0.20634925365448,5,0,0,0,5,-5,0,0,280,0,280,-280
TJ Grant,Shane Roller,TJ Grant,2011-10-01,1,0,-5,5,4.2,1.571429,0,0,0,0,0,0,298,165,26,18,8,-8,2.62857127189636,-2.62857127189636,1,0,0,1,1,-1,-1,1,371,91,280,-280
Michael Johnson,Shane Roller,Michael Johnson,2012-01-28,1,0,-7,7,1.157895,1.571429,0,0,0,0,2.539993,-2.539993,265,233,41,18,23,-23,-0.413533806800842,0.413533806800842,0,0,0,1,0,0,-1,1,119,119,0,0
John Alessio,Shane Roller,Shane Roller,2012-07-07,0,1,1,-1,2.058824,1.571429,0,0,0,0,0,0,126,479,52,18,34,-34,0.487395048141479,-0.487395048141479,0,0,0,1,0,0,-1,1,77,161,-84,84
Alexander Volkanovski,Shane Young,Alexander Volkanovski,2017-11-18,1,0,5,-5,13,1.625,-5.080002,5.080002,0,0,-2.540009,2.540009,502,16,28,21,7,-7,11.375,-11.375,0,0,0,0,0,0,0,0,0,0,0,0
Rolando Dy,Shane Young,Shane Young,2018-06-23,0,1,3,-3,1.285714,1.625,0,0,0,0,-7.62001,7.62001,0,104,16,21,-5,5,-0.339285731315613,0.339285731315613,0,0,0,0,0,0,0,0,274,217,57,-57
Austin Arnett,Shane Young,Shane Young,2019-02-09,0,1,2,-2,2.666667,1.625,10.16,-10.16,0,0,0,0,0,16,22,21,1,-1,1.04166674613953,-1.04166674613953,1,1,1,0,0,0,1,-1,84,231,-147,147
Ludovit Klein,Shane Young,Ludovit Klein,2020-09-26,1,0,-2,2,5,1.625,-2.540009,2.540009,10,-10,0,0,3,0,24,21,3,-3,3.375,-3.375,0,2,0,0,-2,2,0,0,0,595,-595,595
Omar Morales,Shane Young,Omar Morales,2021-03-27,1,0,8,-8,2.75,1.625,7.619995,-7.619995,10,-10,2.539993,-2.539993,87,206,15,21,-6,6,1.125,-1.125,0,0,0,1,0,0,-1,1,0,182,-182,182
Blake Bilder,Shane Young,Blake Bilder,2023-02-11,1,0,3,-3,8,1.625,0,0,0,0,-10.16,10.16,103,3,9,21,-12,12,6.375,-6.375,0,0,0,1,0,0,-1,1,0,686,-686,686
Gabriel Miranda,Shane Young,Gabriel Miranda,2023-09-09,1,0,3,-3,2.833333,1.625,7.619995,-7.619995,0,0,-2.540009,2.540009,32,0,23,21,2,-2,1.20833325386047,-1.20833325386047,0,0,1,1,0,0,0,0,371,210,161,-161
Macy Chiasson,Shanna Young,Macy Chiasson,2020-02-15,1,0,0,0,3,1.5,10.16,-10.16,10,-10,17.78,-17.78,513,22,12,15,-3,3,1.5,-1.5,0,0,0,0,0,0,0,0,140,0,140,-140
Stephanie Egger,Shanna Young,Stephanie Egger,2021-10-02,1,0,3,-3,2,1.5,-2.539993,2.539993,0,0,7.619995,-7.619995,208,23,12,15,-3,3,0.5,-0.5,0,0,0,0,0,0,0,0,0,595,-595,595
Gina Mazany,Shanna Young,Shanna Young,2022-04-30,0,1,2,-2,1.166667,1.5,-2.539993,2.539993,0,0,7.619995,-7.619995,82,57,13,15,-2,2,-0.333333373069763,0.333333373069763,2,0,0,1,2,-2,-1,1,518,210,308,-308
Miranda Maverick,Shanna Young,Miranda Maverick,2022-11-05,1,0,-6,6,2.8,1.5,-10.15999,10.15999,0,0,0,0,554,0,19,15,4,-4,1.29999995231628,-1.29999995231628,2,1,0,1,1,-1,-1,1,238,189,49,-49
Spencer Fisher,Shannon Gugerty,Spencer Fisher,2008-10-25,1,0,6,-6,2.666667,2.142857,-7.62001,7.62001,0,0,-7.619995,7.619995,168,379,33,22,11,-11,0.523809671401978,-0.523809671401978,2,0,1,0,2,-2,1,-1,126,0,126,-126
Matt Grice,Shannon Gugerty,Shannon Gugerty,2009-07-11,0,1,0,0,3,2.142857,-5.080002,5.080002,-10,10,-2.539993,2.539993,36,73,20,22,-2,2,0.857142925262451,-0.857142925262451,0,0,1,0,0,0,1,-1,154,259,-105,105
Terry Etim,Shannon Gugerty,Terry Etim,2009-11-14,1,0,-4,4,3.2,2.142857,7.619995,-7.619995,0,0,5.080002,-5.080002,38,51,21,22,-1,1,1.05714297294617,-1.05714297294617,1,1,0,0,0,0,0,0,392,126,266,-266
Kleydson Rodrigues,Shannon Ross,Kleydson Rodrigues,2023-02-11,1,0,-6,6,2.666667,1.625,-2.539993,2.539993,10,-10,2.539993,-2.539993,0,0,11,21,-10,10,1.04166674613953,-1.04166674613953,0,0,0,0,0,0,0,0,280,0,280,-280
Jesus Aguilar,Shannon Ross,Jesus Aguilar,2023-07-08,1,0,-7,7,4.5,1.625,-5.080002,5.080002,0,0,-10.16,10.16,0,0,11,21,-10,10,2.875,-2.875,0,0,0,1,0,0,-1,1,154,147,7,-7
Alex Oliveira,Shavkat Rakhmonov,Shavkat Rakhmonov,2020-10-24,0,1,6,-6,1.833333,17,-5.080002,5.080002,0,0,-2.540009,2.540009,124,44,34,17,17,-17,-15.1666666269302,15.1666666269302,1,0,0,0,1,-1,0,0,91,0,91,-91
Michel Prazeres,Shavkat Rakhmonov,Shavkat Rakhmonov,2021-06-26,0,1,13,-13,6.5,17,-17.78,17.78,0,0,-25.40001,25.40001,58,205,30,17,13,-13,-10.5,10.5,2,1,0,0,1,-1,0,0,2652,245,2407,-2407
Carlston Harris,Shavkat Rakhmonov,Shavkat Rakhmonov,2022-02-05,0,1,7,-7,3.8,17,-2.539993,2.539993,0,0,-2.540009,2.540009,44,52,24,17,7,-7,-13.2000000476837,13.2000000476837,1,2,0,0,-1,1,0,0,140,224,-84,84
Neil Magny,Shavkat Rakhmonov,Shavkat Rakhmonov,2022-06-25,0,1,7,-7,2.333333,17,5.080002,-5.080002,0,0,7.619995,-7.619995,7,546,40,17,23,-23,-14.6666667461395,14.6666667461395,2,3,1,0,-1,1,1,-1,413,140,273,-273
Geoff Neal,Shavkat Rakhmonov,Shavkat Rakhmonov,2023-03-04,0,1,4,-4,3,17,-5.080002,5.080002,0,0,-5.080002,5.080002,72,223,20,17,3,-3,-14,14,1,4,0,0,-3,3,0,0,448,252,196,-196
Pat Barry,Shawn Jordan,Shawn Jordan,2013-06-15,0,1,5,-5,1.142857,2.375,-2.540009,2.540009,-25,25,-2.539993,2.539993,0,5,15,27,-12,12,-1.23214280605316,1.23214280605316,1,0,2,0,1,-1,2,-2,182,0,182,-182
Gabriel Gonzaga,Shawn Jordan,Gabriel Gonzaga,2013-10-19,1,0,6,-6,1.545455,2.375,5.080002,-5.080002,-18,18,2.539993,-2.539993,3,0,28,27,1,-1,-0.829545497894287,0.829545497894287,3,1,1,0,2,-2,1,-1,105,126,-21,21
Jared Cannonier,Shawn Jordan,Shawn Jordan,2015-01-03,0,1,0,0,2.833333,2.375,-2.540009,2.540009,-75,75,5.080002,-5.080002,0,3,23,27,-4,4,0.458333253860474,-0.458333253860474,0,0,0,1,0,0,-1,1,0,441,-441,441
Josh Culibao,Shayilan Nuerdanbieke,Josh Culibao,2021-05-22,1,0,-1,1,5.5,3.545455,5.080002,-5.080002,0,0,10.16,-10.16,4,366,13,50,-37,37,1.95454549789429,-1.95454549789429,0,0,1,0,0,0,1,-1,455,0,455,-455
TJ Brown,Shayilan Nuerdanbieke,Shayilan Nuerdanbieke,2022-06-25,0,1,4,-4,1.7,3.545455,2.539993,-2.539993,0,0,7.62001,-7.62001,174,452,27,50,-23,23,-1.845454454422,1.845454454422,2,0,0,0,2,-2,0,0,161,399,-238,238
Darrick Minner,Shayilan Nuerdanbieke,Shayilan Nuerdanbieke,2022-11-05,0,1,4,-4,1.857143,3.545455,-2.540009,2.540009,0,0,0,0,0,33,40,50,-10,10,-1.68831169605255,1.68831169605255,1,1,0,0,0,0,0,0,623,133,490,-490
Steve Garcia,Shayilan Nuerdanbieke,Steve Garcia,2023-04-08,1,0,2,-2,2.8,3.545455,10.16,-10.16,0,0,15.24001,-15.24001,15,214,19,50,-31,31,-0.745454549789429,0.745454549789429,2,2,0,0,0,0,0,0,161,154,7,-7
Elias Theodorou,Sheldon Westcott,Elias Theodorou,2014-04-16,1,0,-4,4,5.333333,3.333333,0,0,15,-15,10.16,-10.16,244,201,19,13,6,-6,2.00000023841858,-2.00000023841858,0,0,0,0,0,0,0,0,0,0,0,0
Pawel Pawlak,Sheldon Westcott,Pawel Pawlak,2015-04-11,1,0,-4,4,4,3.333333,-2.539993,2.539993,0,0,5.080002,-5.080002,187,598,15,13,2,-2,0.666666746139526,-0.666666746139526,0,0,0,1,0,0,-1,1,315,360,-45,45
Edgar Garcia,Sheldon Westcott,Sheldon Westcott,2016-01-02,0,1,0,0,2.8,3.333333,-7.619995,7.619995,0,0,0,0,0,147,19,13,6,-6,-0.533333301544189,0.533333301544189,0,0,0,1,0,0,-1,1,413,266,147,-147
Antoni Hardonk,Sherman Pendergarst,Antoni Hardonk,2006-11-18,1,0,-9,9,1.333333,0.6111111,7.619995,-7.619995,10,-10,10.12,-10.12,0,164,14,29,-15,15,0.72222226858139,-0.72222226858139,0,0,0,0,0,0,0,0,0,0,0,0
Zabit Magomedsharipov,Sheymon Moraes,Zabit Magomedsharipov,2017-11-25,1,0,-1,1,18,2.75,12.7,-12.7,0,0,2.539993,-2.539993,592,8,19,15,4,-4,15.25,-15.25,1,0,0,0,1,-1,0,0,84,0,84,-84
Julio Arce,Sheymon Moraes,Sheymon Moraes,2018-11-03,0,1,1,-1,3,2.75,-2.540009,2.540009,-10,10,-5.080002,5.080002,251,98,24,15,9,-9,0.25,-0.25,2,0,0,0,2,-2,0,0,155,343,-188,188
Andre Fili,Sheymon Moraes,Andre Fili,2019-07-13,1,0,1,-1,2.2,2.75,7.619995,-7.619995,0,0,5.080002,-5.080002,5,0,32,15,17,-17,-0.549999952316284,0.549999952316284,1,1,1,0,0,0,1,-1,146,252,-106,106
Kyung Ho Kang,Shunichi Shimizu,Kyung Ho Kang,2014-01-04,1,0,-2,2,2.111111,1.666667,10.15999,-10.15999,0,0,17.42,-17.42,495,109,28,48,-20,20,0.444444537162781,-0.444444537162781,0,0,0,0,0,0,0,0,0,0,0,0
Bethe Correia,Sijara Eubanks,Bethe Correia,2019-09-21,1,0,2,-2,1.833333,1.142857,2.540009,-2.540009,10,-10,-7.619995,7.619995,84,145,17,15,2,-2,0.690476179122925,-0.690476179122925,0,0,2,0,0,0,2,-2,826,0,826,-826
Julia Avila,Sijara Eubanks,Sijara Eubanks,2020-09-12,0,1,-3,3,4.5,1.142857,7.619995,-7.619995,10,-10,2.540009,-2.540009,114,612,11,15,-4,4,3.35714280605316,-3.35714280605316,2,0,0,0,2,-2,0,0,91,357,-266,266
Loopy Godinez,Silvana Gomez Juarez,Loopy Godinez,2021-10-09,1,0,-8,8,3.666667,2.2,-2.540009,2.540009,0,0,-10.16,10.16,207,0,14,16,-2,2,1.46666669845581,-1.46666669845581,0,0,0,0,0,0,0,0,175,0,175,-175
Vanessa Demopoulos,Silvana Gomez Juarez,Vanessa Demopoulos,2022-01-22,1,0,-4,4,1.8,2.2,-2.540009,2.540009,0,0,-15.24001,15.24001,0,71,14,16,-2,2,-0.400000095367432,0.400000095367432,0,0,0,0,0,0,0,0,0,105,-105,105
Seth Baczynski,Simeon Thoresen,Seth Baczynski,2012-09-22,1,0,2,-2,1.428571,2.833333,5.080002,-5.080002,0,0,-10.16,10.16,2,0,34,23,11,-11,-1.40476179122925,1.40476179122925,3,0,0,0,3,-3,0,0,106,0,106,-106
David Mitchell,Simeon Thoresen,David Mitchell,2013-01-26,1,0,5,-5,3.142857,2.833333,-2.539993,2.539993,0,0,-10.16,10.16,242,217,29,23,6,-6,0.309523820877075,-0.309523820877075,0,0,0,1,0,0,-1,1,518,126,392,-392
Nikita Krylov,Soa Palelei,Soa Palelei,2013-08-31,0,1,-15,15,3.333333,4.4,-2.539993,2.539993,-60,60,-10.16,10.16,137,456,39,27,12,-12,-1.06666684150696,1.06666684150696,0,0,0,0,0,0,0,0,0,0,0,0
Pat Barry,Soa Palelei,Soa Palelei,2013-12-06,0,1,-2,2,1.142857,4.4,-12.7,12.7,-30,30,-17.78,17.78,0,85,15,27,-12,12,-3.25714290142059,3.25714290142059,0,1,3,0,-1,1,3,-3,174,97,77,-77
Walt Harris,Soa Palelei,Soa Palelei,2014-11-07,0,1,-6,6,1.3,4.4,2.540009,-2.540009,-15,15,-10.16,10.16,0,94,23,27,-4,4,-3.10000014305115,3.10000014305115,0,2,1,0,-2,2,1,-1,286,336,-50,50
Suman Mokhtarian,Sodiq Yusuff,Sodiq Yusuff,2018-12-01,0,1,1,-1,1.6,6.5,-2.539993,2.539993,0,0,2.540009,-2.540009,34,57,13,15,-2,2,-4.89999997615814,4.89999997615814,0,0,0,0,0,0,0,0,0,0,0,0
Sheymon Moraes,Sodiq Yusuff,Sodiq Yusuff,2019-03-30,0,1,3,-3,2.75,6.5,-2.539993,2.539993,0,0,2.540009,-2.540009,81,159,15,15,0,0,-3.75,3.75,1,1,0,0,0,0,0,0,238,119,119,-119
Gabriel Benitez,Sodiq Yusuff,Sodiq Yusuff,2019-08-17,0,1,5,-5,2.090909,6.5,-2.539993,2.539993,10,-10,0,0,0,4,34,15,19,-19,-4.40909099578857,4.40909099578857,2,2,1,0,0,0,1,-1,616,140,476,-476
Andre Fili,Sodiq Yusuff,Sodiq Yusuff,2020-01-18,0,1,3,-3,2.2,6.5,5.080002,-5.080002,0,0,7.62001,-7.62001,123,255,32,15,17,-17,-4.29999995231628,4.29999995231628,2,3,1,0,-1,1,1,-1,189,154,35,-35
Arnold Allen,Sodiq Yusuff,Arnold Allen,2021-04-10,1,0,0,0,9.5,6.5,-2.539993,2.539993,0,0,-2.539993,2.539993,309,153,21,15,6,-6,3,-3,7,4,0,0,3,-3,0,0,441,448,-7,7
Alex Caceres,Sodiq Yusuff,Sodiq Yusuff,2022-03-12,0,1,5,-5,1.5,6.5,2.540009,-2.540009,0,0,5.080002,-5.080002,21,162,35,15,20,-20,-5,5,5,0,1,0,5,-5,1,-1,140,336,-196,196
Don Shainis,Sodiq Yusuff,Sodiq Yusuff,2022-10-01,0,1,3,-3,2.4,6.5,-7.619995,7.619995,0,0,-10.16,10.16,11,2,17,15,2,-2,-4.09999990463257,4.09999990463257,0,1,0,0,-1,1,0,0,0,203,-203,203
Luigi Fioravanti,Solomon Hutcherson,Luigi Fioravanti,2006-06-24,1,0,-8,8,1.733333,1.571429,-7.619995,7.619995,-15,15,-5.199997,5.199997,47,99,41,18,23,-23,0.161904811859131,-0.161904811859131,0,0,0,0,0,0,0,0,79,0,79,-79
Hector Aldana,Song Kenan,Song Kenan,2018-06-23,0,1,1,-1,1.333333,2.857143,-2.540009,2.540009,0,0,2.540009,-2.540009,11,4,7,27,-20,20,-1.52380955219269,1.52380955219269,0,0,0,0,0,0,0,0,0,0,0,0
Max Griffin,Song Kenan,Max Griffin,2021-03-20,1,0,4,-4,1.9,2.857143,-2.540009,2.540009,0,0,12.7,-12.7,28,0,29,27,2,-2,-0.957142949104309,0.957142949104309,0,1,0,0,-1,1,0,0,378,1001,-623,623
Ian Garry,Song Kenan,Ian Garry,2023-03-04,1,0,-7,7,13,2.857143,7.619995,-7.619995,0,0,7.62001,-7.62001,5,44,13,27,-14,14,10.1428570747375,-10.1428570747375,3,0,0,1,3,-3,-1,1,245,714,-469,469
Rolando Bedoya,Song Kenan,Song Kenan,2023-08-26,0,1,-7,7,4.666667,2.857143,-2.540009,2.540009,0,0,7.62001,-7.62001,33,40,17,27,-10,10,1.8095235824585,-1.8095235824585,0,0,0,2,0,0,-2,2,112,175,-63,63
Bharat Kandare,Song Yadong,Song Yadong,2017-11-25,0,1,11,-11,1.666667,2.857143,-2.540009,2.540009,0,0,12.70001,-12.70001,0,8,8,27,-19,19,-1.19047629833221,1.19047629833221,0,0,0,0,0,0,0,0,0,0,0,0
Felipe Arantes,Song Yadong,Song Yadong,2018-06-23,0,1,10,-10,1.8,2.857143,0,0,0,0,15.24001,-15.24001,16,374,28,27,1,-1,-1.05714297294617,1.05714297294617,0,1,0,0,-1,1,0,0,245,210,35,-35
Vince Morales,Song Yadong,Song Yadong,2018-11-24,0,1,8,-8,1.571429,2.857143,2.539993,-2.539993,0,0,7.62001,-7.62001,5,162,18,27,-9,9,-1.28571438789368,1.28571438789368,0,2,0,0,-2,2,0,0,0,154,-154,154
Alejandro Perez,Song Yadong,Song Yadong,2019-07-06,0,1,8,-8,2.555556,2.857143,-5.080002,5.080002,0,0,0,0,0,1,32,27,5,-5,-0.301587343215942,0.301587343215942,0,3,0,0,-3,3,0,0,126,224,-98,98
Marlon Vera,Song Yadong,Song Yadong,2020-05-16,0,1,5,-5,2.625,2.857143,0,0,0,0,7.62001,-7.62001,195,60,29,27,2,-2,-0.232142925262451,0.232142925262451,0,4,0,0,-4,4,0,0,0,315,-315,315
Kyler Phillips,Song Yadong,Kyler Phillips,2021-03-06,1,0,2,-2,5.5,2.857143,0,0,0,0,12.70001,-12.70001,96,66,13,27,-14,14,2.64285707473755,-2.64285707473755,1,5,0,0,-4,4,0,0,371,294,77,-77
Casey Kenney,Song Yadong,Song Yadong,2021-08-07,0,1,7,-7,4,2.857143,-2.540009,2.540009,0,0,2.540009,-2.540009,26,20,20,27,-7,7,1.14285707473755,-1.14285707473755,2,0,0,0,2,-2,0,0,287,154,133,-133
Julio Arce,Song Yadong,Song Yadong,2021-11-13,0,1,9,-9,3,2.857143,-2.540009,2.540009,0,0,7.62001,-7.62001,0,0,24,27,-3,3,0.142857074737549,-0.142857074737549,1,1,0,0,0,0,0,0,112,98,14,-14
Marlon Moraes,Song Yadong,Song Yadong,2022-03-12,0,1,9,-9,2.3,2.857143,-5.080002,5.080002,0,0,0,0,0,0,33,27,6,-6,-0.557142972946167,0.557142972946167,0,2,1,0,-2,2,1,-1,518,119,399,-399
Cory Sandhagen,Song Yadong,Cory Sandhagen,2022-09-17,1,0,6,-6,4.25,2.857143,7.619995,-7.619995,0,0,7.62001,-7.62001,227,99,21,27,-6,6,1.39285707473755,-1.39285707473755,0,3,0,0,-3,3,0,0,322,189,133,-133
Ricky Simon,Song Yadong,Song Yadong,2023-04-29,0,1,5,-5,5,2.857143,-5.080002,5.080002,0,0,5.080002,-5.080002,51,27,24,27,-3,3,2.14285707473755,-2.14285707473755,1,0,0,1,1,-1,-1,1,1540,224,1316,-1316
Thiago Alves,Spencer Fisher,Spencer Fisher,2005-10-03,0,1,-7,7,1.533333,2.666667,5.080002,-5.080002,15,-15,5.080002,-5.080002,388,75,38,33,5,-5,-1.13333344459534,1.13333344459534,0,0,0,0,0,0,0,0,0,0,0,0
Frankie Edgar,Spencer Fisher,Frankie Edgar,2007-11-17,1,0,-5,5,2.090909,2.666667,-2.539993,2.539993,-20,20,0,0,790,0,34,33,1,-1,-0.575757741928101,0.575757741928101,1,1,0,0,0,0,0,0,287,775,-488,488
Bill Algeo,Spike Carlyle,Bill Algeo,2020-11-28,1,0,4,-4,2.428571,3,10.16,-10.16,0,0,5.080002,-5.080002,256,258,24,12,12,-12,-0.571428537368774,0.571428537368774,0,0,0,0,0,0,0,0,91,0,91,-91
Luiz Cane,Stanislav Nedkov,Stanislav Nedkov,2011-08-27,0,1,1,-1,2.428571,6,7.62001,-7.62001,-20,20,15.24001,-15.24001,0,6,24,14,10,-10,-3.57142853736877,3.57142853736877,1,0,2,0,1,-1,2,-2,161,0,161,-161
Nikita Krylov,Stanislav Nedkov,Nikita Krylov,2015-01-24,1,0,-11,11,3.333333,6,10.16,-10.16,0,0,15.24001,-15.24001,30,10,39,14,25,-25,-2.66666674613953,2.66666674613953,0,1,1,0,-1,1,1,-1,315,1246,-931,931
Ramazan Emeev,Stefan Sekulic,Ramazan Emeev,2018-09-15,1,0,5,-5,3.333333,3,-5.080002,5.080002,0,0,2.539993,-2.539993,144,136,26,16,10,-10,0.333333253860474,-0.333333253860474,1,0,0,0,1,-1,0,0,126,0,126,-126
Dwight Grant,Stefan Sekulic,Dwight Grant,2021-04-24,1,0,7,-7,1.833333,3,2.539993,-2.539993,15,-15,2.539993,-2.539993,25,124,17,16,1,-1,-1.16666662693024,1.16666662693024,0,0,1,0,0,0,1,-1,245,952,-707,707
Junior Dos Santos,Stefan Struve,Junior Dos Santos,2009-02-21,1,0,4,-4,2.333333,2.538461,-17.78001,17.78001,-27,27,-17.78,17.78,6,0,30,46,-16,16,-0.205128192901611,0.205128192901611,1,0,0,0,1,-1,0,0,119,0,119,-119
Denis Stojnic,Stefan Struve,Stefan Struve,2009-06-13,0,1,8,-8,4.333333,2.538461,-27.94,27.94,-20,20,-28.36,28.36,288,128,16,46,-30,30,1.79487204551697,-1.79487204551697,0,0,1,1,0,0,0,0,126,112,14,-14
Chase Gormley,Stefan Struve,Stefan Struve,2009-10-24,0,1,,,2.333333,2.538461,-20.32001,20.32001,0,0,-20.36,20.36,89,67,20,46,-26,26,-0.205128192901611,0.205128192901611,0,1,0,1,-1,1,-1,1,0,133,-133,133
Paul Buentello,Stefan Struve,Stefan Struve,2009-12-12,0,1,14,-14,2.058824,2.538461,-22.86,22.86,-20,20,-17.78,17.78,113,350,52,46,6,-6,-0.479637861251831,0.479637861251831,2,2,0,1,0,0,-1,1,1652,49,1603,-1603
Roy Nelson,Stefan Struve,Roy Nelson,2010-03-31,1,0,11,-11,1.571429,2.538461,-27.94,27.94,-2,2,-27.94,27.94,8,0,36,46,-10,10,-0.967032909393311,0.967032909393311,1,3,0,1,-2,2,-1,1,116,109,7,-7
Christian Morecraft,Stefan Struve,Stefan Struve,2010-08-07,0,1,1,-1,2.666667,2.538461,-12.70001,12.70001,-5,5,-7.619995,7.619995,285,8,11,46,-35,35,0.128205299377441,-0.128205299377441,0,0,0,2,0,0,-2,2,0,129,-129,129
Sean McCorkle,Stefan Struve,Stefan Struve,2010-12-11,0,1,12,-12,2.428571,2.538461,-10.16,10.16,0,0,-7.619995,7.619995,186,16,24,46,-22,22,-0.109889984130859,0.109889984130859,0,1,0,2,-1,1,-2,2,0,126,-126,126
Travis Browne,Stefan Struve,Travis Browne,2011-05-28,1,0,5,-5,2.571429,2.538461,-12.70001,12.70001,-10,10,-12.7,12.7,73,39,25,46,-21,21,3.29670906066895e-02,-3.29670906066895e-02,1,2,0,2,-1,1,-2,2,343,168,175,-175
Pat Barry,Stefan Struve,Stefan Struve,2011-10-01,0,1,9,-9,1.142857,2.538461,-30.48001,30.48001,-30,30,-25.39999,25.39999,24,3,15,46,-31,31,-1.39560425281525,1.39560425281525,0,0,1,3,0,0,-2,2,97,126,-29,29
Dave Herman,Stefan Struve,Stefan Struve,2012-02-15,0,1,4,-4,3.666667,2.538461,-17.78001,17.78001,-23,23,-17.78,17.78,6,55,28,46,-18,18,1.12820529937744,-1.12820529937744,1,1,0,3,0,0,-3,3,249,137,112,-112
Lavar Johnson,Stefan Struve,Stefan Struve,2012-05-26,0,1,10,-10,1.8,2.538461,-17.78001,17.78001,-25,25,-5.080002,5.080002,53,0,28,46,-18,18,-0.738461494445801,0.738461494445801,0,2,0,3,-2,2,-3,3,0,101,-101,101
Stipe Miocic,Stefan Struve,Stefan Struve,2012-09-29,0,1,6,-6,5,2.538461,-17.78001,17.78001,-25,25,-10.16,10.16,3,0,24,46,-22,22,2.46153855323792,-2.46153855323792,0,3,0,3,-3,3,-3,3,0,126,-126,126
Mark Hunt,Stefan Struve,Mark Hunt,2013-03-02,1,0,13,-13,0.9285714,2.538461,-33.02,33.02,0,0,-30.48,30.48,238,125,27,46,-19,19,-1.6098900437355,1.6098900437355,3,4,0,3,-1,1,-3,3,371,154,217,-217
Alistair Overeem,Stefan Struve,Alistair Overeem,2014-12-13,1,0,8,-8,2.473684,2.538461,-17.78001,17.78001,0,0,-10.16,10.16,160,0,66,46,20,-20,-6.4777135848999e-02,6.4777135848999e-02,0,0,2,4,0,0,-2,2,99,651,-552,552
Antonio Rodrigo Nogueira,Stefan Struve,Stefan Struve,2015-08-01,0,1,12,-12,3.4,2.538461,-20.32001,20.32001,-25,25,-17.78,17.78,322,38,44,46,-2,2,0.861538648605347,-0.861538648605347,0,0,1,5,0,0,-4,4,784,231,553,-553
Jared Rosholt,Stefan Struve,Jared Rosholt,2015-11-14,1,0,2,-2,3.5,2.538461,-22.86,22.86,0,0,-22.86,22.86,403,19,18,46,-28,28,0.961538553237915,-0.961538553237915,0,1,0,5,-1,1,-5,5,0,105,-105,105
Antonio Silva,Stefan Struve,Stefan Struve,2016-05-08,0,1,8,-8,1.583333,2.538461,-17.78001,17.78001,-1,1,-5.080002,5.080002,1,8,31,46,-15,15,-0.955128073692322,0.955128073692322,0,0,2,5,0,0,-3,3,1079,176,903,-903
Daniel Omielanczuk,Stefan Struve,Stefan Struve,2016-10-08,0,1,6,-6,2.375,2.538461,-27.94,27.94,-18,18,-25.39999,25.39999,70,165,27,46,-19,19,-0.163461446762085,0.163461446762085,0,1,0,5,-1,1,-5,5,911,153,758,-758
Andrei Arlovski,Stefan Struve,Andrei Arlovski,2018-03-03,1,0,9,-9,1.545455,2.538461,-20.32001,20.32001,-25,25,-17.78,17.78,271,77,56,46,10,-10,-0.993006944656372,0.993006944656372,0,2,6,5,-2,2,1,-1,259,511,-252,252
Marcos Rogerio de Lima,Stefan Struve,Stefan Struve,2019-02-23,0,1,2,-2,2.1,2.538461,-25.40001,25.40001,-12,12,-22.86,22.86,316,110,31,46,-15,15,-0.438461542129517,0.438461542129517,1,0,0,5,1,-1,-5,5,112,357,-245,245
Ben Rothwell,Stefan Struve,Ben Rothwell,2019-12-07,1,0,7,-7,2.785714,2.538461,-17.78001,17.78001,0,0,-15.24001,15.24001,278,3,53,46,7,-7,0.247252941131592,-0.247252941131592,3,1,1,5,2,-2,-4,4,2289,287,2002,-2002
Tracy Cortez,Stephanie Egger,Tracy Cortez,2020-10-10,1,0,-6,6,11,2,-2.539993,2.539993,0,0,-7.619995,7.619995,598,127,12,12,0,0,9,-9,1,0,0,0,1,-1,0,0,329,0,329,-329
Jessica-Rose Clark,Stephanie Egger,Stephanie Egger,2022-02-19,0,1,1,-1,1.222222,2,-2.539993,2.539993,10,-10,-10.16,10.16,121,81,20,12,8,-8,-0.777777791023254,0.777777791023254,1,0,0,0,1,-1,0,0,119,497,-378,378
Mayra Bueno Silva,Stephanie Egger,Mayra Bueno Silva,2022-08-06,1,0,-3,3,5.5,2,0,0,10,-10,-5.080002,5.080002,0,44,13,12,1,-1,3.5,-3.5,1,1,0,0,0,0,0,0,112,168,-56,56
Irina Alekseeva,Stephanie Egger,Irina Alekseeva,2023-04-29,1,0,-2,2,5,2,5.080002,-5.080002,10,-10,-2.540009,2.540009,0,0,6,12,-6,6,3,-3,0,0,0,0,0,0,0,0,0,266,-266,266
Dan Stittgen,Stephen Thompson,Stephen Thompson,2012-02-04,0,1,3,-3,2.4,2.833333,2.539993,-2.539993,0,0,-2.5,2.5,0,1,17,23,-6,6,-0.433333158493042,0.433333158493042,0,0,0,0,0,0,0,0,0,0,0,0
Matt Brown,Stephen Thompson,Matt Brown,2012-04-21,1,0,2,-2,1.368421,2.833333,0,0,0,0,0,0,485,48,45,23,22,-22,-1.4649121761322,1.4649121761322,2,1,0,0,1,-1,0,0,77,77,0,0
Nah-Shon Burrell,Stephen Thompson,Stephen Thompson,2013-05-25,0,1,-7,7,2.142857,2.833333,-2.540009,2.540009,0,0,-7.5,7.5,40,378,22,23,-1,1,-0.690476179122925,0.690476179122925,1,0,0,0,1,-1,0,0,91,399,-308,308
Chris Clements,Stephen Thompson,Stephen Thompson,2013-09-21,0,1,7,-7,2,2.833333,-5.080002,5.080002,0,0,-12.7,12.7,12,154,18,23,-5,5,-0.833333253860474,0.833333253860474,1,1,0,0,0,0,0,0,518,119,399,-399
Patrick Cote,Stephen Thompson,Stephen Thompson,2014-09-27,0,1,3,-3,2.090909,2.833333,-2.540009,2.540009,0,0,0,0,107,39,34,23,11,-11,-0.742424249649048,0.742424249649048,3,2,1,0,1,-1,1,-1,164,371,-207,207
Jake Ellenberger,Stephen Thompson,Stephen Thompson,2015-07-12,0,1,-2,2,2.066667,2.833333,-7.62001,7.62001,0,0,-10.16,10.16,1,116,46,23,23,-23,-0.766666650772095,0.766666650772095,1,3,2,0,-2,2,2,-2,134,288,-154,154
Johny Hendricks,Stephen Thompson,Stephen Thompson,2016-02-06,0,1,0,0,2.25,2.833333,-7.62001,7.62001,15,-15,-15.24001,15.24001,29,0,26,23,3,-3,-0.583333253860474,0.583333253860474,0,4,0,0,-4,4,0,0,427,209,218,-218
Rory MacDonald,Stephen Thompson,Stephen Thompson,2016-06-18,0,1,-7,7,4.75,2.833333,0,0,0,0,2.539993,-2.539993,8,108,23,23,0,0,1.91666674613953,-1.91666674613953,6,5,0,0,1,-1,0,0,623,133,490,-490
Jorge Masvidal,Stephen Thompson,Stephen Thompson,2017-11-04,0,1,-2,2,2.058824,2.833333,-2.540009,2.540009,0,0,-2.539993,2.539993,3,4,52,23,29,-29,-0.77450966835022,0.77450966835022,2,6,0,0,-4,4,0,0,462,504,-42,42
Anthony Pettis,Stephen Thompson,Anthony Pettis,2019-03-23,1,0,-4,4,2.4,2.833333,-5.080002,5.080002,-15,15,-7.619995,7.619995,1,0,34,23,11,-11,-0.433333158493042,0.433333158493042,0,7,1,0,-7,7,1,-1,497,504,-7,7
Vicente Luque,Stephen Thompson,Stephen Thompson,2019-11-02,0,1,-9,9,2.444444,2.833333,-2.540009,2.540009,0,0,0,0,1,11,31,23,8,-8,-0.388888835906982,0.388888835906982,5,0,0,1,5,-5,-1,1,84,224,-140,140
Geoff Neal,Stephen Thompson,Stephen Thompson,2020-12-19,0,1,-7,7,3,2.833333,-2.540009,2.540009,0,0,0,0,226,0,20,23,-3,3,0.166666746139526,-0.166666746139526,2,1,0,1,1,-1,-1,1,371,413,-42,42
Gilbert Burns,Stephen Thompson,Gilbert Burns,2021-07-10,1,0,-4,4,3.666667,2.833333,-5.080002,5.080002,0,0,-10.16,10.16,433,0,28,23,5,-5,0.833333492279053,-0.833333492279053,0,2,2,1,-2,2,1,-1,147,203,-56,56
Belal Muhammad,Stephen Thompson,Belal Muhammad,2021-12-18,1,0,-5,5,7.666667,2.833333,-2.540009,2.540009,0,0,-7.619995,7.619995,717,52,26,23,3,-3,4.83333325386047,-4.83333325386047,1,0,0,1,1,-1,-1,1,833,161,672,-672
Kevin Holland,Stephen Thompson,Stephen Thompson,2022-12-03,0,1,-9,9,2.5,2.833333,7.619995,-7.619995,0,0,15.24001,-15.24001,81,47,35,23,12,-12,-0.333333253860474,0.333333253860474,2,0,0,1,2,-2,-1,1,168,350,-182,182
Razak Al-Hassan,Steve Cantwell,Steve Cantwell,2008-12-10,0,1,4,-4,2.6,1.166667,0,0,20,-20,-3.999329e-02,3.999329e-02,17,78,18,13,5,-5,1.43333327770233,-1.43333327770233,0,0,0,0,0,0,0,0,0,0,0,0
Luiz Cane,Steve Cantwell,Luiz Cane,2009-04-18,1,0,5,-5,2.428571,1.166667,0,0,0,0,5.080002,-5.080002,13,2,24,13,11,-11,1.26190483570099,-1.26190483570099,2,1,0,0,1,-1,0,0,182,129,53,-53
David Dvorak,Steve Erceg,Steve Erceg,2023-06-10,0,1,4,-4,3.333333,10,-7.619995,7.619995,0,0,0,0,117,89,26,11,15,-15,-6.66666674613953,6.66666674613953,0,0,0,0,0,0,0,0,175,0,175,-175
Harold Howard,Steve Jennum,Steve Jennum,1994-09-09,0,1,,,0.3333333,0.6666667,10.16,-10.16,25,-25,13,-13,0,0,4,5,-1,1,-0.333333343267441,0.333333343267441,1,0,0,0,1,-1,0,0,0,0,0,0
Melton Bowen,Steve Jennum,Steve Jennum,1994-12-16,0,1,,,0,0.6666667,5.080002,-5.080002,10,-10,6,-6,0,0,1,5,-4,4,-0.666666686534882,0.666666686534882,0,1,0,0,-1,1,0,0,0,98,-98,98
David Abbott,Steve Jennum,David Abbott,1995-12-16,1,0,,,0.6666667,0.6666667,5.080002,-5.080002,50,-50,2.5,-2.5,0,0,25,5,20,-20,0,0,0,2,0,0,-2,2,0,0,0,365,-365,365
Daniel Kelly,Steve Montgomery,Daniel Kelly,2015-11-14,1,0,14,-14,3.25,1.8,-10.15999,10.15999,0,0,-18.2,18.2,473,2,17,14,3,-3,1.45000004768372,-1.45000004768372,2,0,0,0,2,-2,0,0,273,0,273,-273
Tai Bowden,Steve Nelmark,Steve Nelmark,1996-05-17,0,1,,,1,2,-2.540009,2.540009,-10,10,-17,17,0,0,2,3,-1,1,-1,1,0,0,0,0,0,0,0,0,0,0,0,0
Marcus Bossett,Steve Nelmark,Steve Nelmark,1996-12-07,0,1,,,0.3333333,2,2.539993,-2.539993,-25,25,-12,12,0,0,4,3,1,-1,-1.66666665673256,1.66666665673256,1,1,0,1,0,0,-1,1,722,204,518,-518
David Abbott,Steve Nelmark,David Abbott,1996-12-07,1,0,,,0.6666667,2,0,0,25,-25,-17.5,17.5,0,0,25,3,22,-22,-1.33333331346512,1.33333331346512,0,2,0,0,-2,2,0,0,78,0,78,-78
Ryan Jensen,Steve Steinbeiss,Ryan Jensen,2009-09-16,1,0,3,-3,2.625,2.25,-5.080002,5.080002,0,0,2.539993,-2.539993,130,19,29,13,16,-16,0.375,-0.375,0,0,0,0,0,0,0,0,697,0,697,-697
Rob Kimmons,Steve Steinbeiss,Rob Kimmons,2010-08-01,1,0,0,0,2.777778,2.25,-12.7,12.7,0,0,-5.080002,5.080002,409,303,34,13,21,-21,0.527777671813965,-0.527777671813965,0,0,1,0,0,0,1,-1,281,319,-38,38
Mike Swick,Steve Vigneault,Mike Swick,2006-03-04,1,0,-2,2,2.5,2,7.619995,-7.619995,-15,15,15.58,-15.58,49,13,21,18,3,-3,0.5,-0.5,0,0,0,0,0,0,0,0,0,0,0,0
Randy Couture,Steven Graham,Randy Couture,1997-05-30,1,0,,,1.727273,2,0,0,-85,85,2.5,-2.5,0,0,30,3,27,-27,-0.272727251052856,0.272727251052856,1,0,0,0,1,-1,0,0,0,0,0,0
Brandon Davis,Steven Peterson,Brandon Davis,2018-02-18,1,0,0,0,1.4,1.727273,0,0,-10,10,5.080002,-5.080002,39,108,24,30,-6,6,-0.327272772789001,0.327272772789001,0,0,0,0,0,0,0,0,0,0,0,0
Matt Bessette,Steven Peterson,Steven Peterson,2018-07-06,0,1,5,-5,2.444444,1.727273,0,0,0,0,0,0,92,433,31,30,1,-1,0.717171669006348,-0.717171669006348,0,0,0,0,0,0,0,0,0,138,-138,138
Luis Pena,Steven Peterson,Luis Pena,2019-03-23,1,0,-3,3,3,1.727273,12.7,-12.7,10,-10,12.7,-12.7,288,309,12,30,-18,18,1.27272725105286,-1.27272725105286,0,1,0,0,-1,1,0,0,133,260,-127,127
Alex Caceres,Steven Peterson,Alex Caceres,2019-07-20,1,0,2,-2,1.5,1.727273,0,0,0,0,7.619995,-7.619995,0,158,35,30,5,-5,-0.227272748947144,0.227272748947144,0,0,1,0,0,0,1,-1,153,119,34,-34
Martin Bravo,Steven Peterson,Steven Peterson,2019-09-21,0,1,-3,3,3.666667,1.727273,-5.080002,5.080002,0,0,2.539993,-2.539993,38,1,14,30,-16,16,1.93939399719238,-1.93939399719238,0,0,0,0,0,0,0,0,442,63,379,-379
Chase Hooper,Steven Peterson,Steven Peterson,2021-06-12,0,1,-10,10,4,1.727273,7.619995,-7.619995,10,-10,10.16,-10.16,175,477,15,30,-15,15,2.27272725105286,-2.27272725105286,1,1,0,0,0,0,0,0,546,630,-84,84
Julian Erosa,Steven Peterson,Julian Erosa,2022-02-05,1,0,1,-1,2.333333,1.727273,7.619995,-7.619995,0,0,10.16,-10.16,112,44,40,30,10,-10,0.60606050491333,-0.60606050491333,3,2,2,0,1,-1,2,-2,154,238,-84,84
Lucas Alexander,Steven Peterson,Lucas Alexander,2023-03-25,1,0,-5,5,2.666667,1.727273,2.539993,-2.539993,0,0,7.619995,-7.619995,55,31,11,30,-19,19,0.939393997192383,-0.939393997192383,0,0,0,0,0,0,0,0,161,413,-252,252
Josh Clopton,Steven Siler,Steven Siler,2011-12-03,0,1,6,-6,3,1.8125,-12.7,12.7,0,0,-9.800003,9.800003,465,23,8,45,-37,37,1.1875,-1.1875,0,0,0,0,0,0,0,0,0,0,0,0
Cole Miller,Steven Siler,Steven Siler,2012-03-02,0,1,2,-2,1.909091,1.8125,5.080002,-5.080002,0,0,7.619995,-7.619995,163,78,32,45,-13,13,9.65908765792847e-02,-9.65908765792847e-02,1,1,1,0,0,0,1,-1,201,90,111,-111
Joey Gambino,Steven Siler,Steven Siler,2012-06-22,0,1,-2,2,4.5,1.8125,-10.16,10.16,0,0,-4.800003,4.800003,25,68,11,45,-34,34,2.6875,-2.6875,0,2,0,0,-2,2,0,0,0,112,-112,112
Darren Elkins,Steven Siler,Darren Elkins,2012-11-17,1,0,3,-3,2.454545,1.8125,-2.539993,2.539993,0,0,2.539993,-2.539993,682,14,38,45,-7,7,0.642045497894287,-0.642045497894287,2,3,0,0,-1,1,0,0,406,148,258,-258
Kurt Holobaugh,Steven Siler,Steven Siler,2013-04-27,0,1,0,0,3,1.8125,0,0,10,-10,0,0,299,407,28,45,-17,17,1.1875,-1.1875,0,0,0,0,0,0,0,0,0,161,-161,161
Mike Brown,Steven Siler,Steven Siler,2013-08-17,0,1,11,-11,2.888889,1.8125,-12.7,12.7,0,0,0,0,0,6,35,45,-10,10,1.07638883590698,-1.07638883590698,2,1,0,0,1,-1,0,0,448,112,336,-336
Dennis Bermudez,Steven Siler,Dennis Bermudez,2013-11-06,1,0,0,0,1.888889,1.8125,-12.7,12.7,10,-10,-10.16,10.16,483,45,26,45,-19,19,7.63888359069824e-02,-7.63888359069824e-02,4,2,0,0,2,-2,0,0,165,81,84,-84
Rony Jason,Steven Siler,Rony Jason,2014-03-23,1,0,3,-3,2,1.8125,-10.16,10.16,0,0,7.619995,-7.619995,1,0,21,45,-24,24,0.1875,-0.1875,0,0,1,0,0,0,1,-1,134,137,-3,3
Noad Lahat,Steven Siler,Noad Lahat,2014-07-26,1,0,3,-3,5.5,1.8125,-5.080002,5.080002,0,0,-2.540009,2.540009,199,221,13,45,-32,32,3.6875,-3.6875,0,0,1,1,0,0,0,0,125,125,0,0
Dustin Hazelett,Stevie Lynch,Dustin Hazelett,2007-06-16,1,0,,,1.714286,2.5,7.619995,-7.619995,0,0,13.03999,-13.03999,17,19,19,7,12,-12,-0.785714268684387,0.785714268684387,1,0,0,0,1,-1,0,0,133,0,133,-133
Marcin Bandel,Stevie Ray,Stevie Ray,2015-04-11,0,1,0,0,2.142857,2.555556,0,0,0,0,16.50999,-16.50999,95,194,22,32,-10,10,-0.41269850730896,0.41269850730896,0,0,1,0,0,0,1,-1,189,0,189,-189
Leonardo Mafra,Stevie Ray,Stevie Ray,2015-07-18,0,1,1,-1,3.25,2.555556,0,0,0,0,0,0,0,2,17,32,-15,15,0.694444417953491,-0.694444417953491,0,1,1,0,-1,1,1,-1,367,98,269,-269
Mickael Lebout,Stevie Ray,Stevie Ray,2015-10-24,0,1,3,-3,2.285714,2.555556,2.539993,-2.539993,0,0,7.619995,-7.619995,47,46,23,32,-9,9,-0.269841194152832,0.269841194152832,1,2,0,0,-1,1,0,0,98,98,0,0
Alan Patrick,Stevie Ray,Alan Patrick,2016-09-24,1,0,7,-7,3.75,2.555556,2.539993,-2.539993,0,0,10.16,-10.16,732,92,19,32,-13,13,1.19444441795349,-1.19444441795349,0,3,1,0,-3,3,1,-1,462,336,126,-126
Ross Pearson,Stevie Ray,Stevie Ray,2016-11-19,0,1,6,-6,1.25,2.555556,-5.080002,5.080002,0,0,-2.540009,2.540009,8,192,36,32,4,-4,-1.30555558204651,1.30555558204651,0,0,1,0,0,0,1,-1,307,56,251,-251
Joe Lauzon,Stevie Ray,Stevie Ray,2017-04-22,0,1,5,-5,1.75,2.555556,0,0,0,0,2.539993,-2.539993,491,35,44,32,12,-12,-0.805555582046509,0.805555582046509,0,1,1,0,-1,1,1,-1,238,154,84,-84
Paul Felder,Stevie Ray,Paul Felder,2017-07-16,1,0,6,-6,2.833333,2.555556,2.539993,-2.539993,0,0,0,0,66,105,23,32,-9,9,0.277777671813965,-0.277777671813965,1,2,1,0,-1,1,1,-1,147,85,62,-62
Kajan Johnson,Stevie Ray,Kajan Johnson,2018-03-17,1,0,6,-6,1.769231,2.555556,2.539993,-2.539993,0,0,12.7,-12.7,254,100,36,32,4,-4,-0.786324858665466,0.786324858665466,3,0,0,1,3,-3,-1,1,189,244,-55,55
Jessin Ayari,Stevie Ray,Stevie Ray,2018-10-27,0,1,-2,2,2.666667,2.555556,5.080002,-5.080002,0,0,7.619995,-7.619995,6,0,22,32,-10,10,0.111111164093018,-0.111111164093018,0,0,0,1,0,0,-1,1,517,224,293,-293
Michael Johnson,Stevie Ray,Stevie Ray,2019-10-26,0,1,4,-4,1.157895,2.555556,0,0,0,0,7.619995,-7.619995,0,174,41,32,9,-9,-1.39766085147858,1.39766085147858,1,1,0,1,0,0,-1,1,364,364,0,0
Joey Beltran,Stipe Miocic,Stipe Miocic,2011-10-08,0,1,0,0,1.214286,5,-7.619995,7.619995,-55,55,-12.7,12.7,56,365,31,24,7,-7,-3.78571426868439,3.78571426868439,1,0,0,0,1,-1,0,0,119,0,119,-119
Philip De Fries,Stipe Miocic,Stipe Miocic,2012-02-15,0,1,-4,4,2,5,2.540009,-2.540009,10,-10,-2.539993,2.539993,0,4,18,24,-6,6,-3,3,0,1,0,0,-1,1,0,0,0,130,-130,130
Shane del Rosario,Stipe Miocic,Stipe Miocic,2012-05-26,0,1,-1,1,5.5,5,0,0,10,-10,-7.199997,7.199997,0,178,13,24,-11,11,0.5,-0.5,0,2,0,0,-2,2,0,0,0,101,-101,101
Gabriel Gonzaga,Stipe Miocic,Stipe Miocic,2014-01-25,0,1,3,-3,1.545455,5,-5.079987,5.079987,2,-2,-10.16,10.16,5,125,28,24,4,-4,-3.45454549789429,3.45454549789429,4,3,1,0,1,-1,1,-1,98,609,-511,511
Fabio Maldonado,Stipe Miocic,Stipe Miocic,2014-05-31,0,1,3,-3,2.090909,5,-7.619995,7.619995,-35,35,-12.7,12.7,0,4,34,24,10,-10,-2.90909099578857,2.90909099578857,1,4,1,0,-3,3,1,-1,69,126,-57,57
Junior Dos Santos,Stipe Miocic,Junior Dos Santos,2014-12-13,1,0,-2,2,2.333333,5,0,0,-2,2,-7.619995,7.619995,79,180,30,24,6,-6,-2.66666674613953,2.66666674613953,0,5,1,0,-5,5,1,-1,420,196,224,-224
Mark Hunt,Stipe Miocic,Stipe Miocic,2015-05-09,0,1,9,-9,0.9285714,5,-15.23999,15.23999,25,-25,-20.31999,20.31999,0,989,27,24,3,-3,-4.07142859697342,4.07142859697342,0,0,1,0,0,0,1,-1,175,147,28,-28
Andrei Arlovski,Stipe Miocic,Stipe Miocic,2016-01-02,0,1,3,-3,1.545455,5,-2.539993,2.539993,0,0,-7.619995,7.619995,0,2,56,24,32,-32,-3.45454549789429,3.45454549789429,7,1,3,0,6,-6,3,-3,119,238,-119,119
Junior Dos Santos,Stipe Miocic,Stipe Miocic,2017-05-13,0,1,-1,1,2.333333,5,0,0,-2,2,-7.619995,7.619995,0,5,30,24,6,-6,-2.66666674613953,2.66666674613953,1,2,2,0,-1,1,2,-2,398,497,-99,99
Daniel Cormier,Stipe Miocic,Daniel Cormier,2018-07-07,1,0,4,-4,7.333333,5,-12.7,12.7,-5,5,-20.31999,20.31999,6,80,25,24,1,-1,2.33333349227905,-2.33333349227905,5,3,0,0,2,-2,0,0,168,420,-252,252
Daniel Cormier,Stipe Miocic,Stipe Miocic,2019-08-17,0,1,4,-4,7.333333,5,-12.7,12.7,-5,5,-20.31999,20.31999,181,91,25,24,1,-1,2.33333349227905,-2.33333349227905,7,0,0,1,7,-7,-1,1,287,406,-119,119
Daniel Cormier,Stipe Miocic,Stipe Miocic,2020-08-15,0,1,4,-4,7.333333,5,-12.7,12.7,-5,5,-20.31999,20.31999,53,352,25,24,1,-1,2.33333349227905,-2.33333349227905,0,1,1,1,-1,1,0,0,364,364,0,0
SeungWoo Choi,Suman Mokhtarian,SeungWoo Choi,2019-12-21,1,0,0,0,1.833333,1.6,10.16,-10.16,0,0,5.080002,-5.080002,409,29,17,13,4,-4,0.233333349227905,-0.233333349227905,0,0,0,0,0,0,0,0,147,0,147,-147
Chan-Mi Jeon,Syuri Kondo,Syuri Kondo,2017-09-22,0,1,-8,8,2.5,2,2.540009,-2.540009,0,0,-2.639999,2.639999,0,0,7,9,-2,2,0.5,-0.5,0,0,0,0,0,0,0,0,0,0,0,0
Poliana Botelho,Syuri Kondo,Poliana Botelho,2018-05-19,1,0,0,0,1.6,2,10.16,-10.16,10,-10,2.539993,-2.539993,5,0,13,9,4,-4,-0.399999976158142,0.399999976158142,1,1,0,0,0,0,0,0,224,239,-15,15
Manon Fiorot,Tabatha Ricci,Manon Fiorot,2021-06-05,1,0,5,-5,11,9,15.23999,-15.23999,10,-10,10.16,-10.16,40,0,12,10,2,-2,2,-2,1,0,0,0,1,-1,0,0,136,0,136,-136
Maria Oliveira,Tabatha Ricci,Tabatha Ricci,2021-10-23,0,1,-2,2,1.857143,9,12.7,-12.7,0,0,20.31999,-20.31999,1,398,20,10,10,-10,-7.14285719394684,7.14285719394684,0,0,0,1,0,0,-1,1,0,140,-140,140
Jessica Penne,Tabatha Ricci,Tabatha Ricci,2023-03-04,0,1,12,-12,1.75,9,10.16,-10.16,0,0,15.23999,-15.23999,0,314,22,10,12,-12,-7.25,7.25,0,1,0,1,-1,1,-1,1,2142,497,1645,-1645
Nick Hein,Tae Hyun Bang,Nick Hein,2016-09-03,1,0,-1,1,2.8,1.8,-7.619995,7.619995,0,0,-12.7,12.7,8,139,19,28,-9,9,1,-1,2,0,0,0,2,-2,0,0,343,0,343,-343
Azamat Murzakanov,Tafon Nchukwi,Azamat Murzakanov,2022-03-12,1,0,5,-5,13,1.5,-5.080002,5.080002,20,-20,-15.24001,15.24001,39,14,13,10,3,-3,11.5,-11.5,0,0,0,0,0,0,0,0,0,0,0,0
AJ Dobson,Tafon Nchukwi,AJ Dobson,2023-08-12,1,0,3,-3,3.5,1.5,2.539993,-2.539993,0,0,-2.540009,2.540009,273,0,9,10,-1,1,2,-2,0,0,0,1,0,0,-1,1,294,518,-224,224
Bruno Silva,Tagir Ulanbekov,Tagir Ulanbekov,2020-10-10,0,1,2,-2,2.555556,7,12.70001,-12.70001,60,-60,10.16,-10.16,141,227,32,16,16,-16,-4.44444441795349,4.44444441795349,0,0,0,0,0,0,0,0,0,0,0,0
Allan Nascimento,Tagir Ulanbekov,Tagir Ulanbekov,2021-10-30,0,1,0,0,3.333333,7,2.540009,-2.540009,0,0,-2.540009,2.540009,16,724,26,16,10,-10,-3.66666674613953,3.66666674613953,0,1,0,0,-1,1,0,0,0,385,-385,385
Tim Elliott,Tagir Ulanbekov,Tim Elliott,2022-03-05,1,0,5,-5,1.666667,7,0,0,0,0,-10.16,10.16,52,295,32,16,16,-16,-5.33333337306976,5.33333337306976,0,2,0,0,-2,2,0,0,147,126,21,-21
Nate Maness,Tagir Ulanbekov,Tagir Ulanbekov,2022-11-05,0,1,0,0,4.666667,7,7.62001,-7.62001,0,0,5.080002,-5.080002,0,94,17,16,1,-1,-2.33333349227905,2.33333349227905,0,0,0,0,0,0,0,0,133,245,-112,112
Rashad Coulter,Tai Tuivasa,Tai Tuivasa,2017-11-18,0,1,11,-11,2.25,2.5,-7.62001,7.62001,-59,59,2.539993,-2.539993,38,74,13,21,-8,8,-0.25,0.25,0,0,1,0,0,0,1,-1,189,0,189,-189
Cyril Asker,Tai Tuivasa,Tai Tuivasa,2018-02-10,0,1,8,-8,2.25,2.5,-5.080002,5.080002,-17,17,-2.539993,2.539993,0,25,13,21,-8,8,-0.25,0.25,1,1,2,0,0,0,2,-2,77,84,-7,7
Andrei Arlovski,Tai Tuivasa,Tai Tuivasa,2018-06-09,0,1,14,-14,1.545455,2.5,2.539993,-2.539993,-24,24,5.080002,-5.080002,38,99,56,21,35,-35,-0.954545497894287,0.954545497894287,1,2,6,0,-1,1,6,-6,98,119,-21,21
Junior Dos Santos,Tai Tuivasa,Junior Dos Santos,2018-12-01,1,0,9,-9,2.333333,2.5,5.079987,-5.079987,-26,26,5.080002,-5.080002,48,75,30,21,9,-9,-0.166666746139526,0.166666746139526,1,3,3,0,-2,2,3,-3,140,175,-35,35
Blagoy Ivanov,Tai Tuivasa,Blagoy Ivanov,2019-06-08,1,0,6,-6,3.166667,2.5,-7.62001,7.62001,-14,14,-5.080002,5.080002,158,159,25,21,4,-4,0.666666746139526,-0.666666746139526,1,0,0,1,1,-1,-1,1,91,189,-98,98
Serghei Spivac,Tai Tuivasa,Serghei Spivac,2019-10-05,1,0,-2,2,4,2.5,2.539993,-2.539993,-4,4,7.619995,-7.619995,261,5,20,21,-1,1,1.5,-1.5,0,0,0,1,0,0,-1,1,0,119,-119,119
Stefan Struve,Tai Tuivasa,Tai Tuivasa,2020-10-24,0,1,5,-5,2.538461,2.5,22.86,-22.86,1,-1,22.86,-22.86,0,104,46,21,25,-25,3.8461446762085e-02,-3.8461446762085e-02,0,0,1,1,0,0,0,0,825,385,440,-440
Harry Hunsucker,Tai Tuivasa,Tai Tuivasa,2021-03-20,0,1,4,-4,1.166667,2.5,0,0,-59,59,0,0,0,10,13,21,-8,8,-1.33333337306976,1.33333337306976,0,1,0,1,-1,1,-1,1,0,147,-147,147
Greg Hardy,Tai Tuivasa,Tai Tuivasa,2021-07-10,0,1,4,-4,1.4,2.5,7.619995,-7.619995,1,-1,12.7,-12.7,0,6,12,21,-9,9,-1.10000002384186,1.10000002384186,0,2,1,1,-2,2,0,0,203,112,91,-91
Augusto Sakai,Tai Tuivasa,Tai Tuivasa,2021-12-11,0,1,2,-2,3.2,2.5,2.539993,-2.539993,1,-1,5.080002,-5.080002,33,118,21,21,0,0,0.700000047683716,-0.700000047683716,2,3,0,1,-1,1,-1,1,819,154,665,-665
Derrick Lewis,Tai Tuivasa,Tai Tuivasa,2022-02-12,0,1,9,-9,2.454545,2.5,2.539993,-2.539993,-4,4,10.16,-10.16,108,126,38,21,17,-17,-4.54545021057129e-02,4.54545021057129e-02,7,4,1,1,3,-3,0,0,553,63,490,-490
Ciryl Gane,Tai Tuivasa,Ciryl Gane,2022-09-03,1,0,3,-3,6,2.5,5.079987,-5.079987,-19,19,15.24001,-15.24001,1,4,14,21,-7,7,3.5,-3.5,0,5,0,1,-5,5,-1,1,224,203,21,-21
Sergei Pavlovich,Tai Tuivasa,Sergei Pavlovich,2022-12-03,1,0,1,-1,18,2.5,2.539993,-2.539993,-7,7,22.86,-22.86,9,0,19,21,-2,2,15.5,-15.5,0,0,0,2,0,0,-2,2,0,91,-91,91
Mara Romero Borella,Taila Santos,Mara Romero Borella,2019-02-02,1,0,7,-7,1.333333,6.333333,0,0,0,0,2.539993,-2.539993,356,165,21,22,-1,1,-5.00000011920929,5.00000011920929,0,0,0,0,0,0,0,0,0,0,0,0
Molly McCann,Taila Santos,Taila Santos,2020-07-15,0,1,3,-3,2.166667,6.333333,-5.080002,5.080002,0,0,-15.24001,15.24001,56,473,19,22,-3,3,-4.16666674613953,4.16666674613953,0,0,0,0,0,0,0,0,780,529,251,-251
Gillian Robertson,Taila Santos,Taila Santos,2020-12-19,0,1,-2,2,1.5,6.333333,-2.539993,2.539993,-10,10,-12.7,12.7,61,767,20,22,-2,2,-4.83333349227905,4.83333349227905,1,1,0,0,0,0,0,0,1114,157,957,-957
Roxanne Modafferi,Taila Santos,Taila Santos,2021-09-25,0,1,11,-11,1.190476,6.333333,2.539993,-2.539993,0,0,2.539993,-2.539993,182,483,46,22,24,-24,-5.14285731315613,5.14285731315613,0,2,0,0,-2,2,0,0,462,280,182,-182
Erin Blanchfield,Taila Santos,Erin Blanchfield,2023-08-26,1,0,-6,6,12,6.333333,-5.080002,5.080002,0,0,-5.080002,5.080002,488,9,13,22,-9,9,5.66666650772095,-5.66666650772095,2,3,0,0,-1,1,0,0,287,700,-413,413
Jessica-Rose Clark,Tainara Lisboa,Tainara Lisboa,2023-05-13,0,1,3,-3,1.222222,3,-5.079987,5.079987,0,0,-7.619995,7.619995,456,129,20,8,12,-12,-1.77777779102325,1.77777779102325,0,0,0,0,0,0,0,0,315,0,315,-315
Kenny Florian,Takanori Gomi,Kenny Florian,2010-03-31,1,0,2,-2,2.333333,2.5,7.62001,-7.62001,-10,10,10.16,-10.16,105,8,20,49,-29,29,-0.166666746139526,0.166666746139526,1,0,1,0,1,-1,1,-1,109,0,109,-109
Nate Diaz,Takanori Gomi,Nate Diaz,2011-09-24,1,0,-7,7,1.692308,2.5,12.70001,-12.70001,15,-15,15.23999,-15.23999,23,37,35,49,-14,14,-0.807692289352417,0.807692289352417,0,0,0,0,0,0,0,0,147,542,-395,395
Mac Danzig,Takanori Gomi,Takanori Gomi,2012-11-10,0,1,-2,2,1.75,2.5,2.540009,-2.540009,0,0,0,0,93,261,33,49,-16,16,-0.75,0.75,1,0,0,0,1,-1,0,0,203,413,-210,210
Belal Muhammad,Takashi Sato,Belal Muhammad,2019-09-07,1,0,2,-2,7.666667,2.285714,2.539993,-2.539993,0,0,-2.539993,2.539993,151,38,26,23,3,-3,5.38095211982727,-5.38095211982727,0,0,0,0,0,0,0,0,231,0,231,-231
Miguel Baeza,Takashi Sato,Miguel Baeza,2020-11-28,1,0,-2,2,3.333333,2.285714,10.16,-10.16,0,0,2.540009,-2.540009,69,2,13,23,-10,10,1.0476188659668,-1.0476188659668,1,0,0,0,1,-1,0,0,196,448,-252,252
Gunnar Nelson,Takashi Sato,Gunnar Nelson,2022-03-19,1,0,2,-2,3.8,2.285714,2.539993,-2.539993,0,0,-2.539993,2.539993,489,0,24,23,1,-1,1.51428556442261,-1.51428556442261,1,0,1,0,1,-1,1,-1,1197,476,721,-721
Bryan Battle,Takashi Sato,Bryan Battle,2022-08-06,1,0,-5,5,5.5,2.285714,7.619995,-7.619995,0,0,10.16,-10.16,2,0,13,23,-10,10,3.21428561210632,-3.21428561210632,2,0,0,0,2,-2,0,0,182,140,42,-42
Themba Gorimbo,Takashi Sato,Themba Gorimbo,2023-05-20,1,0,0,0,2.75,2.285714,7.619995,-7.619995,0,0,10.16,-10.16,675,141,15,23,-8,8,0.464285612106323,-0.464285612106323,0,0,0,1,0,0,-1,1,0,287,-287,287
Hyun Gyu Lim,Takenori Sato,Hyun Gyu Lim,2014-09-20,1,0,0,0,1.857143,1.727273,12.7,-12.7,0,0,15.58,-15.58,12,2,20,30,-10,10,0.129870057106018,-0.129870057106018,0,0,0,0,0,0,0,0,259,0,259,-259
Reuben Duran,Takeya Mizugaki,Takeya Mizugaki,2011-03-03,0,1,0,0,1.571429,1.909091,0,0,0,0,5.080002,-5.080002,60,254,18,32,-14,14,-0.33766233921051,0.33766233921051,0,0,0,0,0,0,0,0,0,0,0,0
Brian Bowles,Takeya Mizugaki,Brian Bowles,2011-07-02,1,0,4,-4,3.333333,1.909091,0,0,0,0,2.540009,-2.540009,369,24,13,32,-19,19,1.42424237728119,-1.42424237728119,1,1,0,0,0,0,0,0,121,121,0,0
Cole Escovedo,Takeya Mizugaki,Takeya Mizugaki,2011-09-24,0,1,3,-3,1.888889,1.909091,0,0,0,0,7.62001,-7.62001,40,155,26,32,-6,6,-2.02020406723022e-02,2.02020406723022e-02,0,0,0,0,0,0,0,0,0,84,-84,84
Chris Cariaso,Takeya Mizugaki,Chris Cariaso,2012-02-25,1,0,2,-2,2.125,1.909091,-10.15999,10.15999,-10,10,-12.7,12.7,83,485,25,32,-7,7,0.215909123420715,-0.215909123420715,1,1,0,0,0,0,0,0,112,154,-42,42
Jeff Hougland,Takeya Mizugaki,Takeya Mizugaki,2012-11-10,0,1,6,-6,1.666667,1.909091,0,0,0,0,-2.539993,2.539993,36,664,16,32,-16,16,-0.242424249649048,0.242424249649048,0,0,0,0,0,0,0,0,179,259,-80,80
Bryan Caraway,Takeya Mizugaki,Takeya Mizugaki,2013-03-02,0,1,-1,1,2.333333,1.909091,2.540009,-2.540009,0,0,-2.539993,2.539993,346,12,30,32,-2,2,0.424242377281189,-0.424242377281189,2,1,0,0,1,-1,0,0,224,112,112,-112
Dominick Cruz,Takeya Mizugaki,Dominick Cruz,2014-09-27,1,0,-1,1,6,1.909091,2.540009,-2.540009,0,0,-2.539993,2.539993,22,0,28,32,-4,4,4.09090912342072,-4.09090912342072,2,2,0,0,0,0,0,0,1092,574,518,-518
Cody Garbrandt,Takeya Mizugaki,Cody Garbrandt,2016-08-20,1,0,-7,7,2.6,1.909091,2.540009,-2.540009,0,0,-10.15999,10.15999,7,0,18,32,-14,14,0.690909028053284,-0.690909028053284,1,0,0,1,1,-1,-1,1,181,693,-512,512
Irene Aldana,Talita Bernardo,Irene Aldana,2018-01-14,1,0,-1,1,2,1.5,12.7,-12.7,0,0,0,0,86,357,21,10,11,-11,0.5,-0.5,0,0,0,0,0,0,0,0,281,0,281,-281
Viviane Araujo,Talita Bernardo,Viviane Araujo,2019-05-11,1,0,0,0,2.2,1.5,0,0,-10,10,0,0,77,12,16,10,6,-6,0.700000047683716,-0.700000047683716,0,0,0,0,0,0,0,0,0,482,-482,482
Akihiro Gono,Tamdan McCrory,Akihiro Gono,2007-11-17,1,0,12,-12,1.666667,2.8,-22.86,22.86,-15,15,-20.31999,20.31999,156,67,56,19,37,-37,-1.13333332538605,1.13333332538605,0,0,0,0,0,0,0,0,0,0,0,0
Luke Cummo,Tamdan McCrory,Tamdan McCrory,2008-08-09,0,1,7,-7,1,2.8,-10.15999,10.15999,-15,15,-5.079987,5.079987,133,617,12,19,-7,7,-1.79999995231628,1.79999995231628,0,0,0,0,0,0,0,0,161,266,-105,105
Dustin Hazelett,Tamdan McCrory,Dustin Hazelett,2008-11-15,1,0,0,0,1.714286,2.8,-7.619995,7.619995,-15,15,0,0,0,74,19,19,0,0,-1.08571422100067,1.08571422100067,0,1,1,0,-1,1,1,-1,259,98,161,-161
Ryan Madigan,Tamdan McCrory,Tamdan McCrory,2009-03-07,0,1,,,1.666667,2.8,-10.15999,10.15999,-15,15,-10.03999,10.03999,0,202,8,19,-11,11,-1.13333332538605,1.13333332538605,0,0,0,0,0,0,0,0,0,112,-112,112
John Howard,Tamdan McCrory,John Howard,2009-08-08,1,0,4,-4,1.846154,2.8,-22.86,22.86,-15,15,-10.15999,10.15999,507,182,37,19,18,-18,-0.953846096992493,0.953846096992493,1,1,0,0,0,0,0,0,189,154,35,-35
Krzysztof Jotko,Tamdan McCrory,Krzysztof Jotko,2016-06-18,1,0,-3,3,4,2.8,-7.619995,7.619995,0,0,2.540009,-2.540009,1,0,30,19,11,-11,1.20000004768372,-1.20000004768372,3,0,0,0,3,-3,0,0,112,2506,-2394,2394
Nate Marquardt,Tamdan McCrory,Nate Marquardt,2016-10-01,1,0,8,-8,1.842105,2.8,-10.15999,10.15999,0,0,-5.079987,5.079987,301,6,54,19,35,-35,-0.957894682884216,0.957894682884216,0,0,2,1,0,0,1,-1,140,105,35,-35
Ramona Pascual,Tamires Vidal,Tamires Vidal,2022-11-05,0,1,10,-10,1.2,3.5,2.539993,-2.539993,0,0,-5.080002,5.080002,23,56,11,9,2,-2,-2.29999995231628,2.29999995231628,0,0,0,0,0,0,0,0,0,0,0,0
Montserrat Rendon,Tamires Vidal,Montserrat Rendon,2023-09-23,1,0,9,-9,6,3.5,5.080002,-5.080002,0,0,0,0,291,54,6,9,-3,3,2.5,-2.5,0,1,0,0,-1,1,0,0,0,322,-322,322
Andrei Arlovski,Tanner Boser,Andrei Arlovski,2020-11-07,1,0,12,-12,1.545455,2.1,2.539993,-2.539993,35,-35,5.080002,-5.080002,0,0,56,31,25,-25,-0.554545402526855,0.554545402526855,1,0,7,0,1,-1,7,-7,178,0,178,-178
Hyun Gyu Lim,Tarec Saffiedine,Tarec Saffiedine,2014-01-04,0,1,1,-1,1.857143,2.285714,12.7,-12.7,0,0,17.78,-17.78,19,379,20,23,-3,3,-0.428571581840515,0.428571581840515,1,0,0,0,1,-1,0,0,126,0,126,-126
Rory MacDonald,Tarec Saffiedine,Rory MacDonald,2014-10-04,1,0,-3,3,4.75,2.285714,5.080002,-5.080002,0,0,15.23999,-15.23999,20,0,23,23,0,0,2.46428561210632,-2.46428561210632,5,1,0,0,4,-4,0,0,112,273,-161,161
Jake Ellenberger,Tarec Saffiedine,Tarec Saffiedine,2016-01-30,0,1,1,-1,2.066667,2.285714,-2.540009,2.540009,0,0,2.539993,-2.539993,54,61,46,23,23,-23,-0.219047784805298,0.219047784805298,0,0,3,1,0,0,2,-2,202,483,-281,281
Dong Hyun Kim,Tarec Saffiedine,Dong Hyun Kim,2016-12-30,1,0,5,-5,5.5,2.285714,10.16,-10.16,0,0,15.23999,-15.23999,317,85,26,23,3,-3,3.21428561210632,-3.21428561210632,1,1,2,1,0,0,1,-1,398,335,63,-63
Rafael Dos Anjos,Tarec Saffiedine,Rafael Dos Anjos,2017-06-17,1,0,2,-2,2.133333,2.285714,-5.080002,5.080002,0,0,0,0,209,221,47,23,24,-24,-0.15238094329834,0.15238094329834,0,0,1,1,0,0,0,0,224,169,55,-55
Chris Beal,Tateki Matsuda,Chris Beal,2014-09-05,1,0,1,-1,2,1.625,0,0,0,0,9.259995,-9.259995,328,112,15,21,-6,6,0.375,-0.375,1,0,0,0,1,-1,0,0,132,0,132,-132
Amanda Cooper,Tatiana Suarez,Tatiana Suarez,2016-07-08,0,1,-1,1,0.6,11,-5.080002,5.080002,0,0,-5.080002,5.080002,26,178,8,11,-3,3,-10.3999999761581,10.3999999761581,0,0,0,0,0,0,0,0,0,0,0,0
Viviane Pereira,Tatiana Suarez,Tatiana Suarez,2017-11-11,0,1,-2,2,6.5,11,-10.16,10.16,0,0,-7.619995,7.619995,6,749,15,11,4,-4,-4.5,4.5,0,1,0,0,-1,1,0,0,0,491,-491,491
Alexa Grasso,Tatiana Suarez,Tatiana Suarez,2018-05-19,0,1,-3,3,5.333333,11,0,0,10,-10,0,0,0,101,19,11,8,-8,-5.66666650772095,5.66666650772095,1,2,0,0,-1,1,0,0,287,189,98,-98
Carla Esparza,Tatiana Suarez,Tatiana Suarez,2018-09-08,0,1,3,-3,2.857143,11,-10.16,10.16,0,0,-7.619995,7.619995,4,777,27,11,16,-16,-8.14285707473755,8.14285707473755,0,3,1,0,-3,3,1,-1,91,112,-21,21
Nina Nunes,Tatiana Suarez,Tatiana Suarez,2019-06-08,0,1,5,-5,1.571429,11,0,0,10,-10,-5.080002,5.080002,0,497,18,11,7,-7,-9.42857146263123,9.42857146263123,0,4,0,0,-4,4,0,0,0,273,-273,273
Montana De La Rosa,Tatiana Suarez,Tatiana Suarez,2023-02-25,0,1,-4,4,1.5,11,5.079987,-5.079987,10,-10,5.080002,-5.080002,37,345,20,11,9,-9,-9.5,9.5,2,5,0,0,-3,3,0,0,630,1358,-728,728
Jessica Andrade,Tatiana Suarez,Tatiana Suarez,2023-08-05,0,1,-1,1,2,11,-10.16,10.16,0,0,-10.16,10.16,17,142,36,11,25,-25,-9,9,0,6,4,0,-6,6,4,-4,91,161,-70,70
Carlos Candelario,Tatsuro Taira,Tatsuro Taira,2022-05-14,0,1,8,-8,2.666667,14,2.540009,-2.540009,0,0,-5.080002,5.080002,208,417,11,14,-3,3,-11.3333332538605,11.3333332538605,0,0,0,0,0,0,0,0,0,0,0,0
Jesus Aguilar,Tatsuro Taira,Tatsuro Taira,2023-02-04,0,1,3,-3,4.5,14,-7.619995,7.619995,0,0,-20.32001,20.32001,23,229,11,14,-3,3,-9.5,9.5,0,1,0,0,-1,1,0,0,0,266,-266,266
Edgar Chairez,Tatsuro Taira,Tatsuro Taira,2023-07-08,0,1,4,-4,2,14,0,0,0,0,2.539993,-2.539993,25,593,15,14,1,-1,-12,12,0,2,0,0,-2,2,0,0,0,154,-154,154
Clay Guida,Tatsuya Kawajiri,Clay Guida,2014-04-11,1,0,-3,3,1.9,3.272727,0,0,10,-10,2.540009,-2.540009,538,166,58,47,11,-11,-1.37272727489471,1.37272727489471,0,0,1,0,0,0,1,-1,223,0,223,-223
Dennis Bermudez,Tatsuya Kawajiri,Dennis Bermudez,2016-02-21,1,0,-8,8,1.888889,3.272727,-2.539993,2.539993,10,-10,-7.619995,7.619995,260,446,26,47,-21,21,-1.38383841514587,1.38383841514587,0,0,1,0,0,0,1,-1,225,681,-456,456
Leandro Issa,Taylor Lapilus,Taylor Lapilus,2016-09-03,0,1,8,-8,2.166667,6.333333,2.539993,-2.539993,0,0,-10.16,10.16,391,58,19,22,-3,3,-4.16666674613953,4.16666674613953,2,0,0,0,2,-2,0,0,623,0,623,-623
Dennis Bermudez,Te Edwards,Dennis Bermudez,2019-01-19,1,0,4,-4,1.888889,2,-5.080002,5.080002,0,0,-15.24001,15.24001,42,522,26,9,17,-17,-0.111111164093018,0.111111164093018,0,0,2,0,0,0,2,-2,189,0,189,-189
Angela Magana,Tecia Torres,Tecia Torres,2014-12-12,0,1,6,-6,1.222222,2.166667,0,0,0,0,12.70001,-12.70001,4,38,20,19,1,-1,-0.944444537162781,0.944444537162781,0,0,0,0,0,0,0,0,0,0,0,0
Angela Hill,Tecia Torres,Tecia Torres,2015-06-13,0,1,5,-5,1.153846,2.166667,5.080002,-5.080002,0,0,10.16,-10.16,25,544,28,19,9,-9,-1.01282060146332,1.01282060146332,1,1,0,0,0,0,0,0,183,183,0,0
Jocelyn Jones-Lybarger,Tecia Torres,Tecia Torres,2015-12-12,0,1,4,-4,1.5,2.166667,15.23999,-15.23999,0,0,10.16,-10.16,141,335,10,19,-9,9,-0.666666746139526,0.666666746139526,0,2,0,0,-2,2,0,0,0,182,-182,182
Rose Namajunas,Tecia Torres,Rose Namajunas,2016-04-16,1,0,-3,3,2,2.166667,10.16,-10.16,10,-10,12.70001,-12.70001,80,45,18,19,-1,1,-0.166666746139526,0.166666746139526,1,3,0,0,-2,2,0,0,128,126,2,-2
Bec Rawlings,Tecia Torres,Tecia Torres,2017-02-04,0,1,0,0,0.875,2.166667,12.7,-12.7,10,-10,10.16,-10.16,111,251,15,19,-4,4,-1.29166674613953,1.29166674613953,0,0,1,0,0,0,1,-1,161,294,-133,133
Juliana Lima,Tecia Torres,Tecia Torres,2017-07-07,0,1,8,-8,1.8,2.166667,10.16,-10.16,0,0,12.70001,-12.70001,49,187,14,19,-5,5,-0.366666793823242,0.366666793823242,1,1,0,0,0,0,0,0,972,153,819,-819
Jessica Andrade,Tecia Torres,Jessica Andrade,2018-02-24,1,0,-2,2,2,2.166667,0,0,0,0,5.080002,-5.080002,435,23,36,19,17,-17,-0.166666746139526,0.166666746139526,1,2,1,0,-1,1,1,-1,155,232,-77,77
Joanna Jedrzejczyk,Tecia Torres,Joanna Jedrzejczyk,2018-07-28,1,0,2,-2,3.2,2.166667,12.7,-12.7,0,0,12.70001,-12.70001,135,283,21,19,2,-2,1.03333330154419,-1.03333330154419,0,0,1,0,0,0,1,-1,112,154,-42,42
Marina Rodriguez,Tecia Torres,Marina Rodriguez,2019-08-10,1,0,3,-3,5.666667,2.166667,12.7,-12.7,0,0,12.70001,-12.70001,144,88,20,19,1,-1,3.49999976158142,-3.49999976158142,0,0,0,0,0,0,0,0,0,378,-378,378
Brianna Fortino,Tecia Torres,Tecia Torres,2020-06-20,0,1,-4,4,3,2.166667,-2.540009,2.540009,0,0,5.080002,-5.080002,274,129,12,19,-7,7,0.833333253860474,-0.833333253860474,1,0,0,0,1,-1,0,0,343,315,28,-28
Sam Hughes,Tecia Torres,Tecia Torres,2020-12-12,0,1,-3,3,1.6,2.166667,10.16,-10.16,0,0,10.16,-10.16,51,15,13,19,-6,6,-0.566666722297668,0.566666722297668,0,1,0,0,-1,1,0,0,0,175,-175,175
Angela Hill,Tecia Torres,Tecia Torres,2021-08-07,0,1,5,-5,1.153846,2.166667,5.080002,-5.080002,0,0,10.16,-10.16,116,16,28,19,9,-9,-1.01282060146332,1.01282060146332,1,2,0,0,-1,1,0,0,147,238,-91,91
Mackenzie Dern,Tecia Torres,Mackenzie Dern,2022-04-09,1,0,-3,3,4.333333,2.166667,7.619995,-7.619995,0,0,7.62001,-7.62001,144,174,16,19,-3,3,2.16666674613953,-2.16666674613953,0,3,0,0,-3,3,0,0,182,245,-63,63
Steve Judson,Tedd Williams,Tedd Williams,2000-03-10,0,1,,,0,7,-5.080002,5.080002,-45,45,-2,2,18,42,2,8,-6,6,-7,7,0,0,1,0,0,0,1,-1,168,0,168,-168
Ian Freeman,Tedd Williams,Ian Freeman,2000-09-22,1,0,3,-3,2.857143,7,-5.080002,5.080002,-50,50,-5,5,356,436,27,8,19,-19,-4.14285707473755,4.14285707473755,1,1,0,0,0,0,0,0,105,196,-91,91
Mickael Lebout,Teemu Packalen,Mickael Lebout,2015-07-18,1,0,-1,1,2.285714,2.666667,-5.080002,5.080002,0,0,-5.080002,5.080002,413,194,23,11,12,-12,-0.38095235824585,0.38095235824585,0,0,0,0,0,0,0,0,98,0,98,-98
Thibault Gouti,Teemu Packalen,Teemu Packalen,2016-02-27,0,1,1,-1,2.4,2.666667,-7.619995,7.619995,0,0,-7.619995,7.619995,0,10,17,11,6,-6,-0.266666650772095,0.266666650772095,0,0,0,0,0,0,0,0,0,224,-224,224
Marc Diakiese,Teemu Packalen,Marc Diakiese,2017-03-18,1,0,-5,5,2.285714,2.666667,-7.619995,7.619995,0,0,-5.080002,5.080002,1,0,23,11,12,-12,-0.38095235824585,0.38095235824585,2,1,0,0,1,-1,0,0,99,385,-286,286
Ottman Azaitar,Teemu Packalen,Ottman Azaitar,2019-09-07,1,0,-3,3,6.5,2.666667,-12.7,12.7,0,0,-10.16,10.16,11,0,15,11,4,-4,3.83333325386047,-3.83333325386047,0,0,0,1,0,0,-1,1,0,903,-903,903
Matt Frevola,Terrance McKinney,Terrance McKinney,2021-06-12,0,1,5,-5,3.666667,2.8,-2.540009,2.540009,0,0,-5.080002,5.080002,0,0,14,19,-5,5,0.866666793823242,-0.866666793823242,0,0,1,0,0,0,1,-1,140,0,140,-140
Drew Dober,Terrance McKinney,Drew Dober,2022-03-12,1,0,6,-6,2.166667,2.8,-5.080002,5.080002,0,0,-7.619995,7.619995,24,93,38,19,19,-19,-0.633333206176758,0.633333206176758,0,1,0,0,-1,1,0,0,273,273,0,0
Erick Gonzalez,Terrance McKinney,Terrance McKinney,2022-08-06,0,1,3,-3,1.75,2.8,2.539993,-2.539993,0,0,5.080002,-5.080002,0,52,22,19,3,-3,-1.04999995231628,1.04999995231628,0,0,1,1,0,0,0,0,294,147,147,-147
Ismael Bonfim,Terrance McKinney,Ismael Bonfim,2023-01-21,1,0,-1,1,4.75,2.8,-5.080002,5.080002,0,0,-5.080002,5.080002,47,136,23,19,4,-4,1.95000004768372,-1.95000004768372,0,1,0,1,-1,1,-1,1,0,168,-168,168
Mike Breeden,Terrance McKinney,Terrance McKinney,2023-08-12,0,1,6,-6,1.666667,2.8,0,0,0,0,-7.619995,7.619995,0,3,16,19,-3,3,-1.13333332538605,1.13333332538605,0,0,1,2,0,0,-1,1,469,203,266,-266
Cody Stamann,Terrion Ware,Cody Stamann,2017-07-08,1,0,-4,4,3.5,1.888889,-5.080002,5.080002,0,0,-17.78,17.78,410,16,27,26,1,-1,1.61111116409302,-1.61111116409302,0,0,0,0,0,0,0,0,0,0,0,0
"Sean O'Malley",Terrion Ware,"Sean O'Malley",2017-12-01,1,0,-8,8,17,1.888889,7.619995,-7.619995,0,0,2.540009,-2.540009,27,69,18,26,-8,8,15.111111164093,-15.111111164093,0,0,0,0,0,0,0,0,0,146,-146,146
Tom Duquesnoy,Terrion Ware,Tom Duquesnoy,2018-03-17,1,0,-7,7,8,1.888889,-2.540009,2.540009,0,0,-7.619995,7.619995,5,88,18,26,-8,8,6.11111116409302,-6.11111116409302,0,0,0,0,0,0,0,0,161,106,55,-55
Merab Dvalishvili,Terrion Ware,Merab Dvalishvili,2018-09-15,1,0,-5,5,4,1.888889,-5.080002,5.080002,0,0,-7.619995,7.619995,693,0,20,26,-6,6,2.11111116409302,-2.11111116409302,0,0,0,0,0,0,0,0,147,182,-35,35
Rich Clementi,Terry Etim,Rich Clementi,2008-05-24,1,0,10,-10,1.956522,3.2,-10.16,10.16,0,0,-2.539993,2.539993,593,48,68,21,47,-47,-1.24347829818726,1.24347829818726,4,0,0,0,4,-4,0,0,35,0,35,-35
Brian Cobb,Terry Etim,Terry Etim,2009-02-21,0,1,,,2.222222,3.2,-5.080002,5.080002,0,0,-2.419998,2.419998,108,24,29,21,8,-8,-0.977777719497681,0.977777719497681,0,0,0,0,0,0,0,0,0,273,-273,273
Justin Buchholz,Terry Etim,Terry Etim,2009-06-13,0,1,2,-2,1.5,3.2,-2.539993,2.539993,0,0,0,0,116,104,25,21,4,-4,-1.70000004768372,1.70000004768372,1,1,0,0,0,0,0,0,343,112,231,-231
Rafael Dos Anjos,Terry Etim,Rafael Dos Anjos,2010-04-10,1,0,1,-1,2.133333,3.2,-12.7,12.7,15,-15,-7.619995,7.619995,337,89,47,21,26,-26,-1.06666660308838,1.06666660308838,1,2,1,0,-1,1,1,-1,203,301,-98,98
Edson Barboza,Terry Etim,Edson Barboza,2012-01-14,1,0,-1,1,2.090909,3.2,-5.080002,5.080002,-10,10,5.080002,-5.080002,1,16,34,21,13,-13,-1.10909104347229,1.10909104347229,3,0,0,0,3,-3,0,0,140,644,-504,504
James Irvin,Terry Martin,James Irvin,2005-08-20,1,0,2,-2,1.7,2.090909,15.24001,-15.24001,20,-20,10.16,-10.16,4,287,27,34,-7,7,-0.39090895652771,0.39090895652771,0,0,1,0,0,0,1,-1,196,0,196,-196
Jason Lambert,Terry Martin,Jason Lambert,2006-04-15,1,0,5,-5,2,2.090909,17.78,-17.78,0,0,10.16,-10.16,167,215,39,34,5,-5,-9.09090042114258e-02,9.09090042114258e-02,1,0,0,1,1,-1,-1,1,42,238,-196,196
Chris Leben,Terry Martin,Chris Leben,2007-09-19,1,0,1,-1,2,2.090909,7.619995,-7.619995,0,0,5.080002,-5.080002,87,419,33,34,-1,1,-9.09090042114258e-02,9.09090042114258e-02,0,0,1,2,0,0,-1,1,116,522,-406,406
Marvin Eastman,Terry Martin,Marvin Eastman,2008-02-02,1,0,9,-9,1.2,2.090909,2.539993,-2.539993,0,0,5.080002,-5.080002,254,334,33,34,-1,1,-0.89090895652771,0.89090895652771,0,0,2,3,0,0,-1,1,364,136,228,-228
Julian Erosa,Teruto Ishihara,Teruto Ishihara,2016-03-05,0,1,2,-2,2.333333,1.428571,15.24001,-15.24001,10,-10,12.70001,-12.70001,64,8,40,17,23,-23,0.904761791229248,-0.904761791229248,1,0,0,0,1,-1,0,0,85,0,85,-85
Horacio Gutierrez,Teruto Ishihara,Teruto Ishihara,2016-08-06,0,1,0,0,1.333333,1.428571,7.62001,-7.62001,10,-10,7.740005,-7.740005,0,6,7,17,-10,10,-9.52380895614624e-02,9.52380895614624e-02,0,1,0,0,-1,1,0,0,0,154,-154,154
Rolando Dy,Teruto Ishihara,Teruto Ishihara,2017-09-22,0,1,1,-1,1.285714,1.428571,2.540009,-2.540009,10,-10,0,0,1,356,16,17,-1,1,-0.142857193946838,0.142857193946838,0,2,0,0,-2,2,0,0,0,412,-412,412
Kyung Ho Kang,Teruto Ishihara,Kyung Ho Kang,2019-02-09,1,0,4,-4,2.111111,1.428571,5.080002,-5.080002,0,0,10.16,-10.16,74,12,28,17,11,-11,0.682539701461792,-0.682539701461792,0,3,0,0,-3,3,0,0,189,505,-316,316
Frank Hamaker,Thaddeus Luster,Frank Hamaker,1994-03-11,1,0,,,1,0,,,,,-20,20,0,0,1,1,0,0,1,-1,0,0,0,0,0,0,0,0,0,0,0,0
Martin Kampmann,Thales Leites,Martin Kampmann,2006-11-11,1,0,-1,1,2.857143,3.111111,-2.539993,2.539993,-15,15,-15.23999,15.23999,100,151,27,37,-10,10,-0.253968238830566,0.253968238830566,1,0,0,0,1,-1,0,0,86,0,86,-86
Ryan Jensen,Thales Leites,Thales Leites,2007-08-25,0,1,4,-4,2.625,3.111111,0,0,0,0,-5.080002,5.080002,40,73,29,37,-8,8,-0.486111164093018,0.486111164093018,0,0,0,0,0,0,0,0,0,287,-287,287
Ed Herman,Thales Leites,Thales Leites,2013-11-16,0,1,1,-1,1.6875,3.111111,0,0,20,-20,-2.539993,2.539993,74,686,43,37,6,-6,-1.42361116409302,1.42361116409302,3,1,1,0,2,-2,1,-1,112,2275,-2163,2163
Francis Carmont,Thales Leites,Thales Leites,2014-08-23,0,1,0,0,2.083333,3.111111,5.080002,-5.080002,20,-20,0,0,27,51,37,37,0,0,-1.02777791023254,1.02777791023254,0,2,0,0,-2,2,0,0,84,280,-196,196
Tim Boetsch,Thales Leites,Thales Leites,2015-01-31,0,1,1,-1,1.615385,3.111111,-2.539993,2.539993,0,0,-10.15999,10.15999,38,121,34,37,-3,3,-1.49572658538818,1.49572658538818,1,3,2,0,-2,2,2,-2,168,161,7,-7
Michael Bisping,Thales Leites,Michael Bisping,2015-07-18,1,0,3,-3,3.333333,3.111111,0,0,0,0,-7.619995,7.619995,35,58,39,37,2,-2,0.222222089767456,-0.222222089767456,1,4,1,0,-3,3,1,-1,84,168,-84,84
Chris Camozzi,Thales Leites,Thales Leites,2016-08-06,0,1,-5,5,1.846154,3.111111,2.540009,-2.540009,0,0,-7.619995,7.619995,22,681,37,37,0,0,-1.26495730876923,1.26495730876923,3,0,0,0,3,-3,0,0,69,385,-316,316
Krzysztof Jotko,Thales Leites,Krzysztof Jotko,2016-11-19,1,0,-8,8,4,3.111111,0,0,0,0,-2.539993,2.539993,483,169,30,37,-7,7,0.888888835906982,-0.888888835906982,4,1,0,0,3,-3,0,0,154,105,49,-49
Sam Alvey,Thales Leites,Thales Leites,2017-04-22,0,1,-5,5,1.833333,3.111111,2.540009,-2.540009,0,0,-7.619995,7.619995,21,98,51,37,14,-14,-1.27777779102325,1.27777779102325,4,0,1,0,4,-4,1,-1,84,154,-70,70
Jack Hermansson,Thales Leites,Jack Hermansson,2018-05-12,1,0,-7,7,2.875,3.111111,0,0,0,0,-2.539993,2.539993,126,461,31,37,-6,6,-0.236111164093018,0.236111164093018,0,1,1,0,-1,1,1,-1,196,385,-189,189
AJ Fletcher,Themba Gorimbo,AJ Fletcher,2023-02-18,1,0,-6,6,3.333333,2.75,-7.619995,7.619995,0,0,-25.40001,25.40001,201,120,13,15,-2,2,0.583333253860474,-0.583333253860474,0,0,0,0,0,0,0,0,182,0,182,-182
John Alessio,Thiago Alves,Thiago Alves,2006-10-10,0,1,4,-4,2.058824,1.533333,2.540009,-2.540009,-15,15,5.080002,-5.080002,251,76,52,38,14,-14,0.525490283966064,-0.525490283966064,0,0,0,0,0,0,0,0,136,0,136,-136
Papy Abedi,Thiago Alves,Thiago Alves,2011-11-05,0,1,5,-5,2.5,1.533333,5.080002,-5.080002,15,-15,11.39999,-11.39999,40,31,14,38,-24,24,0.966666698455811,-0.966666698455811,0,1,0,0,-1,1,0,0,0,1852,-1852,1852
Beneil Dariush,Thiago Moises,Beneil Dariush,2018-11-10,1,0,6,-6,4.4,2.428571,2.540009,-2.540009,0,0,5.080002,-5.080002,812,0,27,24,3,-3,1.97142863273621,-1.97142863273621,0,0,2,0,0,0,2,-2,252,0,252,-252
Kurt Holobaugh,Thiago Moises,Thiago Moises,2019-05-11,0,1,8,-8,3,2.428571,5.080002,-5.080002,0,0,0,0,193,471,28,24,4,-4,0.571428537368774,-0.571428537368774,0,0,0,0,0,0,0,0,2205,182,2023,-2023
Damir Ismagulov,Thiago Moises,Damir Ismagulov,2019-08-31,1,0,4,-4,8,2.428571,2.540009,-2.540009,0,0,10.16,-10.16,76,24,27,24,3,-3,5.57142853736877,-5.57142853736877,0,1,0,0,-1,1,0,0,0,112,-112,112
Michael Johnson,Thiago Moises,Thiago Moises,2020-05-13,0,1,8,-8,1.157895,2.428571,2.540009,-2.540009,0,0,7.619995,-7.619995,21,0,41,24,17,-17,-1.27067673206329,1.27067673206329,0,0,0,0,0,0,0,0,200,256,-56,56
Bobby Green,Thiago Moises,Thiago Moises,2020-10-31,0,1,9,-9,2.142857,2.428571,2.540009,-2.540009,0,0,2.539993,-2.539993,71,111,44,24,20,-20,-0.285714387893677,0.285714387893677,3,1,1,0,2,-2,1,-1,49,171,-122,122
Alexander Hernandez,Thiago Moises,Thiago Moises,2021-02-27,0,1,3,-3,2.333333,2.428571,0,0,-10,10,5.080002,-5.080002,0,0,20,24,-4,4,-9.5238208770752e-02,9.5238208770752e-02,1,2,0,0,-1,1,0,0,588,119,469,-469
Islam Makhachev,Thiago Moises,Islam Makhachev,2021-07-17,1,0,3,-3,24,2.428571,2.540009,-2.540009,0,0,0,0,491,204,25,24,1,-1,21.5714285373688,-21.5714285373688,4,3,1,0,1,-1,1,-1,679,140,539,-539
Joel Alvarez,Thiago Moises,Joel Alvarez,2021-11-13,1,0,2,-2,6.666667,2.428571,15.24001,-15.24001,0,0,17.78,-17.78,2,0,23,24,-1,1,4.23809504508972,-4.23809504508972,3,0,0,0,3,-3,0,0,385,119,266,-266
Christos Giagos,Thiago Moises,Thiago Moises,2022-06-25,0,1,5,-5,1.818182,2.428571,2.540009,-2.540009,0,0,2.539993,-2.539993,0,154,31,24,7,-7,-0.610389590263367,0.610389590263367,0,0,1,1,0,0,0,0,280,224,56,-56
Melquizael Costa,Thiago Moises,Thiago Moises,2023-01-21,0,1,-1,1,3.333333,2.428571,2.540009,-2.540009,-10,10,2.539993,-2.539993,2,331,26,24,2,-2,0.904761791229248,-0.904761791229248,0,1,0,1,-1,1,-1,1,0,210,-210,210
Leonardo Mafra,Thiago Perpetuo,Thiago Perpetuo,2012-06-23,0,1,-1,1,3.25,2.25,0,0,-15,15,-2.199997,2.199997,0,294,17,13,4,-4,1,-1,0,0,0,0,0,0,0,0,0,0,0,0
Omari Akhmedov,Thiago Perpetuo,Omari Akhmedov,2013-11-09,1,0,1,-1,3.5,2.25,5.080002,-5.080002,15,-15,5.419998,-5.419998,127,46,27,13,14,-14,1.25,-1.25,0,1,0,0,-1,1,0,0,0,504,-504,504
Cezar Ferreira,Thiago Santos,Cezar Ferreira,2013-08-03,1,0,-1,1,1.625,2,-2.540009,2.540009,-20,20,5.080002,-5.080002,7,4,21,33,-12,12,-0.375,0.375,1,0,0,0,1,-1,0,0,406,0,406,-406
Ronny Markes,Thiago Santos,Thiago Santos,2014-03-23,0,1,-5,5,3.4,2,-2.540009,2.540009,-20,20,-2.539993,2.539993,0,14,22,33,-11,11,1.40000009536743,-1.40000009536743,0,0,1,0,0,0,1,-1,137,232,-95,95
Uriah Hall,Thiago Santos,Uriah Hall,2014-07-05,1,0,-1,1,1.636364,2,-5.080002,5.080002,-20,20,7.62001,-7.62001,5,59,29,33,-4,4,-0.363636374473572,0.363636374473572,1,1,0,0,0,0,0,0,189,104,85,-85
Andy Enz,Thiago Santos,Thiago Santos,2015-01-31,0,1,-8,8,2.5,2,2.539993,-2.539993,-20,20,5.080002,-5.080002,0,7,14,33,-19,19,0.5,-0.5,0,0,0,0,0,0,0,0,217,210,7,-7
Steve Bosse,Thiago Santos,Thiago Santos,2015-06-27,0,1,2,-2,6,2,-7.62001,7.62001,0,0,-10.15999,10.15999,0,1,14,33,-19,19,4,-4,0,1,0,0,-1,1,0,0,0,147,-147,147
Nate Marquardt,Thiago Santos,Thiago Santos,2016-05-14,0,1,5,-5,1.842105,2,-5.080002,5.080002,-20,20,-5.079987,5.079987,0,27,54,33,21,-21,-0.157894730567932,0.157894730567932,0,2,1,0,-2,2,1,-1,497,322,175,-175
Gegard Mousasi,Thiago Santos,Gegard Mousasi,2016-07-09,1,0,-2,2,7,2,0,0,-20,20,0,0,129,0,48,33,15,-15,5,-5,1,3,0,0,-2,2,0,0,420,56,364,-364
Jack Marshman,Thiago Santos,Thiago Santos,2017-02-19,0,1,-6,6,2.3,2,-5.080002,5.080002,-20,20,-7.619995,7.619995,4,100,33,33,0,0,0.299999952316284,-0.299999952316284,0,0,0,1,0,0,-1,1,0,225,-225,225
Gerald Meerschaert,Thiago Santos,Thiago Santos,2017-07-08,0,1,-4,4,2.058824,2,-2.540009,2.540009,-20,20,2.540009,-2.540009,70,133,52,33,19,-19,5.88235855102539e-02,-5.88235855102539e-02,0,1,0,1,-1,1,-1,1,0,139,-139,139
Jack Hermansson,Thiago Santos,Thiago Santos,2017-10-28,0,1,-4,4,2.875,2,-2.540009,2.540009,-20,20,2.540009,-2.540009,35,3,31,33,-2,2,0.875,-0.875,2,2,0,1,0,0,-1,1,84,112,-28,28
David Branch,Thiago Santos,David Branch,2018-04-21,1,0,2,-2,3.666667,2,-2.540009,2.540009,-20,20,5.080002,-5.080002,2,0,28,33,-5,5,1.66666674613953,-1.66666674613953,0,3,2,1,-3,3,1,-1,217,175,42,-42
Kevin Holland,Thiago Santos,Thiago Santos,2018-08-04,0,1,-9,9,2.5,2,2.539993,-2.539993,-35,35,12.70001,-12.70001,70,577,35,33,2,-2,0.5,-0.5,0,0,0,2,0,0,-2,2,0,105,-105,105
Eryk Anders,Thiago Santos,Thiago Santos,2018-09-22,0,1,-3,3,1.875,2,-2.540009,2.540009,-20,20,-2.539993,2.539993,353,112,23,33,-10,10,-0.125,0.125,1,1,0,2,0,0,-2,2,28,49,-21,21
Jimi Manuwa,Thiago Santos,Thiago Santos,2018-12-08,0,1,4,-4,2.833333,2,-2.540009,2.540009,0,0,7.62001,-7.62001,145,80,23,33,-10,10,0.833333253860474,-0.833333253860474,0,2,1,2,-2,2,-1,1,497,77,420,-420
Jan Blachowicz,Thiago Santos,Thiago Santos,2019-02-23,0,1,0,0,2.9,2,0,0,0,0,5.080002,-5.080002,5,8,39,33,6,-6,0.900000095367432,-0.900000095367432,4,3,0,2,1,-1,-2,2,161,77,84,-84
Jon Jones,Thiago Santos,Jon Jones,2019-07-06,1,0,-4,4,27,2,5.079987,-5.079987,43,-43,20.32001,-20.32001,0,0,28,33,-5,5,25,-25,9,4,0,2,5,-5,-2,2,126,133,-7,7
Aleksandar Rakic,Thiago Santos,Aleksandar Rakic,2021-03-06,1,0,-8,8,4.666667,2,5.079987,-5.079987,0,0,5.080002,-5.080002,152,0,17,33,-16,16,2.66666650772095,-2.66666650772095,1,0,0,2,1,-1,-2,2,189,609,-420,420
Magomed Ankalaev,Thiago Santos,Magomed Ankalaev,2022-03-12,1,0,-9,9,18,2,2.539993,-2.539993,0,0,-2.539993,2.539993,215,17,19,33,-14,14,16,-16,6,0,0,2,6,-6,-2,2,133,371,-238,238
Jamahal Hill,Thiago Santos,Jamahal Hill,2022-08-06,1,0,-7,7,12,2,5.079987,-5.079987,0,0,7.62001,-7.62001,86,354,13,33,-20,20,10,-10,3,0,0,2,3,-3,-2,2,168,147,21,-21
James Irvin,Thiago Silva,Thiago Silva,2007-05-26,0,1,4,-4,1.7,3.166667,0,0,0,0,2.539993,-2.539993,17,36,27,25,2,-2,-1.46666669845581,1.46666669845581,2,0,1,0,2,-2,1,-1,189,0,189,-189
Tomasz Drwal,Thiago Silva,Thiago Silva,2007-09-08,0,1,1,-1,4.2,3.166667,-2.540009,2.540009,0,0,5.079987,-5.079987,64,25,26,25,1,-1,1.03333306312561,-1.03333306312561,0,1,0,0,-1,1,0,0,0,105,-105,105
Houston Alexander,Thiago Silva,Thiago Silva,2007-11-17,0,1,10,-10,1.133333,3.166667,-5.080002,5.080002,0,0,-5.080002,5.080002,29,116,32,25,7,-7,-2.03333342075348,2.03333342075348,2,2,0,0,0,0,0,0,70,70,0,0
Antonio Mendes,Thiago Silva,Thiago Silva,2008-05-24,0,1,2,-2,1.384615,3.166667,2.539993,-2.539993,0,0,7.619995,-7.619995,22,87,31,25,6,-6,-1.78205132484436,1.78205132484436,0,3,0,0,-3,3,0,0,0,189,-189,189
Lyoto Machida,Thiago Silva,Lyoto Machida,2009-01-31,1,0,4,-4,3,3.166667,-2.540009,2.540009,-20,20,0,0,148,24,32,25,7,-7,-0.166666746139526,0.166666746139526,3,4,0,0,-1,1,0,0,252,252,0,0
Keith Jardine,Thiago Silva,Thiago Silva,2009-08-29,0,1,7,-7,1.545455,3.166667,0,0,-20,20,5.079987,-5.079987,0,27,28,25,3,-3,-1.62121224403381,1.62121224403381,1,0,1,1,1,-1,0,0,315,210,105,-105
Rashad Evans,Thiago Silva,Rashad Evans,2010-01-02,1,0,3,-3,2.375,3.166667,-5.080002,5.080002,0,0,2.539993,-2.539993,434,14,27,25,2,-2,-0.791666746139526,0.791666746139526,0,1,1,1,-1,1,0,0,224,126,98,-98
Alexander Gustafsson,Thiago Silva,Alexander Gustafsson,2012-04-14,1,0,-4,4,2.25,3.166667,7.619995,-7.619995,0,0,12.7,-12.7,39,0,26,25,1,-1,-0.916666746139526,0.916666746139526,4,0,0,1,4,-4,-1,1,106,833,-727,727
Rafael Cavalcante,Thiago Silva,Thiago Silva,2013-06-08,0,1,3,-3,1.714286,3.166667,-2.540009,2.540009,0,0,0,0,0,3,19,25,-6,6,-1.45238101482391,1.45238101482391,0,0,0,1,0,0,-1,1,0,420,-420,420
Matt Hamill,Thiago Silva,Thiago Silva,2013-10-09,0,1,7,-7,1.5,3.166667,-2.540009,2.540009,0,0,5.079987,-5.079987,83,45,20,25,-5,5,-1.66666674613953,1.66666674613953,1,1,0,1,0,0,-1,1,382,123,259,-259
Naoyuki Kotani,Thiago Tavares,Thiago Tavares,2007-04-05,0,1,3,-3,2.428571,3,2.540009,-2.540009,10,-10,-10.16,10.16,355,308,48,28,20,-20,-0.571428537368774,0.571428537368774,0,0,0,0,0,0,0,0,0,0,0,0
Jason Black,Thiago Tavares,Thiago Tavares,2007-06-12,0,1,12,-12,5.75,3,2.540009,-2.540009,10,-10,-2.800003,2.800003,88,305,27,28,-1,1,2.75,-2.75,0,1,0,0,-1,1,0,0,0,68,-68,68
Tyson Griffin,Thiago Tavares,Tyson Griffin,2007-09-22,1,0,1,-1,2,3,-2.539993,2.539993,0,0,-5.080002,5.080002,475,236,24,28,-4,4,-1,1,2,2,0,0,0,0,0,0,98,102,-4,4
Michihiro Omigawa,Thiago Tavares,Thiago Tavares,2008-01-23,0,1,9,-9,1.214286,3,-2.539993,2.539993,0,0,-5.080002,5.080002,230,401,31,28,3,-3,-1.78571426868439,1.78571426868439,0,0,0,0,0,0,0,0,123,123,0,0
Kurt Pellegrino,Thiago Tavares,Kurt Pellegrino,2008-09-06,1,0,6,-6,2.285714,3,2.540009,-2.540009,10,-10,0,0,380,206,23,28,-5,5,-0.714285612106323,0.714285612106323,0,1,0,0,-1,1,0,0,378,227,151,-151
Manvel Gamburyan,Thiago Tavares,Thiago Tavares,2009-01-31,0,1,3,-3,1.5,3,-5.079987,5.079987,-10,10,-7.62001,7.62001,138,308,25,28,-3,3,-1.5,1.5,1,0,0,0,1,-1,0,0,399,147,252,-252
Pat Audinwood,Thiago Tavares,Thiago Tavares,2010-09-25,0,1,-1,1,5.5,3,12.70001,-12.70001,10,-10,8.73999,-8.73999,5,178,13,28,-15,15,2.5,-2.5,0,1,0,0,-1,1,0,0,0,602,-602,602
Shane Roller,Thiago Tavares,Shane Roller,2011-03-03,1,0,5,-5,1.571429,3,7.62001,-7.62001,10,-10,5.080002,-5.080002,12,29,18,28,-10,10,-1.42857146263123,1.42857146263123,0,2,0,0,-2,2,0,0,0,159,-159,159
Spencer Fisher,Thiago Tavares,Thiago Tavares,2011-08-27,0,1,9,-9,2.666667,3,0,0,10,-10,-5.080002,5.080002,1,403,33,28,5,-5,-0.333333253860474,0.333333253860474,0,0,2,1,0,0,1,-1,182,177,5,-5
Sam Stout,Thiago Tavares,Thiago Tavares,2012-01-14,0,1,0,0,1.666667,3,5.080002,-5.080002,10,-10,0,0,21,144,32,28,4,-4,-1.33333337306976,1.33333337306976,2,1,0,1,1,-1,-1,1,448,140,308,-308
Khabib Nurmagomedov,Thiago Tavares,Khabib Nurmagomedov,2013-01-19,1,0,-4,4,29,3,7.62001,-7.62001,10,-10,0,0,13,0,29,28,1,-1,26,-26,2,2,0,1,0,0,-1,1,196,371,-175,175
Justin Salas,Thiago Tavares,Thiago Tavares,2013-11-09,0,1,2,-2,1.714286,3,2.540009,-2.540009,10,-10,0,0,17,78,19,28,-9,9,-1.28571426868439,1.28571426868439,0,0,0,2,0,0,-2,2,0,294,-294,294
Robert Peralta,Thiago Tavares,Thiago Tavares,2014-08-16,0,1,-1,1,2.25,3,2.540009,-2.540009,0,0,2.539993,-2.539993,0,232,26,28,-2,2,-0.75,0.75,1,1,0,2,0,0,-2,2,686,280,406,-406
Brian Ortega,Thiago Tavares,Brian Ortega,2015-06-06,1,0,-6,6,5,3,2.540009,-2.540009,0,0,-2.540009,2.540009,53,505,18,28,-10,10,2,-2,0,2,0,2,-2,2,-2,2,0,294,-294,294
Clay Guida,Thiago Tavares,Thiago Tavares,2015-11-07,0,1,3,-3,1.9,3,0,0,10,-10,0,0,18,1,58,28,30,-30,-1.10000002384186,1.10000002384186,2,0,1,3,2,-2,-2,2,217,154,63,-63
Dooho Choi,Thiago Tavares,Dooho Choi,2016-07-08,1,0,-6,6,3.5,3,7.62001,-7.62001,0,0,0,0,17,118,18,28,-10,10,0.5,-0.5,2,1,0,3,1,-1,-3,3,223,244,-21,21
Olivier Aubin-Mercier,Thibault Gouti,Olivier Aubin-Mercier,2016-06-18,1,0,-2,2,2.2,2.4,-2.540009,2.540009,0,0,-5.080002,5.080002,454,27,16,17,-1,1,-0.200000047683716,0.200000047683716,0,0,0,0,0,0,0,0,140,0,140,-140
Mike Davis,Thomas Gifford,Mike Davis,2019-10-12,1,0,0,0,5,1.555556,-2.539993,2.539993,0,0,-7.619995,7.619995,116,0,12,23,-11,11,3.44444441795349,-3.44444441795349,0,0,0,0,0,0,0,0,0,0,0,0
Don Frye,Thomas Ramirez,Don Frye,1996-02-16,1,0,,,2.222222,0,0,0,-191,191,0,0,0,0,29,1,28,-28,2.22222232818604,-2.22222232818604,1,0,0,0,1,-1,0,0,0,0,0,0
Bob Cook,Tiki Ghosn,Bob Cook,2000-03-10,1,0,,,5,1.428571,-2.540009,2.540009,0,0,-2,2,68,127,5,17,-12,12,3.57142853736877,-3.57142853736877,0,0,0,0,0,0,0,0,0,0,0,0
Omari Akhmedov,Tim Boetsch,Omari Akhmedov,2019-03-09,1,0,-7,7,3.5,1.615385,0,0,0,0,-2.540009,2.540009,194,2,27,34,-7,7,1.88461542129517,-1.88461542129517,2,0,2,0,2,-2,2,-2,650,0,650,-650
Nick Catone,Tim Credeur,Tim Credeur,2009-04-01,0,1,-4,4,2.5,3,-7.619995,7.619995,0,0,-7.619995,7.619995,331,24,14,16,-2,2,-0.5,0.5,1,0,0,0,1,-1,0,0,53,0,53,-53
John Dodson,Tim Elliott,John Dodson,2012-05-05,1,0,2,-2,1.833333,1.666667,-10.15999,10.15999,10,-10,0,0,12,2,34,32,2,-2,0.166666746139526,-0.166666746139526,0,0,0,0,0,0,0,0,0,0,0,0
Ali Bagautinov,Tim Elliott,Ali Bagautinov,2013-11-16,1,0,2,-2,2.5,1.666667,-7.619995,7.619995,0,0,-2.539993,2.539993,34,66,21,32,-11,11,0.833333373069763,-0.833333373069763,1,0,0,0,1,-1,0,0,73,560,-487,487
Joseph Benavidez,Tim Elliott,Joseph Benavidez,2014-04-26,1,0,2,-2,3.5,1.666667,-7.619995,7.619995,0,0,-2.539993,2.539993,93,76,36,32,4,-4,1.83333337306976,-1.83333337306976,0,0,1,0,0,0,1,-1,133,161,-28,28
Mark De La Rosa,Tim Elliott,Tim Elliott,2017-12-30,0,1,-8,8,2.2,1.666667,-2.539993,2.539993,10,-10,-2.539993,2.539993,31,334,16,32,-16,16,0.533333420753479,-0.533333420753479,0,0,0,0,0,0,0,0,0,1344,-1344,1344
Askar Askarov,Tim Elliott,Askar Askarov,2020-01-18,1,0,-6,6,14,1.666667,-2.539993,2.539993,0,0,2.539993,-2.539993,245,122,15,32,-17,17,12.3333333730698,-12.3333333730698,0,1,0,0,-1,1,0,0,0,749,-749,749
Ryan Benoit,Tim Elliott,Tim Elliott,2020-07-15,0,1,-3,3,1.25,1.666667,-5.079987,5.079987,0,0,5.080002,-5.080002,22,162,18,32,-14,14,-0.416666626930237,0.416666626930237,1,0,0,0,1,-1,0,0,970,179,791,-791
Victor Altamirano,Tim Elliott,Tim Elliott,2023-06-03,0,1,-4,4,4,1.666667,2.540009,-2.540009,0,0,10.16,-10.16,64,673,15,32,-17,17,2.33333337306976,-2.33333337306976,2,1,0,0,1,-1,0,0,70,1053,-983,983
Mitch Gagnon,Tim Gorman,Mitch Gagnon,2014-04-16,1,0,-1,1,2.4,2.25,0,0,0,0,-2.899994,2.899994,188,409,17,13,4,-4,0.150000095367432,-0.150000095367432,2,0,0,0,2,-2,0,0,207,0,207,-207
Thomas Almeida,Tim Gorman,Thomas Almeida,2014-11-08,1,0,-8,8,4.4,2.25,5.079987,-5.079987,10,-10,9.800003,-9.800003,3,133,27,13,14,-14,2.15000009536743,-2.15000009536743,0,0,0,0,0,0,0,0,0,206,-206,206
Pat Barry,Tim Hague,Tim Hague,2009-05-23,0,1,3,-3,1.142857,1.615385,-12.7,12.7,-25,25,-5.079987,5.079987,0,44,15,34,-19,19,-0.472527384757996,0.472527384757996,1,0,0,0,1,-1,0,0,147,0,147,-147
Todd Duffee,Tim Hague,Todd Duffee,2009-08-29,1,0,-3,3,3,1.615385,-2.539993,2.539993,0,0,5.080002,-5.080002,4,0,12,34,-22,22,1.38461542129517,-1.38461542129517,0,1,0,0,-1,1,0,0,0,98,-98,98
Joey Beltran,Tim Hague,Joey Beltran,2010-05-08,1,0,2,-2,1.214286,1.615385,-7.619995,7.619995,-75,75,-2.539993,2.539993,19,158,31,34,-3,3,-0.401098847389221,0.401098847389221,1,0,0,1,1,-1,-1,1,91,252,-161,161
Roger Gracie,Tim Kennedy,Tim Kennedy,2013-07-06,0,1,-2,2,4,3,12.7,-12.7,0,0,12.7,-12.7,206,371,10,24,-14,14,1,-1,0,0,0,0,0,0,0,0,0,0,0,0
Michael Bisping,Tim Kennedy,Tim Kennedy,2014-04-16,0,1,1,-1,3.333333,3,5.080002,-5.080002,0,0,2.539993,-2.539993,3,721,39,24,15,-15,0.333333253860474,-0.333333253860474,1,1,1,0,0,0,1,-1,571,284,287,-287
Kelvin Gastelum,Tim Kennedy,Kelvin Gastelum,2016-12-10,1,0,-12,12,2.25,3,-5.080002,5.080002,-15,15,-7.62001,7.62001,70,234,26,24,2,-2,-0.75,0.75,1,2,0,0,-1,1,0,0,154,969,-815,815
Tsuyoshi Kohsaka,Tim Lajcik,Tsuyoshi Kohsaka,1999-07-16,1,0,-5,5,1.421053,1.166667,-5.080002,5.080002,0,0,-3,3,75,420,46,13,33,-33,0.254385948181152,-0.254385948181152,0,0,1,0,0,0,1,-1,189,0,189,-189
Bernardo Magalhaes,Tim Means,Tim Means,2012-02-15,0,1,3,-3,3.25,2.2,-12.70001,12.70001,-15,15,-12.5,12.5,9,59,17,48,-31,31,1.04999995231628,-1.04999995231628,0,0,0,0,0,0,0,0,0,0,0,0
Jorge Masvidal,Tim Means,Jorge Masvidal,2013-04-20,1,0,-1,1,2.058824,2.2,-7.62001,7.62001,0,0,-2.539993,2.539993,442,18,52,48,4,-4,-0.141176462173462,0.141176462173462,0,1,0,0,-1,1,0,0,0,430,-430,430
Danny Castillo,Tim Means,Danny Castillo,2013-07-27,1,0,4,-4,1.7,2.2,-12.70001,12.70001,-15,15,-10.16,10.16,336,41,27,48,-21,21,-0.5,0.5,1,0,1,0,1,-1,1,-1,161,98,63,-63
Neil Magny,Tim Means,Neil Magny,2014-05-10,1,0,-4,4,2.333333,2.2,2.539993,-2.539993,0,0,12.7,-12.7,319,60,40,48,-8,8,0.133333206176758,-0.133333206176758,1,0,0,0,1,-1,0,0,98,287,-189,189
Marcio Alexandre Junior,Tim Means,Tim Means,2014-12-20,0,1,-5,5,4.25,2.2,-5.080002,5.080002,15,-15,0,0,106,137,21,48,-27,27,2.04999995231628,-2.04999995231628,0,0,0,0,0,0,0,0,203,224,-21,21
Dhiego Lima,Tim Means,Tim Means,2015-02-28,0,1,-5,5,1.888889,2.2,0,0,0,0,0,0,2,22,26,48,-22,22,-0.311111211776733,0.311111211776733,0,1,0,0,-1,1,0,0,0,70,-70,70
Matt Brown,Tim Means,Matt Brown,2015-07-11,1,0,3,-3,1.368421,2.2,-5.080002,5.080002,0,0,0,0,106,17,45,48,-3,3,-0.831578969955444,0.831578969955444,0,2,0,0,-2,2,0,0,119,133,-14,14
John Howard,Tim Means,Tim Means,2015-12-10,0,1,1,-1,1.846154,2.2,-17.78001,17.78001,0,0,-7.619995,7.619995,60,4,37,48,-11,11,-0.353846192359924,0.353846192359924,1,0,1,0,1,-1,1,-1,152,152,0,0
Sabah Homasi,Tim Means,Tim Means,2016-08-20,0,1,-5,5,1.375,2.2,-5.080002,5.080002,0,0,-7.619995,7.619995,61,8,19,48,-29,29,-0.825000047683716,0.825000047683716,0,1,0,0,-1,1,0,0,0,254,-254,254
Alex Garcia,Tim Means,Tim Means,2017-06-25,0,1,-4,4,2.5,2.2,-12.70001,12.70001,0,0,-7.619995,7.619995,29,1,21,48,-27,27,0.299999952316284,-0.299999952316284,1,2,1,0,-1,1,1,-1,177,309,-132,132
Thiago Alves,Tim Means,Tim Means,2019-12-07,0,1,1,-1,1.533333,2.2,-12.70001,12.70001,0,0,-12.7,12.7,0,42,38,48,-10,10,-0.666666746139526,0.666666746139526,0,3,3,0,-3,3,3,-3,210,895,-685,685
Nicolas Dalby,Tim Means,Tim Means,2021-06-26,0,1,-1,1,5.5,2.2,-7.62001,7.62001,0,0,-2.539993,2.539993,91,483,26,48,-22,22,3.29999995231628,-3.29999995231628,2,4,0,0,-2,2,0,0,217,567,-350,350
Kevin Holland,Tim Means,Kevin Holland,2022-06-18,1,0,-9,9,2.5,2.2,2.539993,-2.539993,0,0,15.24001,-15.24001,9,90,35,48,-13,13,0.299999952316284,-0.299999952316284,1,5,0,0,-4,4,0,0,105,357,-252,252
Max Griffin,Tim Means,Max Griffin,2022-10-29,1,0,-2,2,1.9,2.2,-7.62001,7.62001,0,0,2.539993,-2.539993,313,87,29,48,-19,19,-0.300000071525574,0.300000071525574,0,0,0,0,0,0,0,0,217,133,84,-84
Andre Fialho,Tim Means,Tim Means,2023-09-23,0,1,-10,10,2,2.2,-5.080002,5.080002,0,0,-2.539993,2.539993,48,171,24,48,-24,24,-0.200000047683716,0.200000047683716,0,0,2,0,0,0,2,-2,308,329,-21,21
Wesley Correira,Tim Sylvia,Tim Sylvia,2002-09-27,0,1,-3,3,1.25,3.1,-12.7,12.7,-5,5,-3.199997,3.199997,0,3,36,41,-5,5,-1.84999990463257,1.84999990463257,0,0,0,0,0,0,0,0,0,0,0,0
Ricco Rodriguez,Tim Sylvia,Tim Sylvia,2003-02-28,0,1,-1,1,2.12,3.1,-10.16,10.16,0,0,-25.2,25.2,0,78,78,41,37,-37,-0.980000019073486,0.980000019073486,1,1,0,0,0,0,0,0,483,154,329,-329
Gan McGee,Tim Sylvia,Tim Sylvia,2003-09-26,0,1,-1,1,2.6,3.1,5.080002,-5.080002,0,0,6.800003,-6.800003,0,4,18,41,-23,23,-0.5,0.5,1,2,0,0,-1,1,0,0,364,210,154,-154
Frank Mir,Tim Sylvia,Frank Mir,2004-06-19,1,0,-3,3,1.636364,3.1,-12.7,12.7,-1,1,-2.539993,2.539993,0,29,29,41,-12,12,-1.46363627910614,1.46363627910614,4,3,0,0,1,-1,0,0,140,267,-127,127
Andrei Arlovski,Tim Sylvia,Andrei Arlovski,2005-02-05,1,0,-2,2,1.545455,3.1,-12.7,12.7,-25,25,-7.619995,7.619995,8,0,56,41,15,-15,-1.55454540252686,1.55454540252686,3,0,2,0,3,-3,2,-2,309,231,78,-78
Assuerio Silva,Tim Sylvia,Tim Sylvia,2006-01-16,0,1,2,-2,2,3.1,-25.39999,25.39999,-24,24,-23.2,23.2,68,197,24,41,-17,17,-1.09999990463257,1.09999990463257,0,0,0,0,0,0,0,0,0,345,-345,345
Andrei Arlovski,Tim Sylvia,Tim Sylvia,2006-04-15,0,1,-3,3,1.545455,3.1,-12.7,12.7,-25,25,-7.619995,7.619995,7,4,56,41,15,-15,-1.55454540252686,1.55454540252686,6,1,2,0,5,-5,2,-2,190,89,101,-101
Andrei Arlovski,Tim Sylvia,Tim Sylvia,2006-07-08,0,1,-3,3,1.545455,3.1,-12.7,12.7,-25,25,-7.619995,7.619995,0,45,56,41,15,-15,-1.55454540252686,1.55454540252686,0,2,3,0,-2,2,3,-3,84,84,0,0
Jeff Monson,Tim Sylvia,Tim Sylvia,2006-11-18,0,1,5,-5,2.307692,3.1,-27.94,27.94,-18,18,-15.23999,15.23999,309,344,86,41,45,-45,-0.792307615280151,0.792307615280151,1,3,1,0,-2,2,1,-1,133,133,0,0
Randy Couture,Tim Sylvia,Randy Couture,2007-03-03,1,0,13,-13,1.727273,3.1,-17.78,17.78,-60,60,-12.7,12.7,951,45,30,41,-11,11,-1.37272715568542,1.37272715568542,0,4,3,0,-4,4,3,-3,392,105,287,-287
Antonio Rodrigo Nogueira,Tim Sylvia,Antonio Rodrigo Nogueira,2008-02-02,1,0,0,0,3.4,3.1,-12.7,12.7,-25,25,-7.619995,7.619995,31,120,44,41,3,-3,0.300000190734863,-0.300000190734863,0,0,0,0,0,0,0,0,0,336,-336,336
Oskar Piechota,Tim Williams,Oskar Piechota,2018-02-18,1,0,-3,3,3.666667,3,-5.080002,5.080002,0,0,0,0,4,0,14,20,-6,6,0.666666746139526,-0.666666746139526,1,0,0,0,1,-1,0,0,120,0,120,-120
Eryk Anders,Tim Williams,Eryk Anders,2018-08-25,1,0,-1,1,1.875,3,-2.540009,2.540009,0,0,-2.539993,2.539993,71,91,23,20,3,-3,-1.125,1.125,0,0,0,1,0,0,-1,1,203,188,15,-15
Shamil Abdurakhimov,Timothy Johnson,Timothy Johnson,2015-04-04,0,1,3,-3,2.5,3,0,0,-30,30,-2.540009,2.540009,31,57,28,16,12,-12,-0.5,0.5,0,0,0,0,0,0,0,0,0,0,0,0
Junior Albini,Timothy Johnson,Junior Albini,2017-07-22,1,0,-6,6,2.333333,3,0,0,-1,1,-7.619995,7.619995,1,81,20,16,4,-4,-0.666666746139526,0.666666746139526,0,1,0,0,-1,1,0,0,0,840,-840,840
Marcelo Golm,Timothy Johnson,Timothy Johnson,2018-02-03,0,1,-7,7,2,3,0,0,-16,16,-5.080002,5.080002,64,348,9,16,-7,7,-1,1,0,0,0,1,0,0,-1,1,0,196,-196,196
Martin Day,Timur Valiev,Timur Valiev,2021-02-06,0,1,1,-1,1.333333,6,10.16,-10.16,10,-10,15.24001,-15.24001,15,679,14,21,-7,7,-4.66666662693024,4.66666662693024,0,0,1,0,0,0,1,-1,70,0,70,-70
Raoni Barcelos,Timur Valiev,Timur Valiev,2021-06-26,0,1,3,-3,3.4,6,2.539993,-2.539993,0,0,0,0,83,42,22,21,1,-1,-2.59999990463257,2.59999990463257,5,1,0,0,4,-4,0,0,231,140,91,-91
Jack Shore,Timur Valiev,Jack Shore,2022-03-19,1,0,-5,5,17,6,5.080002,-5.080002,0,0,10.16,-10.16,282,123,18,21,-3,3,11,-11,0,2,0,0,-2,2,0,0,0,266,-266,266
Claudia Gadelha,Tina Lahdemaki,Claudia Gadelha,2014-07-16,1,0,-1,1,3.6,5,5.080002,-5.080002,0,0,2.000427e-02,-2.000427e-02,435,0,23,6,17,-17,-1.40000009536743,1.40000009536743,0,0,0,0,0,0,0,0,0,0,0,0
Guy Mezger,Tito Ortiz,Guy Mezger,1997-05-30,1,0,7,-7,2.142857,1.583333,-5.080002,5.080002,-5,5,3.039993,-3.039993,0,0,44,31,13,-13,0.559523701667786,-0.559523701667786,0,0,0,0,0,0,0,0,0,0,0,0
Wes Albritton,Tito Ortiz,Tito Ortiz,1997-05-30,0,1,,,0,1.583333,-12.7,12.7,-17,17,2.039993,-2.039993,0,0,1,31,-30,30,-1.58333337306976,1.58333337306976,0,0,0,0,0,0,0,0,0,0,0,0
Jerry Bohlander,Tito Ortiz,Tito Ortiz,1999-01-08,0,1,1,-1,2.75,1.583333,-10.16,10.16,-6,6,-4.960007,4.960007,0,0,15,31,-16,16,1.16666662693024,-1.16666662693024,4,1,1,0,3,-3,1,-1,301,588,-287,287
Guy Mezger,Tito Ortiz,Tito Ortiz,1999-03-05,0,1,7,-7,2.142857,1.583333,-5.080002,5.080002,-5,5,3.039993,-3.039993,0,0,44,31,13,-13,0.559523701667786,-0.559523701667786,1,2,0,0,-1,1,0,0,644,56,588,-588
Yuki Kondo,Tito Ortiz,Tito Ortiz,2000-12-16,0,1,0,0,1.818182,1.583333,-10.16,10.16,-22,22,-5.960007,5.960007,1,95,93,31,62,-62,0.234848499298096,-0.234848499298096,0,3,0,0,-3,3,0,0,0,652,-652,652
Vladimir Matyushenko,Tito Ortiz,Tito Ortiz,2001-09-28,0,1,4,-4,3.375,1.583333,-7.619995,7.619995,0,0,0,0,70,1294,35,31,4,-4,1.79166662693024,-1.79166662693024,0,4,0,0,-4,4,0,0,0,286,-286,286
Randy Couture,Tito Ortiz,Randy Couture,2003-09-26,1,0,12,-12,1.727273,1.583333,-5.080002,5.080002,0,0,2.539993,-2.539993,1273,129,30,31,-1,1,0.14393937587738,-0.14393937587738,1,5,1,0,-4,4,1,-1,112,728,-616,616
Chuck Liddell,Tito Ortiz,Chuck Liddell,2004-04-02,1,0,5,-5,2.625,1.583333,-2.539993,2.539993,0,0,5.079987,-5.079987,1,0,29,31,-2,2,1.04166662693024,-1.04166662693024,4,0,0,0,4,-4,0,0,497,189,308,-308
Patrick Cote,Tito Ortiz,Tito Ortiz,2004-10-22,0,1,-5,5,2.090909,1.583333,-10.16,10.16,-35,35,2.539993,-2.539993,0,761,34,31,3,-3,0.507575631141663,-0.507575631141663,0,0,0,1,0,0,-1,1,0,203,-203,203
Vitor Belfort,Tito Ortiz,Tito Ortiz,2005-02-05,0,1,-3,3,1.857143,1.583333,-7.619995,7.619995,-20,20,0,0,186,563,40,31,9,-9,0.273809432983398,-0.273809432983398,0,1,2,1,-1,1,1,-1,168,106,62,-62
Forrest Griffin,Tito Ortiz,Tito Ortiz,2006-04-15,0,1,-4,4,2.714286,1.583333,0,0,0,0,7.619995,-7.619995,14,301,26,31,-5,5,1.13095223903656,-1.13095223903656,2,2,0,1,0,0,-1,1,190,434,-244,244
Chuck Liddell,Tito Ortiz,Chuck Liddell,2006-12-30,1,0,6,-6,2.625,1.583333,-2.539993,2.539993,0,0,5.079987,-5.079987,73,19,29,31,-2,2,1.04166662693024,-1.04166662693024,7,3,0,1,4,-4,-1,1,126,259,-133,133
Lyoto Machida,Tito Ortiz,Lyoto Machida,2008-05-24,1,0,-4,4,3,1.583333,-5.080002,5.080002,-20,20,0,0,175,19,32,31,1,-1,1.41666662693024,-1.41666662693024,2,0,0,2,2,-2,-2,2,147,511,-364,364
Forrest Griffin,Tito Ortiz,Forrest Griffin,2009-11-21,1,0,-4,4,2.714286,1.583333,0,0,0,0,7.619995,-7.619995,71,249,26,31,-5,5,1.13095223903656,-1.13095223903656,0,0,2,2,0,0,0,0,105,546,-441,441
Matt Hamill,Tito Ortiz,Matt Hamill,2010-10-23,1,0,-1,1,1.5,1.583333,-5.080002,5.080002,0,0,5.079987,-5.079987,232,0,20,31,-11,11,-8.33333730697632e-02,8.33333730697632e-02,5,0,0,2,5,-5,-2,2,126,336,-210,210
Ryan Bader,Tito Ortiz,Tito Ortiz,2011-07-02,0,1,-8,8,4.6,1.583333,-2.539993,2.539993,0,0,0,0,9,6,28,31,-3,3,3.01666653156281,-3.01666653156281,0,0,0,2,0,0,-2,2,147,252,-105,105
Rashad Evans,Tito Ortiz,Rashad Evans,2011-08-06,1,0,-5,5,2.375,1.583333,-7.619995,7.619995,0,0,2.539993,-2.539993,305,64,27,31,-4,4,0.791666626930237,-0.791666626930237,2,1,1,2,1,-1,-1,1,434,35,399,-399
Rogerio Nogueira,Tito Ortiz,Rogerio Nogueira,2011-12-10,1,0,-1,1,2.3,1.583333,-2.539993,2.539993,0,0,2.539993,-2.539993,96,56,33,31,2,-2,0.716666579246521,-0.716666579246521,0,0,0,3,0,0,-3,3,0,126,-126,126
Forrest Griffin,Tito Ortiz,Forrest Griffin,2012-07-07,1,0,-4,4,2.714286,1.583333,0,0,0,0,7.619995,-7.619995,52,164,26,31,-5,5,1.13095223903656,-1.13095223903656,0,0,3,4,0,0,-1,1,315,210,105,-105
Bill Algeo,TJ Brown,Bill Algeo,2023-04-15,1,0,1,-1,2.428571,1.7,7.62001,-7.62001,0,0,2.539993,-2.539993,102,39,24,27,-3,3,0.72857141494751,-0.72857141494751,0,0,0,0,0,0,0,0,210,0,210,-210
Raphael Assuncao,TJ Dillashaw,Raphael Assuncao,2013-10-09,1,0,4,-4,2.8,3.6,-2.539993,2.539993,0,0,-2.539993,2.539993,19,168,38,23,15,-15,-0.799999952316284,0.799999952316284,4,0,1,0,4,-4,1,-1,123,0,123,-123
Renan Barao,TJ Dillashaw,TJ Dillashaw,2014-05-24,0,1,-1,1,3.777778,3.6,0,0,10,-10,7.62001,-7.62001,0,218,43,23,20,-20,0.177777767181396,-0.177777767181396,7,0,0,0,7,-7,0,0,112,227,-115,115
Renan Barao,TJ Dillashaw,TJ Dillashaw,2015-07-25,0,1,-1,1,3.777778,3.6,0,0,10,-10,7.62001,-7.62001,9,337,43,23,20,-20,0.177777767181396,-0.177777767181396,1,1,1,0,0,0,1,-1,217,427,-210,210
Dominick Cruz,TJ Dillashaw,Dominick Cruz,2016-01-17,1,0,1,-1,6,3.6,5.080002,-5.080002,0,0,2.540009,-2.540009,33,72,28,23,5,-5,2.40000009536743,-2.40000009536743,3,2,0,0,1,-1,0,0,477,176,301,-301
Raphael Assuncao,TJ Dillashaw,TJ Dillashaw,2016-07-09,0,1,3,-3,2.8,3.6,-2.539993,2.539993,0,0,-2.539993,2.539993,2,49,38,23,15,-15,-0.799999952316284,0.799999952316284,7,0,1,0,7,-7,1,-1,644,174,470,-470
Henry Cejudo,TJ Dillashaw,Henry Cejudo,2019-01-19,1,0,-1,1,5.333333,3.6,-5.080002,5.080002,0,0,-7.619995,7.619995,0,9,19,23,-4,4,1.73333358764648,-1.73333358764648,3,1,1,0,2,-2,1,-1,168,924,-756,756
Ryo Chonan,TJ Grant,TJ Grant,2009-04-18,0,1,7,-7,1.692308,4.2,-2.540009,2.540009,15,-15,-5.080002,5.080002,549,203,35,26,9,-9,-2.50769209861755,2.50769209861755,0,0,0,0,0,0,0,0,518,0,518,-518
Kevin Burns,TJ Grant,TJ Grant,2009-12-12,0,1,4,-4,1.714286,4.2,0,0,15,-15,5.080002,-5.080002,39,146,19,26,-7,7,-2.48571407794952,2.48571407794952,0,1,1,0,-1,1,1,-1,175,238,-63,63
Ricardo Almeida,TJ Grant,Ricardo Almeida,2010-12-11,1,0,8,-8,2.6,4.2,5.080002,-5.080002,15,-15,5.080002,-5.080002,739,52,18,26,-8,8,-1.59999990463257,1.59999990463257,0,2,1,0,-2,2,1,-1,126,364,-238,238
Evan Dunham,TJ Grant,TJ Grant,2012-09-22,0,1,2,-2,2,4.2,0,0,0,0,-5.080002,5.080002,108,40,27,26,1,-1,-2.19999980926514,2.19999980926514,1,0,1,0,1,-1,1,-1,238,651,-413,413
Paul Kelly,"TJ O'Brien",Paul Kelly,2010-11-20,1,0,3,-3,2.8,2.5,-12.70001,12.70001,0,0,-10.2,10.2,174,27,19,28,-9,9,0.299999952316284,-0.299999952316284,0,0,1,0,0,0,1,-1,111,0,111,-111
Cole Miller,"TJ O'Brien",Cole Miller,2011-08-14,1,0,3,-3,1.909091,2.5,-2.540009,2.540009,-10,10,-2.580002,2.580002,49,7,32,28,4,-4,-0.590909123420715,0.590909123420715,0,0,1,1,0,0,0,0,204,267,-63,63
David Mitchell,TJ Waldburger,TJ Waldburger,2010-09-15,0,1,8,-8,3.142857,1.777778,2.540009,-2.540009,0,0,0,0,95,652,29,25,4,-4,1.36507928371429,-1.36507928371429,0,0,0,0,0,0,0,0,0,0,0,0
Johny Hendricks,TJ Waldburger,Johny Hendricks,2011-03-26,1,0,5,-5,2.25,1.777778,-5.080002,5.080002,15,-15,-15.24001,15.24001,26,31,26,25,1,-1,0.472222208976746,-0.472222208976746,0,1,0,0,-1,1,0,0,112,192,-80,80
Mike Stumpf,TJ Waldburger,TJ Waldburger,2011-09-17,0,1,2,-2,2.75,1.777778,-2.539993,2.539993,0,0,-10.5,10.5,24,196,15,25,-10,10,0.972222208976746,-0.972222208976746,0,0,0,1,0,0,-1,1,0,175,-175,175
Jake Hecht,TJ Waldburger,TJ Waldburger,2012-03-02,0,1,5,-5,2.75,1.777778,2.540009,-2.540009,0,0,-5.080002,5.080002,3,6,15,25,-10,10,0.972222208976746,-0.972222208976746,0,1,0,1,-1,1,-1,1,0,167,-167,167
Brian Ebersole,TJ Waldburger,Brian Ebersole,2012-06-22,1,0,7,-7,2.833333,1.777778,2.540009,-2.540009,0,0,-5.080002,5.080002,495,104,69,25,44,-44,1.05555546283722,-1.05555546283722,3,2,0,1,1,-1,-1,1,195,112,83,-83
Nick Catone,TJ Waldburger,TJ Waldburger,2012-12-15,0,1,7,-7,2.5,1.777778,2.540009,-2.540009,15,-15,-7.619995,7.619995,199,79,14,25,-11,11,0.722222208976746,-0.722222208976746,2,0,0,1,2,-2,-1,1,637,176,461,-461
Adlan Amagov,TJ Waldburger,Adlan Amagov,2013-10-19,1,0,1,-1,7,1.777778,7.62001,-7.62001,0,0,2.539993,-2.539993,5,38,16,25,-9,9,5.22222220897675,-5.22222220897675,1,1,0,1,0,0,-1,1,196,308,-112,112
Mike Pyle,TJ Waldburger,Mike Pyle,2014-02-22,1,0,13,-13,1.928571,1.777778,2.540009,-2.540009,0,0,-2.539993,2.539993,197,146,41,25,16,-16,0.150793671607971,-0.150793671607971,2,0,0,2,2,-2,-2,2,273,126,147,-147
Tim Boetsch,Todd Brown,Tim Boetsch,2010-08-07,1,0,-4,4,1.615385,4,2.540009,-2.540009,-20,20,4.960007,-4.960007,224,131,34,20,14,-14,-2.38461542129517,2.38461542129517,0,0,1,0,0,0,1,-1,518,0,518,-518
Philip De Fries,Todd Duffee,Todd Duffee,2012-12-29,0,1,-1,1,2,3,5.080002,-5.080002,-10,10,2.540009,-2.540009,54,33,18,12,6,-6,-1,1,1,0,1,0,1,-1,1,-1,147,0,147,-147
Larry Cureton,Todd Medina,Todd Medina,1995-04-07,0,1,,,0,1.222222,10.16,-10.16,47,-47,-15,15,0,0,2,20,-18,18,-1.22222220897675,1.22222220897675,0,0,0,1,0,0,-1,1,0,0,0,0
Dave Beneteau,Todd Medina,Dave Beneteau,1995-04-07,1,0,,,1.2,1.222222,10.16,-10.16,57,-57,-2,2,0,0,11,20,-9,9,-2.22221612930298e-02,2.22221612930298e-02,0,1,0,0,-1,1,0,0,0,0,0,0
Andrei Arlovski,Tom Aspinall,Tom Aspinall,2021-02-20,0,1,15,-15,1.545455,4.333333,-5.080002,5.080002,-16,16,-2.539993,2.539993,0,137,56,16,40,-40,-2.78787899017334,2.78787899017334,2,0,7,0,2,-2,7,-7,105,0,105,-105
Brendan Allen,Tom Breese,Brendan Allen,2020-02-29,1,0,-4,4,4.4,4,-2.539993,2.539993,0,0,5.080002,-5.080002,254,12,27,15,12,-12,0.400000095367432,-0.400000095367432,1,0,0,0,1,-1,0,0,134,0,134,-134
KB Bhullar,Tom Breese,Tom Breese,2020-10-10,0,1,-1,1,4,4,2.539993,-2.539993,0,0,12.7,-12.7,0,5,10,15,-5,5,0,0,0,0,0,1,0,0,-1,1,0,224,-224,224
Omari Akhmedov,Tom Breese,Omari Akhmedov,2021-01-20,1,0,4,-4,3.5,4,-7.619995,7.619995,0,0,0,0,274,60,27,15,12,-12,-0.5,0.5,0,1,2,1,-1,1,1,-1,165,102,63,-63
Kyle Kingsbury,Tom Lawlor,Tom Lawlor,2008-12-13,0,1,1,-1,1.833333,1.666667,10.15999,-10.15999,0,0,12.7,-12.7,139,682,17,16,1,-1,0.166666746139526,-0.166666746139526,0,0,0,0,0,0,0,0,0,0,0,0
CB Dollaway,Tom Lawlor,Tom Lawlor,2009-07-11,0,1,-1,1,1.888889,1.666667,5.080002,-5.080002,-20,20,5.079987,-5.079987,21,0,26,16,10,-10,0.222222208976746,-0.222222208976746,2,1,0,0,1,-1,0,0,196,210,-14,14
Joe Doerksen,Tom Lawlor,Joe Doerksen,2010-05-08,1,0,6,-6,3.1875,1.666667,0,0,-20,20,2.539993,-2.539993,31,24,67,16,51,-51,1.52083337306976,-1.52083337306976,0,2,3,0,-2,2,3,-3,749,301,448,-448
Patrick Cote,Tom Lawlor,Tom Lawlor,2010-10-23,0,1,3,-3,2.090909,1.666667,-2.540009,2.540009,-35,35,2.539993,-2.539993,8,782,34,16,18,-18,0.424242377281189,-0.424242377281189,0,0,1,0,0,0,1,-1,728,168,560,-560
Francis Carmont,Tom Lawlor,Francis Carmont,2012-11-17,1,0,2,-2,2.083333,1.666667,7.619995,-7.619995,0,0,10.15999,-10.15999,92,407,37,16,21,-21,0.416666626930237,-0.416666626930237,2,1,0,0,1,-1,0,0,129,756,-627,627
Michael Kuiper,Tom Lawlor,Tom Lawlor,2013-04-06,0,1,-6,6,3,1.666667,0,0,-20,20,-2.540009,2.540009,130,170,20,16,4,-4,1.33333337306976,-1.33333337306976,0,0,0,0,0,0,0,0,427,140,287,-287
Corey Anderson,Tom Lawlor,Corey Anderson,2016-03-05,1,0,-6,6,2.8,1.666667,7.619995,-7.619995,0,0,12.7,-12.7,165,15,19,16,3,-3,1.13333332538605,-1.13333332538605,2,1,1,0,1,-1,1,-1,119,1064,-945,945
Icho Larenas,Tom Murphy,Tom Murphy,2006-03-04,0,1,-6,6,1.2,8,2.539993,-2.539993,8,-8,0,0,0,491,11,8,3,-3,-6.79999995231628,6.79999995231628,0,0,0,0,0,0,0,0,0,0,0,0
Niklas Backstrom,Tom Niinimaki,Niklas Backstrom,2014-05-31,1,0,-7,7,3.666667,2.75,10.16,-10.16,0,0,13.87001,-13.87001,39,168,14,30,-16,16,0.916666746139526,-0.916666746139526,0,0,0,0,0,0,0,0,0,0,0,0
Renato Moicano,Tom Niinimaki,Renato Moicano,2014-12-20,1,0,-7,7,3.4,2.75,5.080002,-5.080002,10,-10,7.62001,-7.62001,31,0,22,30,-8,8,0.650000095367432,-0.650000095367432,0,0,0,0,0,0,0,0,0,203,-203,203
Brad Tavares,Tom Watson,Brad Tavares,2012-09-29,1,0,-6,6,2.222222,1.888889,0,0,0,0,2.540009,-2.540009,325,67,29,26,3,-3,0.333333492279053,-0.333333492279053,1,0,0,0,1,-1,0,0,137,0,137,-137
Stanislav Nedkov,Tom Watson,Tom Watson,2013-02-16,0,1,1,-1,6,1.888889,-5.080002,5.080002,20,-20,-5.080002,5.080002,160,264,14,26,-12,12,4.11111116409302,-4.11111116409302,0,0,0,0,0,0,0,0,0,140,-140,140
Thales Leites,Tom Watson,Thales Leites,2013-08-03,1,0,0,0,3.111111,1.888889,0,0,0,0,12.7,-12.7,603,74,37,26,11,-11,1.22222232818604,-1.22222232818604,0,1,0,0,-1,1,0,0,1456,168,1288,-1288
Nick Catone,Tom Watson,Nick Catone,2014-02-01,1,0,1,-1,2.5,1.888889,-2.539993,2.539993,0,0,-2.539993,2.539993,251,4,14,26,-12,12,0.611111164093018,-0.611111164093018,0,0,0,0,0,0,0,0,413,182,231,-231
Sam Alvey,Tom Watson,Tom Watson,2014-08-16,0,1,-4,4,1.833333,1.888889,2.540009,-2.540009,0,0,5.080002,-5.080002,26,89,51,26,25,-25,-5.55554628372192e-02,5.55554628372192e-02,0,0,0,0,0,0,0,0,0,196,-196,196
Rafael Natal,Tom Watson,Rafael Natal,2015-01-31,1,0,0,0,2.333333,1.888889,-2.539993,2.539993,0,0,10.16,-10.16,210,0,30,26,4,-4,0.444444417953491,-0.444444417953491,3,1,0,0,2,-2,0,0,514,168,346,-346
Chris Camozzi,Tom Watson,Chris Camozzi,2015-08-08,1,0,-5,5,1.846154,1.888889,2.540009,-2.540009,0,0,5.080002,-5.080002,264,108,37,26,11,-11,-4.27349805831909e-02,4.27349805831909e-02,0,0,0,0,0,0,0,0,112,189,-77,77
Mike Ciesnolevicz,Tomasz Drwal,Tomasz Drwal,2009-06-20,0,1,2,-2,4.75,4.2,-2.539993,2.539993,30,-30,-7.039993,7.039993,0,163,23,26,-3,3,0.550000190734863,-0.550000190734863,1,0,0,0,1,-1,0,0,119,0,119,-119
David Branch,Tomasz Drwal,David Branch,2010-09-15,1,0,0,0,3.666667,4.2,0,0,-20,20,5.080002,-5.080002,459,83,28,26,2,-2,-0.53333306312561,0.53333306312561,0,1,1,0,-1,1,1,-1,74,452,-378,378
Fabricio Camoes,Tommy Hayden,Fabricio Camoes,2012-01-20,1,0,8,-8,1.555556,3.666667,2.540009,-2.540009,10,-10,2.339996,-2.339996,67,80,23,14,9,-9,-2.11111116409302,2.11111116409302,0,0,0,0,0,0,0,0,664,0,664,-664
Dennis Bermudez,Tommy Hayden,Dennis Bermudez,2012-08-11,1,0,-1,1,1.888889,3.666667,-7.619995,7.619995,10,-10,-10.36,10.36,127,28,26,14,12,-12,-1.77777791023254,1.77777791023254,1,0,0,0,1,-1,0,0,98,204,-106,106
Mac Danzig,Tommy Speer,Mac Danzig,2007-12-08,1,0,4,-4,1.75,3,-5.080002,5.080002,-15,15,-2.539993,2.539993,74,28,33,28,5,-5,-1.25,1.25,0,0,0,0,0,0,0,0,0,0,0,0
Anthony Johnson,Tommy Speer,Anthony Johnson,2008-04-02,1,0,1,-1,3.666667,3,10.16,-10.16,35,-35,17.78,-17.78,1,0,28,28,0,0,0.666666746139526,-0.666666746139526,1,0,0,0,1,-1,0,0,295,116,179,-179
Steve Berger,Tony DeSouza,Tony DeSouza,2001-05-04,0,1,1,-1,0.9130435,2.75,-2.540009,2.540009,0,0,15.2,-15.2,67,599,44,15,29,-29,-1.83695650100708,1.83695650100708,0,0,0,0,0,0,0,0,0,0,0,0
Thiago Alves,Tony DeSouza,Thiago Alves,2006-12-30,1,0,-9,9,1.533333,2.75,-7.62001,7.62001,0,0,0,0,104,26,38,15,23,-23,-1.21666669845581,1.21666669845581,0,1,1,0,-1,1,1,-1,185,2066,-1881,1881
Roan Carneiro,Tony DeSouza,Roan Carneiro,2007-12-29,1,0,-4,4,1.909091,2.75,-2.540009,2.540009,0,0,15.23999,-15.23999,287,138,32,15,17,-17,-0.840909123420715,0.840909123420715,0,0,0,1,0,0,-1,1,200,364,-164,164
Yves Edwards,Tony Ferguson,Tony Ferguson,2011-12-03,0,1,8,-8,1.909091,2.888889,-5.080002,5.080002,0,0,-7.619995,7.619995,3,10,64,35,29,-29,-0.979797959327698,0.979797959327698,1,0,2,0,1,-1,2,-2,63,0,63,-63
Danny Castillo,Tony Ferguson,Tony Ferguson,2014-08-30,0,1,5,-5,1.7,2.888889,-5.080002,5.080002,0,0,-12.7,12.7,569,7,27,35,-8,8,-1.18888878822327,1.18888878822327,2,1,1,0,1,-1,1,-1,399,1001,-602,602
Edson Barboza,Tony Ferguson,Tony Ferguson,2015-12-11,0,1,-2,2,2.090909,2.888889,0,0,-10,10,-2.539993,2.539993,117,21,34,35,-1,1,-0.797979831695557,0.797979831695557,1,2,1,0,-1,1,1,-1,139,468,-329,329
Rafael Dos Anjos,Tony Ferguson,Tony Ferguson,2016-11-05,0,1,0,0,2.133333,2.888889,-7.619995,7.619995,15,-15,-15.23999,15.23999,30,0,47,35,12,-12,-0.755555391311646,0.755555391311646,3,3,1,0,0,0,1,-1,602,330,272,-272
Donald Cerrone,Tony Ferguson,Tony Ferguson,2019-06-08,0,1,1,-1,2.117647,2.888889,5.080002,-5.080002,0,0,-7.619995,7.619995,7,0,53,35,18,-18,-0.771241664886475,0.771241664886475,3,4,4,0,-1,1,4,-4,35,945,-910,910
Beneil Dariush,Tony Ferguson,Beneil Dariush,2021-05-15,1,0,-5,5,4.4,2.888889,-2.539993,2.539993,0,0,-10.15999,10.15999,735,5,27,35,-8,8,1.51111125946045,-1.51111125946045,5,5,2,0,0,0,2,-2,98,707,-609,609
Michael Chandler,Tony Ferguson,Michael Chandler,2022-05-07,1,0,-2,2,2.875,2.888889,-7.619995,7.619995,0,0,-12.7,12.7,149,0,31,35,-4,4,-1.38888359069824e-02,1.38888359069824e-02,0,0,1,0,0,0,1,-1,182,357,-175,175
Nate Diaz,Tony Ferguson,Nate Diaz,2022-09-10,1,0,-1,1,1.692308,2.888889,2.540009,-2.540009,15,-15,0,0,0,8,35,35,0,0,-1.1965811252594,1.1965811252594,0,0,2,1,0,0,1,-1,455,126,329,-329
Donnie Chappell,Tony Fryklund,Tony Fryklund,1997-07-27,0,1,,,0,1.555556,-2.540009,2.540009,-7,7,-3,3,0,0,1,23,-22,22,-1.55555558204651,1.55555558204651,0,0,0,0,0,0,0,0,0,0,0,0
Geraldo de Freitas,Tony Gravely,Tony Gravely,2020-11-14,0,1,0,0,2,2.555556,5.079987,-5.079987,0,0,7.62001,-7.62001,2,595,18,32,-14,14,-0.555555582046509,0.555555582046509,0,0,0,0,0,0,0,0,462,0,462,-462
Anthony Birchak,Tony Gravely,Tony Gravely,2021-04-17,0,1,5,-5,2,2.555556,7.619995,-7.619995,0,0,0,0,27,274,24,32,-8,8,-0.555555582046509,0.555555582046509,0,1,0,0,-1,1,0,0,161,154,7,-7
Javid Basharat,Tony Gravely,Javid Basharat,2022-09-17,1,0,-3,3,14,2.555556,10.15999,-10.15999,0,0,0,0,193,103,14,32,-18,18,11.4444444179535,-11.4444444179535,1,2,0,0,-1,1,0,0,189,518,-329,329
Randy Couture,Tony Halme,Randy Couture,1997-05-30,1,0,-1,1,1.727273,0,-5.080002,5.080002,-95,95,-5.5,5.5,0,0,30,4,26,-26,1.72727274894714,-1.72727274894714,0,0,0,0,0,0,0,0,0,0,0,0
Kai Kamaka,Tony Kelley,Kai Kamaka,2020-08-15,1,0,-8,8,2,2.666667,-5.080002,5.080002,10,-10,-2.540009,2.540009,309,0,12,11,1,-1,-0.666666746139526,0.666666746139526,0,0,0,0,0,0,0,0,0,0,0,0
Ali AlQaisi,Tony Kelley,Tony Kelley,2020-10-10,0,1,-3,3,1.6,2.666667,-7.619995,7.619995,0,0,-5.080002,5.080002,360,116,13,11,2,-2,-1.06666672229767,1.06666672229767,0,0,0,0,0,0,0,0,63,56,7,-7
Randy Costa,Tony Kelley,Tony Kelley,2021-12-11,0,1,-7,7,1.5,2.666667,0,0,0,0,7.619995,-7.619995,149,206,10,11,-1,1,-1.16666674613953,1.16666674613953,0,1,1,0,-1,1,1,-1,140,427,-287,287
Steve Montgomery,Tony Sims,Tony Sims,2015-06-27,0,1,-5,5,1.8,3,12.7,-12.7,30,-30,18.2,-18.2,0,33,14,16,-2,2,-1.20000004768372,1.20000004768372,0,0,0,0,0,0,0,0,0,0,0,0
Olivier Aubin-Mercier,Tony Sims,Olivier Aubin-Mercier,2015-08-23,1,0,-3,3,2.2,3,-5.080002,5.080002,0,0,0,0,726,55,16,16,0,0,-0.799999952316284,0.799999952316284,2,1,0,0,1,-1,0,0,120,57,63,-63
Adam Cella,Tor Troeng,Tor Troeng,2013-04-06,0,1,-3,3,0.75,2.285714,0,0,-15,15,-5,5,0,141,14,23,-9,9,-1.53571438789368,1.53571438789368,0,0,0,0,0,0,0,0,0,0,0,0
Rafael Natal,Tor Troeng,Rafael Natal,2013-09-04,1,0,0,0,2.333333,2.285714,-5.080002,5.080002,0,0,4.580002,-4.580002,484,305,30,23,7,-7,4.76188659667969e-02,-4.76188659667969e-02,2,1,0,0,1,-1,0,0,109,151,-42,42
Trevor Smith,Tor Troeng,Trevor Smith,2014-07-19,1,0,2,-2,1.5,2.285714,2.539993,-2.539993,0,0,-0.5,0.5,431,265,25,23,2,-2,-0.785714387893677,0.785714387893677,0,0,0,0,0,0,0,0,0,318,-318,318
Krzysztof Jotko,Tor Troeng,Krzysztof Jotko,2014-10-04,1,0,-6,6,4,2.285714,-2.540009,2.540009,0,0,4.580002,-4.580002,198,251,30,23,7,-7,1.71428561210632,-1.71428561210632,1,0,0,0,1,-1,0,0,302,77,225,-225
Garrett Armfield,Toshiomi Kazama,Garrett Armfield,2023-08-26,1,0,0,0,3,2.5,-2.539993,2.539993,0,0,2.540009,-2.540009,26,0,12,14,-2,2,0.5,-0.5,0,0,0,0,0,0,0,0,413,0,413,-413
Pat Miletich,Townsend Saunders,Pat Miletich,1998-03-13,1,0,,,4.142857,0,12.7,-12.7,0,0,12,-12,0,0,36,2,34,-34,4.14285707473755,-4.14285707473755,0,0,0,0,0,0,0,0,0,0,0,0
Mikey Burnett,Townsend Saunders,Mikey Burnett,1999-01-08,1,0,,,2.5,0,2.539993,-2.539993,0,0,2,-2,0,0,7,2,5,-5,2.5,-2.5,0,0,0,0,0,0,0,0,84,301,-217,217
Vitor Belfort,Tra Telligman,Vitor Belfort,1997-02-07,1,0,-13,13,1.857143,1.4,-5.080002,5.080002,-48,48,-22.03999,22.03999,0,0,40,12,28,-28,0.45714282989502,-0.45714282989502,1,0,0,0,1,-1,0,0,0,0,0,0
Brad Kohler,Tra Telligman,Tra Telligman,1997-12-21,0,1,1,-1,0.8,1.4,-12.70001,12.70001,-13,13,-14,14,0,0,27,12,15,-15,-0.599999964237213,0.599999964237213,0,0,0,1,0,0,-1,1,0,317,-317,317
Pedro Rizzo,Tra Telligman,Pedro Rizzo,1999-05-07,1,0,-9,9,1.818182,1.4,-2.540009,2.540009,8,-8,-22,22,0,0,31,12,19,-19,0.418181896209717,-0.418181896209717,0,1,0,1,-1,1,-1,1,0,502,-502,502
Pedro Rizzo,Tra Telligman,Pedro Rizzo,2003-06-06,1,0,-9,9,1.818182,1.4,-2.540009,2.540009,8,-8,-22,22,205,23,31,12,19,-19,0.418181896209717,-0.418181896209717,2,0,0,2,2,-2,-2,2,987,1491,-504,504
Tim Sylvia,Tra Telligman,Tim Sylvia,2005-08-20,1,0,-11,11,3.1,1.4,15.23999,-15.23999,32,-32,-6.800003,6.800003,1,0,41,12,29,-29,1.69999992847443,-1.69999992847443,0,0,0,3,0,0,-3,3,0,806,-806,806
Rob Broughton,Travis Browne,Travis Browne,2011-09-24,0,1,-1,1,2.285714,2.571429,-10.15999,10.15999,10,-10,-12.7,12.7,24,408,23,25,-2,2,-0.285714149475098,0.285714149475098,1,0,0,0,1,-1,0,0,343,0,343,-343
Josh Barnett,Travis Browne,Travis Browne,2013-12-28,0,1,5,-5,4.375,2.571429,-7.619995,7.619995,-5,5,-2.540009,2.540009,10,0,43,25,18,-18,1.80357146263123,-1.80357146263123,4,1,1,0,3,-3,1,-1,119,826,-707,707
Andrei Arlovski,Travis Browne,Andrei Arlovski,2015-05-23,1,0,4,-4,1.545455,2.571429,-7.619995,7.619995,-15,15,-5.080002,5.080002,5,6,56,25,31,-31,-1.02597403526306,1.02597403526306,5,2,3,0,3,-3,3,-3,252,511,-259,259
David Dodd,Travis Fulton,Travis Fulton,1999-07-16,0,1,3,-3,0.5714286,4.773585,5.080002,-5.080002,-40,40,5,-5,97,461,11,306,-295,295,-4.20215624570847,4.20215624570847,0,0,0,0,0,0,0,0,0,0,0,0
Marvin Eastman,Travis Lutter,Travis Lutter,2004-10-22,0,1,2,-2,1.2,1.666667,-5.080002,5.080002,0,0,-5.080002,5.080002,0,2,33,16,17,-17,-0.466666579246521,0.466666579246521,0,0,0,0,0,0,0,0,0,0,0,0
Matt Lindland,Travis Lutter,Matt Lindland,2005-04-16,1,0,3,-3,2.444444,1.666667,2.540009,-2.540009,0,0,-2.539993,2.539993,328,113,31,16,15,-15,0.777777791023254,-0.777777791023254,0,1,2,0,-1,1,2,-2,238,176,62,-62
Patrick Cote,Travis Lutter,Travis Lutter,2006-11-11,0,1,-7,7,2.090909,1.666667,0,0,-15,15,0,0,0,117,34,16,18,-18,0.424242377281189,-0.424242377281189,0,0,0,0,0,0,0,0,462,574,-112,112
Rich Franklin,Travis Lutter,Rich Franklin,2008-04-19,1,0,-1,1,4.142857,1.666667,5.080002,-5.080002,0,0,2.539993,-2.539993,126,202,36,16,20,-20,2.47619044780731,-2.47619044780731,0,1,2,0,-1,1,2,-2,182,525,-343,343
Vladimir Matyushenko,Travis Wiuff,Vladimir Matyushenko,2002-11-22,1,0,7,-7,3.375,3.571429,-7.619995,7.619995,0,0,-5.039993,5.039993,196,3,35,96,-61,61,-0.196428537368774,0.196428537368774,0,0,0,0,0,0,0,0,420,0,420,-420
Renato Sobral,Travis Wiuff,Renato Sobral,2005-04-16,1,0,2,-2,3.363636,3.571429,-5.080002,5.080002,0,0,-2.5,2.5,199,71,48,96,-48,48,-0.207792282104492,0.207792282104492,0,0,0,1,0,0,-1,1,0,876,-876,876
Mark Hall,Trent Jenkins,Mark Hall,1995-12-16,1,0,,,0.8333333,0,-5.080002,5.080002,5,-5,2,-2,0,0,11,4,7,-7,0.833333313465118,-0.833333313465118,1,0,0,0,1,-1,0,0,99,0,99,-99
Bryan Battle,Tresean Gore,Bryan Battle,2022-02-05,1,0,0,0,5.5,2.5,2.539993,-2.539993,-15,15,5.080002,-5.080002,200,76,13,7,6,-6,3,-3,1,0,0,0,1,-1,0,0,161,0,161,-161
Cody Brundage,Tresean Gore,Cody Brundage,2022-07-09,1,0,0,0,1.8,2.5,0,0,0,0,-7.619995,7.619995,78,0,14,7,7,-7,-0.700000047683716,0.700000047683716,1,0,0,0,1,-1,0,0,119,154,-35,35
Josh Fremd,Tresean Gore,Tresean Gore,2022-10-29,0,1,0,0,2.2,2.5,10.15999,-10.15999,0,0,2.539993,-2.539993,39,166,16,7,9,-9,-0.299999952316284,0.299999952316284,0,0,0,1,0,0,-1,1,203,112,91,-91
James Bochnovic,Trevin Giles,Trevin Giles,2017-07-08,0,1,4,-4,2.666667,3.2,10.15999,-10.15999,35,-35,17.78,-17.78,8,343,11,21,-10,10,-0.533333301544189,0.533333301544189,0,0,0,0,0,0,0,0,0,0,0,0
Antonio Braga Neto,Trevin Giles,Trevin Giles,2017-12-09,0,1,5,-5,3,3.2,7.619995,-7.619995,15,-15,7.619995,-7.619995,194,24,12,21,-9,9,-0.200000047683716,0.200000047683716,0,1,0,0,-1,1,0,0,1260,154,1106,-1106
Zak Cummings,Trevin Giles,Zak Cummings,2019-05-18,1,0,8,-8,3.571429,3.2,0,0,35,-35,2.539993,-2.539993,26,23,32,21,11,-11,0.371428489685059,-0.371428489685059,1,2,0,0,-1,1,0,0,154,525,-371,371
Roman Dolidze,Trevin Giles,Trevin Giles,2021-03-20,0,1,4,-4,6,3.2,5.080002,-5.080002,15,-15,5.079987,-5.079987,255,75,14,21,-7,7,2.79999995231628,-2.79999995231628,1,0,0,0,1,-1,0,0,245,672,-427,427
Dricus Du Plessis,Trevin Giles,Dricus Du Plessis,2021-07-10,1,0,-1,1,10,3.2,2.539993,-2.539993,15,-15,5.079987,-5.079987,94,12,22,21,1,-1,6.79999995231628,-6.79999995231628,1,1,0,0,0,0,0,0,273,112,161,-161
Louis Cosce,Trevin Giles,Trevin Giles,2022-09-17,0,1,-3,3,3.5,3.2,-7.62001,7.62001,0,0,-7.62001,7.62001,216,129,9,21,-12,12,0.299999952316284,-0.299999952316284,0,0,1,1,0,0,0,0,665,434,231,-231
Gabriel Bonfim,Trevin Giles,Gabriel Bonfim,2023-07-29,1,0,-5,5,15,3.2,2.539993,-2.539993,0,0,-5.080002,5.080002,26,14,15,21,-6,6,11.7999999523163,-11.7999999523163,1,1,0,1,0,0,-1,1,189,315,-126,126
Mario Bautista,Trevin Jones,Trevin Jones,2021-03-06,0,1,-3,3,6.5,1.3,5.080002,-5.080002,0,0,-2.540009,2.540009,9,86,15,23,-8,8,5.20000004768372,-5.20000004768372,2,0,0,0,2,-2,0,0,392,0,392,-392
Javid Basharat,Trevin Jones,Javid Basharat,2022-03-12,1,0,-5,5,14,1.3,5.080002,-5.080002,0,0,-2.540009,2.540009,0,3,14,23,-9,9,12.7000000476837,-12.7000000476837,0,1,0,0,-1,1,0,0,0,371,-371,371
Raoni Barcelos,Trevin Jones,Raoni Barcelos,2022-10-01,1,0,3,-3,3.4,1.3,0,0,0,0,-7.62001,7.62001,427,0,22,23,-1,1,2.10000014305115,-2.10000014305115,0,0,0,0,0,0,0,0,252,203,49,-49
Cody Garbrandt,Trevin Jones,Cody Garbrandt,2023-03-04,1,0,-1,1,2.6,1.3,2.540009,-2.540009,0,0,-12.7,12.7,152,99,18,23,-5,5,1.29999995231628,-1.29999995231628,0,0,2,0,0,0,2,-2,448,154,294,-294
Erick Gonzalez,Trevor Peek,Trevor Peek,2023-02-25,0,1,3,-3,1.75,8,5.080002,-5.080002,0,0,12.7,-12.7,135,16,22,9,13,-13,-6.25,6.25,0,0,1,0,0,0,1,-1,203,0,203,-203
Chepe Mariscal,Trevor Peek,Chepe Mariscal,2023-06-24,1,0,2,-2,2.5,8,-5.080002,5.080002,-10,10,-2.540009,2.540009,329,83,21,9,12,-12,-5.5,5.5,0,1,0,0,-1,1,0,0,0,119,-119,119
Travis Lutter,Trevor Prangley,Trevor Prangley,2005-08-20,0,1,0,0,1.666667,3.090909,-5.080002,5.080002,0,0,0,0,101,651,16,45,-29,29,-1.42424237728119,1.42424237728119,0,0,0,0,0,0,0,0,0,0,0,0
Jeremy Horn,Trevor Prangley,Jeremy Horn,2005-11-19,1,0,-3,3,4.136364,3.090909,0,0,0,0,-2.539993,2.539993,109,554,113,45,68,-68,1.04545450210571,-1.04545450210571,0,1,1,0,-1,1,1,-1,91,91,0,0
Ed Herman,Trevor Smith,Ed Herman,2013-07-27,1,0,0,0,1.6875,1.5,-5.080002,5.080002,20,-20,5.080002,-5.080002,198,200,43,25,18,-18,0.1875,-0.1875,2,0,1,0,2,-2,1,-1,539,0,539,-539
Brian Houston,Trevor Smith,Trevor Smith,2014-01-15,0,1,-1,1,0.6666667,1.5,-2.539993,2.539993,0,0,2.5,-2.5,89,92,10,25,-15,15,-0.833333313465118,0.833333313465118,0,0,0,0,0,0,0,0,0,172,-172,172
Thales Leites,Trevor Smith,Thales Leites,2014-04-11,1,0,-1,1,3.111111,1.5,-5.080002,5.080002,0,0,7.619995,-7.619995,4,0,37,25,12,-12,1.61111116409302,-1.61111116409302,1,1,0,0,0,0,0,0,251,86,165,-165
Caio Magalhaes,Trevor Smith,Caio Magalhaes,2014-11-08,1,0,-7,7,3.333333,1.5,-5.080002,5.080002,0,0,-5.080002,5.080002,3,0,13,25,-12,12,1.83333325386047,-1.83333325386047,3,0,0,1,3,-3,-1,1,203,211,-8,8
Dan Miller,Trevor Smith,Trevor Smith,2015-07-12,0,1,0,0,1.75,1.5,-5.080002,5.080002,0,0,-2.539993,2.539993,5,716,22,25,-3,3,0.25,-0.25,0,0,0,2,0,0,-2,2,1415,246,1169,-1169
Joseph Gigliotti,Trevor Smith,Trevor Smith,2016-08-06,0,1,-13,13,3.5,1.5,-10.16,10.16,0,0,-7.5,7.5,58,766,9,25,-16,16,2,-2,0,1,0,2,-1,1,-2,2,0,391,-391,391
Andrew Sanchez,Trevor Smith,Andrew Sanchez,2016-12-09,1,0,-7,7,1.857143,1.5,-5.080002,5.080002,0,0,-2.539993,2.539993,27,43,20,25,-5,5,0.357142806053162,-0.357142806053162,0,2,0,2,-2,2,-2,2,0,125,-125,125
Chris Camozzi,Trevor Smith,Trevor Smith,2017-05-28,0,1,-6,6,1.846154,1.5,-2.539993,2.539993,0,0,0,0,0,804,37,25,12,-12,0.346153855323792,-0.346153855323792,0,0,0,2,0,0,-2,2,183,170,13,-13
Zak Cummings,Trevor Smith,Zak Cummings,2018-12-15,1,0,-3,3,3.571429,1.5,-7.619995,7.619995,20,-20,0,0,125,126,32,25,7,-7,2.07142853736877,-2.07142853736877,0,1,0,2,-1,1,-2,2,210,566,-356,356
Makhmud Muradov,Trevor Smith,Makhmud Muradov,2019-12-07,1,0,-9,9,3.25,1.5,-2.539993,2.539993,0,0,0,0,7,6,34,25,9,-9,1.75,-1.75,0,0,0,2,0,0,-2,2,0,357,-357,357
Jordan Leavitt,Trey Ogden,Jordan Leavitt,2022-04-16,1,0,-6,6,5.5,2.666667,-5.080002,5.080002,0,0,-2.540009,2.540009,317,122,13,22,-9,9,2.83333325386047,-2.83333325386047,1,0,0,0,1,-1,0,0,119,0,119,-119
Ignacio Bahamondes,Trey Ogden,Ignacio Bahamondes,2023-04-08,1,0,-8,8,2.8,2.666667,10.16,-10.16,0,0,7.619995,-7.619995,0,0,19,22,-3,3,0.133333206176758,-0.133333206176758,1,0,0,0,1,-1,0,0,595,357,238,-238
Josh Quinlan,Trey Waters,Trey Waters,2023-04-29,0,1,2,-2,6,8,-12.7,12.7,0,0,-12.7,12.7,54,27,7,9,-2,2,-2,2,1,0,0,0,1,-1,0,0,259,0,259,-259
Richie Hightower,Troy Mandaloniz,Troy Mandaloniz,2007-12-08,0,1,6,-6,2,1.5,-2.539993,2.539993,0,0,-3,3,19,98,12,5,7,-7,0.5,-0.5,0,0,0,0,0,0,0,0,0,0,0,0
Paul Kelly,Troy Mandaloniz,Paul Kelly,2009-02-21,1,0,-5,5,2.8,1.5,0,0,-15,15,-0.1999969,0.1999969,383,165,19,5,14,-14,1.29999995231628,-1.29999995231628,1,1,0,0,0,0,0,0,399,441,-42,42
Kevin Aguilar,Tucker Lutz,Tucker Lutz,2021-05-15,0,1,6,-6,3.4,3,-2.540009,2.540009,10,-10,2.539993,-2.539993,52,185,22,16,6,-6,0.400000095367432,-0.400000095367432,0,0,1,0,0,0,1,-1,336,0,336,-336
Melsik Baghdasaryan,Tucker Lutz,Melsik Baghdasaryan,2023-07-15,1,0,2,-2,4,3,2.539993,-2.539993,0,0,-5.080002,5.080002,42,379,10,16,-6,6,1,-1,0,1,0,0,-1,1,0,0,154,791,-637,637
Ian Loveland,Tyler Toner,Ian Loveland,2010-12-04,1,0,0,0,1.8,2.142857,0,0,0,0,0.1999969,-0.1999969,382,0,28,22,6,-6,-0.342857122421265,0.342857122421265,0,0,0,0,0,0,0,0,0,0,0,0
Jay Hieron,Tyron Woodley,Tyron Woodley,2013-02-02,0,1,6,-6,3.285714,2.714286,7.62001,-7.62001,0,0,2.539993,-2.539993,0,9,30,26,4,-4,0.571428775787354,-0.571428775787354,0,0,1,0,0,0,1,-1,3150,0,3150,-3150
Jake Shields,Tyron Woodley,Jake Shields,2013-06-15,1,0,3,-3,3.444444,2.714286,7.62001,-7.62001,0,0,-5.080002,5.080002,246,125,40,26,14,-14,0.730158805847168,-0.730158805847168,0,1,0,0,-1,1,0,0,777,133,644,-644
Josh Koscheck,Tyron Woodley,Tyron Woodley,2013-11-16,0,1,4,-4,1.545455,2.714286,2.540009,-2.540009,0,0,-2.540009,2.540009,60,90,28,26,2,-2,-1.16883111000061,1.16883111000061,0,0,2,0,0,0,2,-2,266,154,112,-112
Carlos Condit,Tyron Woodley,Tyron Woodley,2014-03-15,0,1,-2,2,2.285714,2.714286,12.70001,-12.70001,0,0,2.539993,-2.539993,3,183,46,26,20,-20,-0.428571224212646,0.428571224212646,1,1,0,0,0,0,0,0,199,119,80,-80
Rory MacDonald,Tyron Woodley,Rory MacDonald,2014-06-14,1,0,-8,8,4.75,2.714286,7.62001,-7.62001,0,0,5.079987,-5.079987,186,85,23,26,-3,3,2.03571438789368,-2.03571438789368,4,2,0,0,2,-2,0,0,112,91,21,-21
Dong Hyun Kim,Tyron Woodley,Tyron Woodley,2014-08-23,0,1,0,0,5.5,2.714286,12.70001,-12.70001,0,0,5.079987,-5.079987,0,50,26,26,0,0,2.78571438789368,-2.78571438789368,2,0,1,0,2,-2,1,-1,318,70,248,-248
Kelvin Gastelum,Tyron Woodley,Tyron Woodley,2015-01-31,0,1,-9,9,2.25,2.714286,0,0,0,0,-7.62001,7.62001,42,26,26,26,0,0,-0.464285612106323,0.464285612106323,4,1,0,0,3,-3,0,0,217,161,56,-56
Robbie Lawler,Tyron Woodley,Tyron Woodley,2016-07-30,0,1,0,0,1.875,2.714286,5.080002,-5.080002,0,0,0,0,0,19,46,26,20,-20,-0.839285612106323,0.839285612106323,3,2,0,0,1,-1,0,0,385,546,-161,161
Stephen Thompson,Tyron Woodley,Tyron Woodley,2017-03-04,0,1,0,0,2.833333,2.714286,7.62001,-7.62001,0,0,2.539993,-2.539993,19,117,23,26,-3,3,0.11904764175415,-0.11904764175415,1,3,0,0,-2,2,0,0,1106,217,889,-889
Demian Maia,Tyron Woodley,Tyron Woodley,2017-07-29,0,1,4,-4,2.545455,2.714286,10.16,-10.16,0,0,-5.080002,5.080002,52,6,39,26,13,-13,-0.16883111000061,0.16883111000061,3,4,1,0,-1,1,1,-1,77,147,-70,70
Darren Till,Tyron Woodley,Tyron Woodley,2018-09-08,0,1,-11,11,3.6,2.714286,7.62001,-7.62001,15,-15,0,0,12,330,23,26,-3,3,0.885714292526245,-0.885714292526245,1,5,0,0,-4,4,0,0,371,406,-35,35
Kamaru Usman,Tyron Woodley,Kamaru Usman,2019-03-02,1,0,-5,5,6.666667,2.714286,7.62001,-7.62001,0,0,5.079987,-5.079987,1093,0,23,26,-3,3,3.95238089561462,-3.95238089561462,1,6,0,0,-5,5,0,0,952,175,777,-777
Gilbert Burns,Tyron Woodley,Gilbert Burns,2020-05-30,1,0,-5,5,3.666667,2.714286,2.540009,-2.540009,0,0,-7.62001,7.62001,478,167,28,26,2,-2,0.952381134033203,-0.952381134033203,4,0,1,0,4,-4,1,-1,77,455,-378,378
Colby Covington,Tyron Woodley,Colby Covington,2020-09-19,1,0,-6,6,5.666667,2.714286,5.080002,-5.080002,0,0,-5.080002,5.080002,721,14,20,26,-6,6,2.95238089561462,-2.95238089561462,0,0,1,0,0,0,1,-1,280,112,168,-168
Vicente Luque,Tyron Woodley,Vicente Luque,2021-03-27,1,0,-9,9,2.444444,2.714286,5.080002,-5.080002,0,0,2.539993,-2.539993,123,22,31,26,5,-5,-0.269841194152832,0.269841194152832,1,0,0,1,1,-1,-1,1,322,189,133,-133
David Dodd,Tyrone Roberts,Tyrone Roberts,2000-06-09,0,1,,,0.5714286,3.583333,12.70001,-12.70001,15,-15,13,-13,2,287,11,55,-44,44,-3.01190465688705,3.01190465688705,0,0,0,0,0,0,0,0,329,0,329,-329
Frankie Edgar,Tyson Griffin,Frankie Edgar,2007-02-03,1,0,3,-3,2.090909,2,0,0,-10,10,0,0,302,99,34,24,10,-10,9.09090042114258e-02,-9.09090042114258e-02,0,0,0,0,0,0,0,0,0,0,0,0
Marcus Aurelio,Tyson Griffin,Tyson Griffin,2008-07-05,0,1,10,-10,2.2,2,10.16,-10.16,10,-10,15.24001,-15.24001,29,379,32,24,8,-8,0.200000047683716,-0.200000047683716,2,0,0,0,2,-2,0,0,94,518,-424,424
Rafael Dos Anjos,Tyson Griffin,Tyson Griffin,2009-04-01,0,1,0,0,2.133333,2,5.080002,-5.080002,25,-25,5.080002,-5.080002,5,171,47,24,23,-23,0.133333444595337,-0.133333444595337,0,1,1,0,-1,1,1,-1,137,270,-133,133
Hermes Franca,Tyson Griffin,Tyson Griffin,2009-09-19,0,1,10,-10,1.411765,2,0,0,10,-10,7.619995,-7.619995,0,17,41,24,17,-17,-0.588235259056091,0.588235259056091,0,2,0,0,-2,2,0,0,805,171,634,-634
Evan Dunham,Tyson Griffin,Evan Dunham,2010-06-12,1,0,2,-2,2,2,10.16,-10.16,10,-10,5.080002,-5.080002,535,18,27,24,3,-3,0,0,2,3,0,0,-1,1,0,0,152,266,-114,114
Takanori Gomi,Tyson Griffin,Takanori Gomi,2010-08-01,1,0,5,-5,2.5,2,2.539993,-2.539993,10,-10,5.080002,-5.080002,4,0,49,24,25,-25,0.5,-0.5,0,0,0,0,0,0,0,0,0,50,-50,50
Manvel Gamburyan,Tyson Griffin,Tyson Griffin,2011-06-26,0,1,3,-3,1.5,2,-2.539993,2.539993,-10,10,-2.540009,2.540009,158,228,25,24,1,-1,-0.5,0.5,0,0,0,1,0,0,-1,1,876,329,547,-547
Kai Kara-France,Tyson Nam,Kai Kara-France,2020-02-22,1,0,-10,10,2.181818,1.5,-7.619995,7.619995,0,0,2.539993,-2.539993,17,53,35,35,0,0,0.681818246841431,-0.681818246841431,0,0,0,0,0,0,0,0,70,0,70,-70
Zarrukh Adashev,Tyson Nam,Tyson Nam,2020-06-13,0,1,-9,9,1,1.5,-5.079987,5.079987,0,0,-7.619995,7.619995,0,2,8,35,-27,27,-0.5,0.5,0,0,0,0,0,0,0,0,0,112,-112,112
Azat Maksum,Tyson Nam,Azat Maksum,2023-07-15,1,0,-11,11,17,1.5,0,0,0,0,5.080002,-5.080002,22,30,17,35,-18,18,15.5,-15.5,0,1,0,0,-1,1,0,0,0,1127,-1127,1127
Paul Craig,Tyson Pedro,Tyson Pedro,2017-03-04,0,1,4,-4,2.833333,2.5,0,0,-20,20,-7.62001,7.62001,6,157,23,14,9,-9,0.333333253860474,-0.333333253860474,1,0,0,0,1,-1,0,0,77,0,77,-77
Ilir Latifi,Tyson Pedro,Ilir Latifi,2017-09-09,1,0,10,-10,1.888889,2.5,-12.7,12.7,25,-25,-15.24001,15.24001,442,4,26,14,12,-12,-0.611111164093018,0.611111164093018,3,1,0,0,2,-2,0,0,553,189,364,-364
Harry Hunsucker,Tyson Pedro,Tyson Pedro,2022-08-20,0,1,3,-3,1.166667,2.5,-2.539993,2.539993,0,0,-10.16,10.16,0,4,13,14,-1,1,-1.33333337306976,1.33333337306976,0,0,2,0,0,0,2,-2,245,1806,-1561,1561
Modestas Bukauskas,Tyson Pedro,Modestas Bukauskas,2023-02-11,1,0,-2,2,3,2.5,0,0,0,0,-2.540009,2.540009,57,181,20,14,6,-6,0.5,-0.5,0,1,2,0,-1,1,2,-2,525,175,350,-350
Sergey Morozov,Umar Nurmagomedov,Umar Nurmagomedov,2021-01-20,0,1,6,-6,3.8,16,-5.080002,5.080002,0,0,-5.080002,5.080002,8,177,24,16,8,-8,-12.2000000476837,12.2000000476837,0,0,0,0,0,0,0,0,0,0,0,0
Brian Kelleher,Umar Nurmagomedov,Umar Nurmagomedov,2022-03-05,0,1,9,-9,1.714286,16,-5.080002,5.080002,0,0,-7.619995,7.619995,6,87,38,16,22,-22,-14.2857142686844,14.2857142686844,1,1,1,0,0,0,1,-1,196,409,-213,213
Nate Maness,Umar Nurmagomedov,Umar Nurmagomedov,2022-06-25,0,1,4,-4,4.666667,16,5.080002,-5.080002,-10,10,7.62001,-7.62001,0,649,17,16,1,-1,-11.3333334922791,11.3333334922791,2,2,0,0,0,0,0,0,574,112,462,-462
Raoni Barcelos,Umar Nurmagomedov,Umar Nurmagomedov,2023-01-14,0,1,8,-8,3.4,16,-2.540009,2.540009,0,0,-5.080002,5.080002,0,2,22,16,6,-6,-12.5999999046326,12.5999999046326,1,3,0,0,-2,2,0,0,105,203,-98,98
Kelvin Gastelum,Uriah Hall,Kelvin Gastelum,2013-04-13,1,0,-7,7,2.25,1.636364,-7.62001,7.62001,-15,15,-20.32001,20.32001,389,114,26,29,-3,3,0.613636374473572,-0.613636374473572,0,0,0,0,0,0,0,0,0,0,0,0
Oluwale Bamgbose,Uriah Hall,Uriah Hall,2015-08-08,0,1,-3,3,1.5,1.636364,-2.540009,2.540009,0,0,-2.540009,2.540009,0,96,10,29,-19,19,-0.136363625526428,0.136363625526428,0,0,0,0,0,0,0,0,0,847,-847,847
Derek Brunson,Uriah Hall,Derek Brunson,2016-09-17,1,0,0,0,2.555556,1.636364,2.539993,-2.539993,0,0,-5.080002,5.080002,62,0,32,29,3,-3,0.919191956520081,-0.919191956520081,3,1,1,0,2,-2,1,-1,209,406,-197,197
Paulo Costa,Uriah Hall,Paulo Costa,2018-07-07,1,0,-6,6,7,1.636364,2.539993,-2.539993,0,0,-17.78,17.78,8,3,16,29,-13,13,5.36363637447357,-5.36363637447357,2,0,0,1,2,-2,-1,1,245,658,-413,413
Antonio Carlos Junior,Uriah Hall,Uriah Hall,2019-09-14,0,1,-6,6,2.2,1.636364,5.080002,-5.080002,0,0,0,0,642,25,16,29,-13,13,0.563636422157288,-0.563636422157288,0,0,1,2,0,0,-1,1,119,434,-315,315
Dominick Cruz,Urijah Faber,Dominick Cruz,2011-07-02,1,0,-6,6,6,3.181818,5.080002,-5.080002,0,0,2.540009,-2.540009,137,45,28,46,-18,18,2.81818175315857,-2.81818175315857,0,0,0,0,0,0,0,0,0,0,0,0
Brian Bowles,Urijah Faber,Urijah Faber,2011-11-19,0,1,-1,1,3.333333,3.181818,2.539993,-2.539993,0,0,7.62001,-7.62001,0,139,13,46,-33,33,0.151515007019043,-0.151515007019043,2,0,0,0,2,-2,0,0,140,140,0,0
Renan Barao,Urijah Faber,Renan Barao,2012-07-21,1,0,-8,8,3.777778,3.181818,0,0,10,-10,7.62001,-7.62001,0,8,43,46,-3,3,0.595959424972534,-0.595959424972534,3,1,0,0,2,-2,0,0,168,245,-77,77
Iuri Alcantara,Urijah Faber,Urijah Faber,2013-08-17,0,1,-1,1,3.5,3.181818,7.619995,-7.619995,0,0,10.16,-10.16,152,608,45,46,-1,1,0.318181753158569,-0.318181753158569,1,0,0,0,1,-1,0,0,91,392,-301,301
Renan Barao,Urijah Faber,Renan Barao,2014-02-01,1,0,-7,7,3.777778,3.181818,0,0,10,-10,7.62001,-7.62001,14,0,43,46,-3,3,0.595959424972534,-0.595959424972534,6,1,0,0,5,-5,0,0,133,168,-35,35
Alex Caceres,Urijah Faber,Urijah Faber,2014-07-05,0,1,-9,9,1.5,3.181818,10.16,-10.16,10,-10,15.24001,-15.24001,31,406,35,46,-11,11,-1.68181824684143,1.68181824684143,4,0,0,1,4,-4,-1,1,161,154,7,-7
Frankie Edgar,Urijah Faber,Frankie Edgar,2015-05-16,1,0,-3,3,2.090909,3.181818,0,0,0,0,2.540009,-2.540009,223,0,34,46,-12,12,-1.09090924263,1.09090924263,3,1,0,1,2,-2,-1,1,175,315,-140,140
Dominick Cruz,Urijah Faber,Dominick Cruz,2016-06-04,1,0,-6,6,6,3.181818,5.080002,-5.080002,0,0,2.540009,-2.540009,206,11,28,46,-18,18,2.81818175315857,-2.81818175315857,4,0,0,1,4,-4,-1,1,139,385,-246,246
Aalon Cruz,Uros Medic,Uros Medic,2021-03-06,0,1,4,-4,2,9,-2.539993,2.539993,-25,25,17.78,-17.78,11,56,12,10,2,-2,-7,7,0,0,0,0,0,0,0,0,0,0,0,0
Donald Cerrone,Vagner Rocha,Donald Cerrone,2011-06-11,1,0,-1,1,2.117647,3.5,7.619995,-7.619995,0,0,0,0,40,56,53,18,35,-35,-1.38235282897949,1.38235282897949,1,0,0,0,1,-1,0,0,126,0,126,-126
Cody McKenzie,Vagner Rocha,Vagner Rocha,2011-09-17,0,1,-6,6,1.6,3.5,5.080002,-5.080002,0,0,-2.539993,2.539993,32,341,26,18,8,-8,-1.89999997615814,1.89999997615814,1,0,0,0,1,-1,0,0,287,98,189,-189
Jonathan Brookins,Vagner Rocha,Jonathan Brookins,2012-02-15,1,0,-3,3,1.6,3.5,5.080002,-5.080002,-10,10,2.540009,-2.540009,7,0,26,18,8,-8,-1.89999997615814,1.89999997615814,0,1,0,0,-1,1,0,0,151,151,0,0
Jake Matthews,Vagner Rocha,Jake Matthews,2014-11-07,1,0,-12,12,3.166667,3.5,2.539993,-2.539993,15,-15,0,0,56,28,25,18,7,-7,-0.333333253860474,0.333333253860474,0,0,0,1,0,0,-1,1,0,996,-996,996
Bo Nickal,Val Woodburn,Bo Nickal,2023-07-08,1,0,-2,2,5,7,12.7,-12.7,0,0,5.079987,-5.079987,2,0,5,8,-3,3,-2,2,1,0,0,0,1,-1,0,0,126,0,126,-126
Sarah Kaufman,Valentina Shevchenko,Valentina Shevchenko,2015-12-19,0,1,3,-3,4.5,5.75,0,0,10,-10,0,0,291,373,22,27,-5,5,-1.25,1.25,1,0,0,0,1,-1,0,0,612,0,612,-612
Amanda Nunes,Valentina Shevchenko,Amanda Nunes,2016-03-05,1,0,0,0,4.6,5.75,7.619995,-7.619995,10,-10,7.619995,-7.619995,279,79,28,27,1,-1,-1.15000009536743,1.15000009536743,0,1,1,0,-1,1,1,-1,525,77,448,-448
Holly Holm,Valentina Shevchenko,Valentina Shevchenko,2016-07-23,0,1,6,-6,2.142857,5.75,7.619995,-7.619995,10,-10,7.619995,-7.619995,105,163,22,27,-5,5,-3.60714292526245,3.60714292526245,0,0,0,0,0,0,0,0,140,140,0,0
Julianna Pena,Valentina Shevchenko,Valentina Shevchenko,2017-01-28,0,1,-1,1,2.4,5.75,2.539993,-2.539993,10,-10,7.619995,-7.619995,360,163,17,27,-10,10,-3.34999990463257,3.34999990463257,2,1,0,0,1,-1,0,0,203,189,14,-14
Amanda Nunes,Valentina Shevchenko,Amanda Nunes,2017-09-09,1,0,0,0,4.6,5.75,7.619995,-7.619995,10,-10,7.619995,-7.619995,152,0,28,27,1,-1,-1.15000009536743,1.15000009536743,3,2,1,0,1,-1,1,-1,253,224,29,-29
Priscila Cachoeira,Valentina Shevchenko,Valentina Shevchenko,2018-02-03,0,1,0,0,2.4,5.75,5.079987,-5.079987,0,0,-2.539993,2.539993,0,512,17,27,-10,10,-3.34999990463257,3.34999990463257,0,0,0,0,0,0,0,0,0,147,-147,147
Joanna Jedrzejczyk,Valentina Shevchenko,Valentina Shevchenko,2018-12-08,0,1,1,-1,3.2,5.75,2.539993,-2.539993,-10,10,-2.539993,2.539993,17,494,21,27,-6,6,-2.54999995231628,2.54999995231628,1,1,1,0,0,0,1,-1,133,308,-175,175
Jessica Eye,Valentina Shevchenko,Valentina Shevchenko,2019-06-08,0,1,1,-1,1.363636,5.75,2.539993,-2.539993,0,0,0,0,2,256,26,27,-1,1,-4.38636362552643,4.38636362552643,1,2,0,0,-1,1,0,0,510,182,328,-328
Liz Carmouche,Valentina Shevchenko,Valentina Shevchenko,2019-08-10,0,1,4,-4,1.857143,5.75,2.539993,-2.539993,0,0,0,0,0,470,20,27,-7,7,-3.89285719394684,3.89285719394684,2,3,0,0,-1,1,0,0,168,63,105,-105
Katlyn Chookagian,Valentina Shevchenko,Valentina Shevchenko,2020-02-08,0,1,0,0,3.6,5.75,10.15999,-10.15999,0,0,5.080002,-5.080002,0,212,23,27,-4,4,-2.15000009536743,2.15000009536743,2,4,0,0,-2,2,0,0,98,182,-84,84
Jennifer Maia,Valentina Shevchenko,Valentina Shevchenko,2020-11-21,0,1,0,0,2.333333,5.75,-2.540009,2.540009,0,0,-5.080002,5.080002,471,574,30,27,3,-3,-3.41666674613953,3.41666674613953,2,5,0,0,-3,3,0,0,112,287,-175,175
Jessica Andrade,Valentina Shevchenko,Valentina Shevchenko,2021-04-24,0,1,-4,4,2,5.75,-10.16,10.16,-10,10,-10.16,10.16,57,311,36,27,9,-9,-3.75,3.75,1,6,2,0,-5,5,2,-2,189,154,35,-35
Lauren Murphy,Valentina Shevchenko,Valentina Shevchenko,2021-09-25,0,1,5,-5,2.666667,5.75,0,0,0,0,2.539993,-2.539993,41,244,22,27,-5,5,-3.08333325386047,3.08333325386047,3,7,0,0,-4,4,0,0,105,154,-49,49
Taila Santos,Valentina Shevchenko,Valentina Shevchenko,2022-06-11,0,1,-6,6,6.333333,5.75,2.539993,-2.539993,0,0,5.080002,-5.080002,529,255,22,27,-5,5,0.583333492279053,-0.583333492279053,1,8,0,0,-7,7,0,0,203,259,-56,56
Alexa Grasso,Valentina Shevchenko,Alexa Grasso,2023-03-04,1,0,-5,5,5.333333,5.75,0,0,0,0,0,0,82,324,19,27,-8,8,-0.416666507720947,0.416666507720947,3,9,0,0,-6,6,0,0,343,266,77,-77
Matt Hughes,Valeri Ignatov,Matt Hughes,1999-09-24,1,0,,,5,0.5,0,0,0,0,11.42,-11.42,0,0,54,3,51,-51,4.5,-4.5,0,0,0,0,0,0,0,0,0,0,0,0
Joanna Jedrzejczyk,Valerie Letourneau,Joanna Jedrzejczyk,2015-11-14,1,0,-4,4,3.2,1.333333,-2.539993,2.539993,0,0,-7.619995,7.619995,186,36,21,14,7,-7,1.86666667461395,-1.86666667461395,2,0,0,0,2,-2,0,0,147,0,147,-147
James Krause,Valmir Lazaro,Valmir Lazaro,2015-02-28,0,1,-1,1,3.111111,3,5.080002,-5.080002,15,-15,0,0,102,24,37,20,17,-17,0.111111164093018,-0.111111164093018,0,0,0,0,0,0,0,0,154,0,154,-154
JJ Aldrich,Vanessa Demopoulos,JJ Aldrich,2021-08-28,1,0,-4,4,2,1.8,7.62001,-7.62001,10,-10,20.31999,-20.31999,259,113,18,14,4,-4,0.200000047683716,-0.200000047683716,1,0,1,0,1,-1,1,-1,168,0,168,-168
Irene Aldana,Vanessa Melo,Irene Aldana,2019-09-21,1,0,0,0,2,1.375,10.15999,-10.15999,0,0,7.619995,-7.619995,0,13,21,19,2,-2,0.625,-0.625,0,0,0,0,0,0,0,0,63,0,63,-63
Tracy Cortez,Vanessa Melo,Tracy Cortez,2019-11-16,1,0,-6,6,11,1.375,0,0,-10,10,0,0,527,2,12,19,-7,7,9.625,-9.625,0,0,0,0,0,0,0,0,0,56,-56,56
Chris Cariaso,Vaughan Lee,Chris Cariaso,2011-11-05,1,0,1,-1,2.125,1.076923,-7.619995,7.619995,0,0,-5.080002,5.080002,381,337,25,27,-2,2,1.04807686805725,-1.04807686805725,0,0,0,0,0,0,0,0,161,0,161,-161
TJ Dillashaw,Vaughan Lee,TJ Dillashaw,2012-07-11,1,0,-3,3,3.6,1.076923,0,0,10,-10,2.539993,-2.539993,61,0,23,27,-4,4,2.52307677268982,-2.52307677268982,1,0,1,0,1,-1,1,-1,147,249,-102,102
Raphael Assuncao,Vaughan Lee,Raphael Assuncao,2013-06-08,1,0,0,0,2.8,1.076923,-2.539993,2.539993,10,-10,0,0,174,2,38,27,11,-11,1.72307682037354,-1.72307682037354,3,0,1,0,3,-3,1,-1,182,332,-150,150
Iuri Alcantara,Vaughan Lee,Iuri Alcantara,2014-05-31,1,0,2,-2,3.5,1.076923,7.619995,-7.619995,10,-10,12.7,-12.7,3,0,45,27,18,-18,2.42307686805725,-2.42307686805725,1,0,0,0,1,-1,0,0,105,357,-252,252
Paddy Holohan,Vaughan Lee,Paddy Holohan,2015-07-18,1,0,-5,5,6,1.076923,10.16,-10.16,0,0,7.619995,-7.619995,472,72,14,27,-13,13,4.92307686805725,-4.92307686805725,1,0,0,1,1,-1,-1,1,181,413,-232,232
Alvaro Herrera Mendoza,Vernon Ramos Ho,Alvaro Herrera Mendoza,2015-11-21,1,0,2,-2,1.5,3,15.24001,-15.24001,-15,15,17.96001,-17.96001,1,0,15,4,11,-11,-1.5,1.5,0,0,0,0,0,0,0,0,0,0,0,0
Chuck Liddell,Vernon White,Chuck Liddell,2004-08-21,1,0,2,-2,2.625,0.7878788,5.080002,-5.080002,0,0,8.039993,-8.039993,91,0,29,59,-30,30,1.83712118864059,-1.83712118864059,5,0,0,0,5,-5,0,0,141,0,141,-141
Ashlee Evans-Smith,Veronica Hardy,Ashlee Evans-Smith,2016-09-03,1,0,9,-9,1,1.75,10.16,-10.16,10,-10,7.619995,-7.619995,361,109,12,11,1,-1,-0.75,0.75,1,0,0,0,1,-1,0,0,195,0,195,-195
Michael Graves,Vicente Luque,Michael Graves,2015-07-12,1,0,1,-1,6,2.444444,-2.539993,2.539993,0,0,-10.16,10.16,537,208,6,31,-25,25,3.55555558204651,-3.55555558204651,0,0,0,0,0,0,0,0,0,0,0,0
Hayder Hassan,Vicente Luque,Vicente Luque,2015-12-19,0,1,9,-9,2,2.444444,-2.539993,2.539993,0,0,-9.5,9.5,0,21,9,31,-22,22,-0.444444417953491,0.444444417953491,0,0,0,0,0,0,0,0,160,160,0,0
Alvaro Herrera Mendoza,Vicente Luque,Vicente Luque,2016-07-07,0,1,2,-2,1.5,2.444444,2.540009,-2.540009,-15,15,-2.539993,2.539993,0,332,15,31,-16,16,-0.944444417953491,0.944444417953491,1,1,0,0,0,0,0,0,229,201,28,-28
Leon Edwards,Vicente Luque,Leon Edwards,2017-03-18,1,0,0,0,7,2.444444,7.62001,-7.62001,0,0,-2.539993,2.539993,312,323,24,31,-7,7,4.55555558204651,-4.55555558204651,2,2,0,0,0,0,0,0,161,254,-93,93
Chad Laprise,Vicente Luque,Vicente Luque,2018-05-19,0,1,5,-5,3.25,2.444444,-2.539993,2.539993,0,0,-10.16,10.16,51,0,17,31,-14,14,0.805555582046509,-0.805555582046509,0,0,1,0,0,0,1,-1,791,427,364,-364
Bryan Barberena,Vicente Luque,Vicente Luque,2019-02-17,0,1,2,-2,1.636364,2.444444,2.540009,-2.540009,0,0,-7.619995,7.619995,31,41,29,31,-2,2,-0.808080792427063,0.808080792427063,1,1,0,0,0,0,0,0,176,274,-98,98
Derrick Krantz,Vicente Luque,Vicente Luque,2019-05-18,0,1,4,-4,1.833333,2.444444,-2.539993,2.539993,0,0,-7.619995,7.619995,96,36,34,31,3,-3,-0.611111044883728,0.611111044883728,0,2,0,0,-2,2,0,0,0,90,-90,90
Randy Brown,Vicente Luque,Vicente Luque,2020-08-01,0,1,2,-2,3.4,2.444444,10.16,-10.16,0,0,7.619995,-7.619995,52,66,22,31,-9,9,0.95555567741394,-0.95555567741394,0,3,1,0,-3,3,1,-1,749,441,308,-308
Michael Chiesa,Vicente Luque,Vicente Luque,2021-08-07,0,1,4,-4,2.571429,2.444444,5.080002,-5.080002,0,0,0,0,61,10,25,31,-6,6,0.126984119415283,-0.126984119415283,4,4,1,0,0,0,1,-1,199,371,-172,172
Rafael Dos Anjos,Vicente Luque,Vicente Luque,2023-08-12,0,1,7,-7,2.133333,2.444444,-7.619995,7.619995,0,0,-12.7,12.7,234,721,47,31,16,-16,-0.311110973358154,0.311110973358154,0,5,2,0,-5,5,2,-2,399,735,-336,336
Raoni Barcelos,Victor Henry,Victor Henry,2022-01-22,0,1,0,0,3.4,3.833333,0,0,0,0,-2.540009,2.540009,15,97,22,29,-7,7,-0.433333158493042,0.433333158493042,0,0,0,0,0,0,0,0,210,0,210,-210
Raphael Assuncao,Victor Henry,Raphael Assuncao,2022-10-15,1,0,5,-5,2.8,3.833333,-5.079987,5.079987,0,0,-5.080002,5.080002,269,3,38,29,9,-9,-1.03333330154419,1.03333330154419,0,1,3,0,-1,1,3,-3,301,266,35,-35
Tony Gravely,Victor Henry,Victor Henry,2023-03-11,0,1,-4,4,2.555556,3.833333,-5.079987,5.079987,0,0,2.539993,-2.539993,202,80,32,29,3,-3,-1.27777767181396,1.27777767181396,2,0,1,0,2,-2,1,-1,280,147,133,-133
Jordan Leavitt,Victor Martinez,Jordan Leavitt,2023-02-25,1,0,-4,4,5.5,2.6,2.539993,-2.539993,0,0,2.539993,-2.539993,46,0,13,18,-5,5,2.90000009536743,-2.90000009536743,0,0,0,0,0,0,0,0,217,0,217,-217
David Heath,Victor Valimaki,David Heath,2006-12-13,1,0,,,2.571429,1.8,-2.540009,2.540009,0,0,-2.119995,2.119995,5,59,25,28,-3,3,0.77142858505249,-0.77142858505249,1,0,0,0,1,-1,0,0,109,0,109,-109
Alessio Sakara,Victor Valimaki,Alessio Sakara,2007-04-21,1,0,,,1.727273,1.8,0,0,-20,20,-2.119995,2.119995,0,5,30,28,2,-2,-7.27272033691406e-02,7.27272033691406e-02,1,0,0,0,1,-1,0,0,441,129,312,-312
Manon Fiorot,Victoria Leonardo,Manon Fiorot,2021-01-20,1,0,0,0,11,1.5,5.079987,-5.079987,0,0,2.540009,-2.540009,85,2,12,15,-3,3,9.5,-9.5,0,0,0,0,0,0,0,0,0,0,0,0
Melissa Gatto,Victoria Leonardo,Melissa Gatto,2021-08-07,1,0,-6,6,4,1.5,0,0,0,0,12.7,-12.7,110,147,10,15,-5,5,2.5,-2.5,0,0,0,1,0,0,-1,1,0,199,-199,199
Mandy Bohm,Victoria Leonardo,Victoria Leonardo,2022-07-23,0,1,0,0,4,1.5,5.079987,-5.079987,0,0,17.78,-17.78,55,426,10,15,-5,5,2.5,-2.5,0,0,0,2,0,0,-2,2,308,350,-42,42
Chris Clements,Vik Grujic,Chris Clements,2014-11-07,1,0,1,-1,2,1,-2.539993,2.539993,0,0,-7.619995,7.619995,33,115,18,12,6,-6,1,-1,0,0,1,0,0,0,1,-1,412,0,412,-412
Ruslan Magomedov,Viktor Pesta,Ruslan Magomedov,2014-05-31,1,0,4,-4,14,2.5,0,0,2,-2,2.539993,-2.539993,5,190,15,14,1,-1,11.5,-11.5,0,0,0,0,0,0,0,0,0,0,0,0
Konstantin Erokhin,Viktor Pesta,Viktor Pesta,2015-01-24,0,1,7,-7,3,2.5,-10.16,10.16,-10,10,-12.58,12.58,0,547,12,14,-2,2,0.5,-0.5,0,0,0,0,0,0,0,0,0,238,-238,238
Derrick Lewis,Viktor Pesta,Derrick Lewis,2015-10-03,1,0,5,-5,2.454545,2.5,0,0,20,-20,5.080002,-5.080002,89,429,38,14,24,-24,-4.54545021057129e-02,4.54545021057129e-02,1,1,1,0,0,0,1,-1,217,252,-35,35
Aleksei Oleinik,Viktor Pesta,Aleksei Oleinik,2017-01-15,1,0,13,-13,3.529412,2.5,-2.539993,2.539993,0,0,7.619995,-7.619995,34,103,77,14,63,-63,1.02941179275513,-1.02941179275513,0,0,0,1,0,0,-1,1,186,470,-284,284
Rustam Khabilov,Vinc Pichel,Rustam Khabilov,2012-12-15,1,0,-4,4,6,4.666667,-5.080002,5.080002,0,0,2.539993,-2.539993,96,2,28,17,11,-11,1.33333349227905,-1.33333349227905,0,0,0,0,0,0,0,0,0,0,0,0
Anthony Njokuani,Vinc Pichel,Vinc Pichel,2014-05-24,0,1,3,-3,1.333333,4.666667,7.619995,-7.619995,0,0,7.619995,-7.619995,6,512,28,17,11,-11,-3.33333313465118,3.33333313465118,1,0,0,1,1,-1,-1,1,1057,525,532,-532
Damien Brown,Vinc Pichel,Vinc Pichel,2017-06-10,0,1,-2,2,1.416667,4.666667,0,0,0,0,-10.16,10.16,0,2,29,17,12,-12,-3.24999988079071,3.24999988079071,1,1,0,1,0,0,-1,1,196,1113,-917,917
Gregor Gillespie,Vinc Pichel,Gregor Gillespie,2018-06-01,1,0,-4,4,14,4.666667,-7.62001,7.62001,0,0,-2.540009,2.540009,471,0,15,17,-2,2,9.33333349227905,-9.33333349227905,3,2,0,1,1,-1,-1,1,125,356,-231,231
Jim Miller,Vinc Pichel,Vinc Pichel,2020-08-15,0,1,-1,1,2.117647,4.666667,-5.080002,5.080002,0,0,-2.540009,2.540009,310,394,53,17,36,-36,-2.54901933670044,2.54901933670044,1,0,0,1,1,-1,-1,1,56,806,-750,750
Austin Hubbard,Vinc Pichel,Vinc Pichel,2021-08-21,0,1,-9,9,2.285714,4.666667,0,0,0,0,-2.540009,2.540009,134,149,23,17,6,-6,-2.38095211982727,2.38095211982727,0,1,0,1,-1,1,-1,1,364,371,-7,7
Mark Madsen,Vinc Pichel,Mark Madsen,2022-04-09,1,0,-2,2,12,4.666667,-5.080002,5.080002,0,0,0,0,310,48,13,17,-4,4,7.33333349227905,-7.33333349227905,0,2,0,1,-2,2,-1,1,0,231,-231,231
Benito Lopez,Vince Morales,Benito Lopez,2019-07-13,1,0,-3,3,5,1.571429,2.540009,-2.540009,0,0,7.619995,-7.619995,0,29,12,18,-6,6,3.42857146263123,-3.42857146263123,1,0,0,0,1,-1,0,0,581,0,581,-581
Chris Gutierrez,Vince Morales,Chris Gutierrez,2020-05-30,1,0,0,0,3.8,1.571429,0,0,0,0,-7.62001,7.62001,9,0,24,18,6,-6,2.22857141494751,-2.22857141494751,1,0,0,0,1,-1,0,0,434,322,112,-112
Jonathan Martinez,Vince Morales,Jonathan Martinez,2022-05-21,1,0,-3,3,4.5,1.571429,-2.539993,2.539993,0,0,0,0,41,14,22,18,4,-4,2.92857146263123,-2.92857146263123,2,0,0,1,2,-2,-1,1,84,721,-637,637
Miles Johns,Vince Morales,Miles Johns,2022-11-19,1,0,-4,4,7,1.571429,-5.080002,5.080002,0,0,-10.16,10.16,128,5,16,18,-2,2,5.42857146263123,-5.42857146263123,2,0,0,1,2,-2,-1,1,749,182,567,-567
Alonzo Menifield,Vinicius Moreira,Alonzo Menifield,2019-01-19,1,0,2,-2,4.666667,1.8,-10.15999,10.15999,0,0,0,0,29,80,17,14,3,-3,2.86666655540466,-2.86666655540466,0,0,0,0,0,0,0,0,0,0,0,0
Eryk Anders,Vinicius Moreira,Eryk Anders,2019-06-29,1,0,2,-2,1.875,1.8,-7.619995,7.619995,-20,20,-2.539993,2.539993,10,41,23,14,9,-9,7.50000476837158e-02,-7.50000476837158e-02,0,0,1,1,0,0,0,0,77,161,-84,84
Paul Craig,Vinicius Moreira,Paul Craig,2019-09-21,1,0,1,-1,2.833333,1.8,-2.539993,2.539993,-20,20,0,0,128,51,23,14,9,-9,1.03333330154419,-1.03333330154419,0,0,3,2,0,0,1,-1,84,84,0,0
Rob Broughton,Vinicius Queiroz,Rob Broughton,2010-10-16,1,0,0,0,2.285714,2,-12.7,12.7,45,-45,-15.03999,15.03999,121,335,23,12,11,-11,0.285714387893677,-0.285714387893677,0,0,0,0,0,0,0,0,0,0,0,0
Victor Altamirano,Vinicius Salvador,Victor Altamirano,2023-03-25,1,0,6,-6,4,2.333333,2.540009,-2.540009,0,0,0,0,304,21,15,20,-5,5,1.66666674613953,-1.66666674613953,1,0,0,0,1,-1,0,0,217,0,217,-217
Ryan Bader,Vinny Magalhaes,Ryan Bader,2008-12-13,1,0,1,-1,4.6,1.555556,-2.539993,2.539993,0,0,-2.539993,2.539993,4,0,28,23,5,-5,3.04444432258606,-3.04444432258606,0,0,0,0,0,0,0,0,0,0,0,0
Phil Davis,Vinny Magalhaes,Phil Davis,2013-04-27,1,0,0,0,4.25,1.555556,-2.539993,2.539993,0,0,10.16,-10.16,55,20,21,23,-2,2,2.69444441795349,-2.69444441795349,1,0,0,1,1,-1,-1,1,196,1596,-1400,1400
Carla Esparza,Virna Jandiroba,Carla Esparza,2019-04-27,1,0,1,-1,2.857143,6.333333,-5.080002,5.080002,0,0,-2.539993,2.539993,327,228,27,22,5,-5,-3.4761905670166,3.4761905670166,0,0,2,0,0,0,2,-2,231,0,231,-231
Felice Herrig,Virna Jandiroba,Virna Jandiroba,2020-08-15,0,1,3,-3,1.4,6.333333,2.539993,-2.539993,0,0,2.540009,-2.540009,0,93,24,22,2,-2,-4.93333351612091,4.93333351612091,0,0,0,0,0,0,0,0,679,476,203,-203
Mackenzie Dern,Virna Jandiroba,Mackenzie Dern,2020-12-12,1,0,-5,5,4.333333,6.333333,2.539993,-2.539993,0,0,-2.539993,2.539993,154,164,16,22,-6,6,-2,2,1,1,0,0,0,0,0,0,84,119,-35,35
Angela Hill,Virna Jandiroba,Virna Jandiroba,2022-05-14,0,1,4,-4,1.153846,6.333333,0,0,0,0,0,0,128,424,28,22,6,-6,-5.17948734760284,5.17948734760284,0,0,0,0,0,0,0,0,147,518,-371,371
David Abbott,Vitor Belfort,Vitor Belfort,1997-05-30,0,1,,,0.6666667,1.857143,0,0,80,-80,-5.460007,5.460007,0,0,25,40,-15,15,-1.19047611951828,1.19047611951828,0,0,0,0,0,0,0,0,174,0,174,-174
Yoshihiro Akiyama,Vitor Belfort,Vitor Belfort,2011-08-06,0,1,2,-2,2.333333,1.857143,-5.080002,5.080002,-15,15,2.539993,-2.539993,0,9,20,40,-20,20,0.476190447807312,-0.476190447807312,0,1,0,0,-1,1,0,0,294,5181,-4887,4887
Antonio Carlos Junior,Vitor Miranda,Antonio Carlos Junior,2014-05-31,1,0,-11,11,2.2,2.4,2.540009,-2.540009,0,0,5.080002,-5.080002,511,120,16,17,-1,1,-0.200000047683716,0.200000047683716,0,0,0,0,0,0,0,0,0,0,0,0
Jake Collier,Vitor Miranda,Vitor Miranda,2014-12-20,0,1,-9,9,1.3,2.4,5.080002,-5.080002,45,-45,2.539993,-2.539993,184,1,23,17,6,-6,-1.10000014305115,1.10000014305115,0,0,0,0,0,0,0,0,0,203,-203,203
Clint Hester,Vitor Miranda,Vitor Miranda,2015-08-01,0,1,-8,8,1.833333,2.4,2.540009,-2.540009,20,-20,0,0,180,205,17,17,0,0,-0.566666722297668,0.566666722297668,0,1,1,0,-1,1,1,-1,267,224,43,-43
Marcelo Guimaraes,Vitor Miranda,Vitor Miranda,2016-03-05,0,1,-4,4,4.5,2.4,-2.539993,2.539993,0,0,-10.16,10.16,237,2,11,17,-6,6,2.09999990463257,-2.09999990463257,0,2,1,0,-2,2,1,-1,1099,217,882,-882
Chris Camozzi,Vitor Miranda,Chris Camozzi,2016-05-29,1,0,-8,8,1.846154,2.4,2.540009,-2.540009,0,0,-5.080002,5.080002,337,14,37,17,20,-20,-0.55384624004364,0.55384624004364,2,3,0,0,-1,1,0,0,98,85,13,-13
Abu Azaitar,Vitor Miranda,Abu Azaitar,2018-07-22,1,0,-7,7,4.666667,2.4,-10.16,10.16,0,0,-2.540009,2.540009,198,297,17,17,0,0,2.26666641235352,-2.26666641235352,0,0,0,0,0,0,0,0,0,784,-784,784
Valerie Letourneau,Viviane Pereira,Viviane Pereira,2016-12-10,0,1,10,-10,1.333333,6.5,15.23999,-15.23999,0,0,12.7,-12.7,106,224,14,15,-1,1,-5.16666662693024,5.16666662693024,0,0,1,0,0,0,1,-1,175,0,175,-175
Jamie Moyle,Viviane Pereira,Viviane Pereira,2017-06-03,0,1,5,-5,1.333333,6.5,0,0,0,0,5.080002,-5.080002,9,113,7,15,-8,8,-5.16666662693024,5.16666662693024,0,1,0,0,-1,1,0,0,0,175,-175,175
Yuki Kondo,Vladimir Matyushenko,Vladimir Matyushenko,2001-06-29,0,1,-5,5,1.818182,3.375,-2.540009,2.540009,-22,22,-5.960007,5.960007,0,854,93,35,58,-58,-1.55681812763214,1.55681812763214,0,0,0,0,0,0,0,0,195,0,195,-195
Andrei Arlovski,Vladimir Matyushenko,Andrei Arlovski,2003-09-26,1,0,-8,8,1.545455,3.375,7.619995,-7.619995,35,-35,7.619995,-7.619995,35,3,56,35,21,-21,-1.82954549789429,1.82954549789429,1,1,2,0,0,0,2,-2,308,819,-511,511
Eliot Marshall,Vladimir Matyushenko,Vladimir Matyushenko,2010-03-21,0,1,-10,10,2.5,3.375,5.080002,-5.080002,0,0,7.619995,-7.619995,0,87,14,35,-21,21,-0.875,0.875,0,0,0,1,0,0,-1,1,0,2368,-2368,2368
Jon Jones,Vladimir Matyushenko,Jon Jones,2010-08-01,1,0,-16,16,27,3.375,10.15999,-10.15999,43,-43,25.39999,-25.39999,54,0,28,35,-7,7,23.625,-23.625,2,1,0,1,1,-1,-1,1,133,133,0,0
Alexandre Ferreira,Vladimir Matyushenko,Vladimir Matyushenko,2010-11-13,0,1,-8,8,3,3.375,-12.70001,12.70001,0,0,-14.96001,14.96001,0,38,24,35,-11,11,-0.375,0.375,0,0,0,2,0,0,-2,2,0,104,-104,104
Jason Brilz,Vladimir Matyushenko,Vladimir Matyushenko,2011-04-30,0,1,-5,5,3.666667,3.375,-2.540009,2.540009,0,0,-7.62001,7.62001,0,2,28,35,-7,7,0.291666746139526,-0.291666746139526,0,1,0,2,-1,1,-2,2,336,168,168,-168
Alexander Gustafsson,Vladimir Matyushenko,Alexander Gustafsson,2011-12-30,1,0,-16,16,2.25,3.375,12.7,-12.7,0,0,12.7,-12.7,4,0,26,35,-9,9,-1.125,1.125,3,2,0,2,1,-1,-2,2,146,244,-98,98
Ryan Bader,Vladimir Matyushenko,Ryan Bader,2013-01-26,1,0,-13,13,4.6,3.375,5.080002,-5.080002,0,0,0,0,6,14,28,35,-7,7,1.22499990463257,-1.22499990463257,0,0,1,3,0,0,-2,2,175,393,-218,218
Misha Cirkunov,Volkan Oezdemir,Volkan Oezdemir,2017-05-28,0,1,3,-3,1.666667,2.714286,2.539993,-2.539993,0,0,5.080002,-5.080002,0,2,24,26,-2,2,-1.04761898517609,1.04761898517609,4,0,0,0,4,-4,0,0,169,0,169,-169
Jimi Manuwa,Volkan Oezdemir,Volkan Oezdemir,2017-07-29,0,1,10,-10,2.833333,2.714286,-2.540009,2.540009,0,0,10.16,-10.16,15,2,23,26,-3,3,0.11904764175415,-0.11904764175415,1,1,0,0,0,0,0,0,294,62,232,-232
Daniel Cormier,Volkan Oezdemir,Daniel Cormier,2018-01-20,1,0,10,-10,7.333333,2.714286,-7.62001,7.62001,30,-30,-7.619995,7.619995,103,7,25,26,-1,1,4.61904788017273,-4.61904788017273,4,2,0,0,2,-2,0,0,287,175,112,-112
Ilir Latifi,Volkan Oezdemir,Volkan Oezdemir,2019-08-10,0,1,8,-8,1.888889,2.714286,-10.16,10.16,25,-25,-5.080002,5.080002,66,25,26,26,0,0,-0.825396776199341,0.825396776199341,5,0,0,1,5,-5,-1,1,532,567,-35,35
Magomed Ankalaev,Volkan Oezdemir,Magomed Ankalaev,2021-10-30,1,0,-3,3,18,2.714286,2.539993,-2.539993,0,0,0,0,105,0,19,26,-7,7,15.2857143878937,-15.2857143878937,5,1,0,1,4,-4,-1,1,245,812,-567,567
Paul Craig,Volkan Oezdemir,Volkan Oezdemir,2022-07-23,0,1,2,-2,2.833333,2.714286,2.539993,-2.539993,-20,20,2.539993,-2.539993,7,309,23,26,-3,3,0.11904764175415,-0.11904764175415,4,0,3,1,4,-4,2,-2,126,266,-140,140
Nikita Krylov,Volkan Oezdemir,Nikita Krylov,2022-10-22,1,0,-3,3,3.333333,2.714286,2.539993,-2.539993,0,0,5.080002,-5.080002,557,47,39,26,13,-13,0.61904764175415,-0.61904764175415,1,1,1,1,0,0,0,0,952,91,861,-861
Bogdan Guskov,Volkan Oezdemir,Volkan Oezdemir,2023-09-02,0,1,-3,3,4.666667,2.714286,2.539993,-2.539993,0,0,2.539993,-2.539993,0,83,17,26,-9,9,1.95238089561462,-1.95238089561462,0,0,0,1,0,0,-1,1,0,315,-315,315
Phil Davis,Wagner Prado,Phil Davis,2012-10-13,1,0,3,-3,4.25,4,5.080002,-5.080002,0,0,12.7,-12.7,354,0,21,15,6,-6,0.25,-0.25,0,0,0,0,0,0,0,0,259,0,259,-259
Ildemar Alcantara,Wagner Prado,Ildemar Alcantara,2013-01-19,1,0,4,-4,1.909091,4,5.080002,-5.080002,-20,20,10.15999,-10.15999,86,73,32,15,17,-17,-2.09090912342072,2.09090912342072,0,0,0,0,0,0,0,0,0,98,-98,98
Ricardo Abreu,Wagner Silva,Ricardo Abreu,2014-05-31,1,0,3,-3,5,2,-2.540009,2.540009,15,-15,-5,5,75,0,6,9,-3,3,3,-3,0,0,0,0,0,0,0,0,0,0,0,0
Colby Covington,Wagner Silva,Colby Covington,2014-11-08,1,0,-1,1,5.666667,2,-2.540009,2.540009,0,0,-2.119995,2.119995,503,2,20,9,11,-11,3.66666650772095,-3.66666650772095,1,0,0,0,1,-1,0,0,77,161,-84,84
Lukasz Brzeski,Waldo Cortes-Acosta,Waldo Cortes-Acosta,2023-08-26,0,1,0,0,2,10,0,0,-24,24,0,0,0,0,12,11,1,-1,-8,8,0,0,0,0,0,0,0,0,168,0,168,-168
Joseph Sandoval,Walel Watson,Walel Watson,2011-10-01,0,1,-2,2,1,1.4,-10.16,10.16,0,0,-17.5,17.5,0,4,14,24,-10,10,-0.399999976158142,0.399999976158142,0,0,0,0,0,0,0,0,0,0,0,0
Yves Jabouin,Walel Watson,Yves Jabouin,2011-12-10,1,0,5,-5,1.818182,1.4,-10.16,10.16,0,0,-17.78,17.78,101,76,31,24,7,-7,0.418181896209717,-0.418181896209717,1,1,0,0,0,0,0,0,105,70,35,-35
TJ Dillashaw,Walel Watson,TJ Dillashaw,2012-02-15,1,0,-1,1,3.6,1.4,-12.7,12.7,0,0,-20.32001,20.32001,742,0,23,24,-1,1,2.19999992847443,-2.19999992847443,0,0,1,0,0,0,1,-1,74,67,7,-7
Mitch Gagnon,Walel Watson,Mitch Gagnon,2012-09-22,1,0,-1,1,2.4,1.4,-15.23999,15.23999,0,0,-25.39999,25.39999,31,0,17,24,-7,7,1.00000011920929,-1.00000011920929,0,0,0,0,0,0,0,0,0,220,-220,220
Cody East,Walt Harris,Walt Harris,2016-04-23,0,1,-5,5,4,1.3,-5.080002,5.080002,-5,5,-2.580002,2.580002,39,0,15,23,-8,8,2.70000004768372,-2.70000004768372,0,0,0,0,0,0,0,0,0,0,0,0
Shamil Abdurakhimov,Walt Harris,Shamil Abdurakhimov,2016-10-01,1,0,2,-2,2.5,1.3,-5.080002,5.080002,-15,15,-2.540009,2.540009,44,29,28,23,5,-5,1.20000004768372,-1.20000004768372,1,1,1,0,0,0,1,-1,223,161,62,-62
Cyril Asker,Walt Harris,Walt Harris,2017-06-17,0,1,-3,3,2.25,1.3,-12.7,12.7,-3,3,-7.619995,7.619995,0,24,13,23,-10,10,0.950000047683716,-0.950000047683716,1,0,1,0,1,-1,1,-1,153,259,-106,106
Mark Godbeer,Walt Harris,Mark Godbeer,2017-11-04,1,0,-1,1,3.25,1.3,-2.540009,2.540009,-10,10,0,0,0,191,17,23,-6,6,1.95000004768372,-1.95000004768372,1,1,0,0,0,0,0,0,245,140,105,-105
Vitor Belfort,Wanderlei Silva,Vitor Belfort,1998-10-16,1,0,-1,1,1.857143,2.692308,2.540009,-2.540009,-20,20,0,0,0,0,40,48,-8,8,-0.835164904594421,0.835164904594421,1,0,1,0,1,-1,1,-1,299,0,299,-299
Tony Petarra,Wanderlei Silva,Wanderlei Silva,1999-05-07,0,1,,,0.6666667,2.692308,0,0,-9,9,-4.960007,4.960007,0,0,5,48,-43,43,-2.0256410241127,2.0256410241127,0,0,0,1,0,0,-1,1,0,203,-203,203
Tito Ortiz,Wanderlei Silva,Tito Ortiz,2000-04-14,1,0,2,-2,1.583333,2.692308,10.16,-10.16,0,0,0,0,1153,7,31,48,-17,17,-1.10897433757782,1.10897433757782,0,1,1,1,-1,1,0,0,203,343,-140,140
Chuck Liddell,Wanderlei Silva,Chuck Liddell,2007-12-29,1,0,7,-7,2.625,2.692308,7.62001,-7.62001,0,0,5.079987,-5.079987,70,2,29,48,-19,19,-6.7307710647583e-02,6.7307710647583e-02,8,0,0,1,8,-8,-1,1,364,2815,-2451,2451
Keith Jardine,Wanderlei Silva,Wanderlei Silva,2008-05-24,0,1,1,-1,1.545455,2.692308,7.62001,-7.62001,-20,20,5.079987,-5.079987,0,9,28,48,-20,20,-1.14685320854187,1.14685320854187,3,0,0,1,3,-3,-1,1,245,147,98,-98
Quinton Jackson,Wanderlei Silva,Quinton Jackson,2008-12-27,1,0,-2,2,3.083333,2.692308,5.080002,-5.080002,0,0,-2.540009,2.540009,2,0,49,48,1,-1,0.391025543212891,-0.391025543212891,1,1,0,1,0,0,-1,1,581,217,364,-364
Rich Franklin,Wanderlei Silva,Rich Franklin,2009-06-13,1,0,2,-2,4.142857,2.692308,5.080002,-5.080002,-20,20,5.079987,-5.079987,78,92,36,48,-12,12,1.45054936408997,-1.45054936408997,0,0,2,2,0,0,0,0,147,168,-21,21
Michael Bisping,Wanderlei Silva,Wanderlei Silva,2010-02-20,0,1,-3,3,3.333333,2.692308,5.080002,-5.080002,-20,20,2.539993,-2.539993,43,61,39,48,-9,9,0.641025543212891,-0.641025543212891,1,0,1,2,1,-1,-1,1,98,252,-154,154
Chris Leben,Wanderlei Silva,Chris Leben,2011-07-02,1,0,-4,4,2,2.692308,0,0,-20,20,-2.540009,2.540009,2,0,33,48,-15,15,-0.692307710647583,0.692307710647583,0,1,2,2,-1,1,0,0,182,497,-315,315
Cung Le,Wanderlei Silva,Wanderlei Silva,2011-11-19,0,1,4,-4,3,2.692308,-5.080002,5.080002,-20,20,-10.16,10.16,0,13,12,48,-36,36,0.307692289352417,-0.307692289352417,0,0,0,3,0,0,-3,3,0,140,-140,140
Rich Franklin,Wanderlei Silva,Rich Franklin,2012-06-23,1,0,2,-2,4.142857,2.692308,5.080002,-5.080002,-20,20,5.079987,-5.079987,47,39,36,48,-12,12,1.45054936408997,-1.45054936408997,0,1,2,3,-1,1,-1,1,504,217,287,-287
Alex Caceres,Wang Guan,Wang Guan,2017-11-25,0,1,-2,2,1.5,20,2.540009,-2.540009,0,0,5.080002,-5.080002,22,24,35,21,14,-14,-18.5,18.5,1,0,1,0,1,-1,1,-1,161,0,161,-161
Marcio Alexandre Junior,Warlley Alves,Warlley Alves,2014-05-31,0,1,2,-2,4.25,2.5,2.540009,-2.540009,15,-15,7.619995,-7.619995,5,458,21,21,0,0,1.75,-1.75,0,0,0,0,0,0,0,0,0,0,0,0
Sultan Aliev,Warlley Alves,Warlley Alves,2018-05-12,0,1,6,-6,5,2.5,0,0,0,0,5.080002,-5.080002,127,204,18,21,-3,3,2.5,-2.5,1,1,1,0,0,0,1,-1,511,1442,-931,931
Melvin Guillard,Waylon Lowe,Melvin Guillard,2010-05-29,1,0,-2,2,1.777778,2.285714,5.080002,-5.080002,10,-10,7.339996,-7.339996,2,87,50,23,27,-27,-0.507936596870422,0.507936596870422,3,0,0,0,3,-3,0,0,112,0,112,-112
Steve Lopez,Waylon Lowe,Waylon Lowe,2010-09-25,0,1,-3,3,2.166667,2.285714,10.16,-10.16,10,-10,10,-10,0,412,19,23,-4,4,-0.11904764175415,0.11904764175415,0,0,1,1,0,0,0,0,371,119,252,-252
Willamy Freire,Waylon Lowe,Waylon Lowe,2011-01-22,0,1,-7,7,4.333333,2.285714,2.540009,-2.540009,10,-10,2,-2,88,577,32,23,9,-9,2.04761910438538,-2.04761910438538,0,1,0,1,-1,1,-1,1,0,119,-119,119
Nik Lentz,Waylon Lowe,Nik Lentz,2011-03-26,1,0,-4,4,2.5,2.285714,2.540009,-2.540009,0,0,-0.2799988,0.2799988,16,270,42,23,19,-19,0.214285612106323,-0.214285612106323,2,2,0,1,0,0,-1,1,210,63,147,-147
Karl Roberson,Wellington Turman,Karl Roberson,2019-07-13,1,0,6,-6,1.5,2.571429,2.539993,-2.539993,35,-35,5.080002,-5.080002,347,413,15,25,-10,10,-1.07142853736877,1.07142853736877,0,0,0,0,0,0,0,0,175,0,175,-175
Markus Perez,Wellington Turman,Wellington Turman,2019-11-16,0,1,8,-8,2.4,2.571429,2.539993,-2.539993,15,-15,2.539993,-2.539993,81,401,17,25,-8,8,-0.171428442001343,0.171428442001343,0,0,0,0,0,0,0,0,448,126,322,-322
Andrew Sanchez,Wellington Turman,Andrew Sanchez,2020-08-08,1,0,8,-8,1.857143,2.571429,2.539993,-2.539993,15,-15,5.080002,-5.080002,71,0,20,25,-5,5,-0.714285731315613,0.714285731315613,0,1,1,0,-1,1,1,-1,301,266,35,-35
Bruno Silva,Wellington Turman,Bruno Silva,2021-06-19,1,0,7,-7,2.555556,2.571429,0,0,15,-15,5.080002,-5.080002,98,172,32,25,7,-7,-1.58729553222656e-02,1.58729553222656e-02,0,0,0,1,0,0,-1,1,252,315,-63,63
Sam Alvey,Wellington Turman,Wellington Turman,2021-08-28,0,1,10,-10,1.833333,2.571429,5.080002,-5.080002,15,-15,7.619995,-7.619995,114,174,51,25,26,-26,-0.738095164299011,0.738095164299011,0,0,3,2,0,0,1,-1,140,70,70,-70
Misha Cirkunov,Wellington Turman,Wellington Turman,2022-02-26,0,1,9,-9,1.666667,2.571429,7.619995,-7.619995,35,-35,12.7,-12.7,184,135,24,25,-1,1,-0.904761910438538,0.904761910438538,0,1,4,2,-1,1,2,-2,147,182,-35,35
Andre Petroski,Wellington Turman,Andre Petroski,2022-11-12,1,0,5,-5,5,2.571429,0,0,15,-15,2.539993,-2.539993,479,100,12,25,-13,13,2.42857146263123,-2.42857146263123,1,2,0,2,-1,1,-2,2,378,259,119,-119
Randy Brown,Wellington Turman,Randy Brown,2023-06-24,1,0,6,-6,3.4,2.571429,7.619995,-7.619995,0,0,15.23999,-15.23999,167,185,22,25,-3,3,0.828571557998657,-0.828571557998657,0,0,2,2,0,0,0,0,133,224,-91,91
Frank Mir,Wes Sims,Frank Mir,2003-06-06,1,0,1,-1,1.636364,1.714286,-17.78,17.78,4,-4,-10.34,10.34,158,11,29,38,-9,9,-7.79221057891846e-02,7.79221057891846e-02,2,0,0,0,2,-2,0,0,441,0,441,-441
Frank Mir,Wes Sims,Frank Mir,2004-01-31,1,0,0,0,1.636364,1.714286,-17.78,17.78,4,-4,-10.34,10.34,456,39,29,38,-9,9,-7.79221057891846e-02,7.79221057891846e-02,3,0,0,0,3,-3,0,0,239,239,0,0
Mike Kyle,Wes Sims,Mike Kyle,2004-04-02,1,0,0,0,1.571429,1.714286,-15.24001,15.24001,-55,55,-15.42,15.42,240,12,36,38,-2,2,-0.142857193946838,0.142857193946838,0,0,0,1,0,0,-1,1,0,62,-62,62
Sean Alvarez,Wesley Correira,Wesley Correira,2003-04-25,0,1,7,-7,1.333333,1.25,-7.619995,7.619995,-25,25,-13.46001,13.46001,197,13,7,36,-29,29,8.33333730697632e-02,-8.33333730697632e-02,0,0,0,0,0,0,0,0,0,0,0,0
David Abbott,Wesley Correira,Wesley Correira,2003-11-21,0,1,,,0.6666667,1.25,-7.619995,7.619995,5,-5,-17.5,17.5,84,7,25,36,-11,11,-0.583333313465118,0.583333313465118,0,1,2,0,-1,1,2,-2,168,210,-42,42
Andrei Arlovski,Wesley Correira,Andrei Arlovski,2004-04-02,1,0,0,0,1.545455,1.25,0,0,-20,20,-4.419998,4.419998,6,0,56,36,20,-20,0.295454502105713,-0.295454502105713,2,2,2,0,0,0,2,-2,189,133,56,-56
Joanderson Brito,Westin Wilson,Joanderson Brito,2023-07-01,1,0,-6,6,5,2,-12.7,12.7,0,0,-2.539993,2.539993,128,0,18,24,-6,6,3,-3,1,0,0,0,1,-1,0,0,427,0,427,-427
Jarno Errens,William Gomis,William Gomis,2022-09-03,0,1,2,-2,2.6,6.5,-2.540009,2.540009,0,0,0,0,14,484,18,15,3,-3,-3.90000009536743,3.90000009536743,0,0,0,0,0,0,0,0,0,0,0,0
Yanis Ghemmouri,William Gomis,William Gomis,2023-09-02,0,1,2,-2,6,6.5,-7.62001,7.62001,0,0,-10.16,10.16,162,55,14,15,-1,1,-0.5,0.5,0,1,0,0,-1,1,0,0,0,364,-364,364
Aleksa Camur,William Knight,William Knight,2020-09-26,0,1,-7,7,2,2.2,7.619995,-7.619995,0,0,2.540009,-2.540009,326,399,9,16,-7,7,-0.200000047683716,0.200000047683716,1,0,0,0,1,-1,0,0,252,0,252,-252
Fabio Cherant,William Knight,William Knight,2021-08-21,0,1,-7,7,1.75,2.2,7.619995,-7.619995,0,0,2.540009,-2.540009,0,2,11,16,-5,5,-0.450000047683716,0.450000047683716,0,1,0,0,-1,1,0,0,147,329,-182,182
Maxim Grishin,William Knight,Maxim Grishin,2022-02-12,1,0,4,-4,3.2,2.2,12.7,-12.7,0,0,12.7,-12.7,147,157,42,16,26,-26,1,-1,0,2,0,0,-2,2,0,0,350,175,175,-175
Devin Clark,William Knight,Devin Clark,2022-04-16,1,0,-2,2,1.75,2.2,5.080002,-5.080002,0,0,5.080002,-5.080002,346,129,22,16,6,-6,-0.450000047683716,0.450000047683716,0,0,2,0,0,0,2,-2,210,63,147,-147
Matt Dwyer,William Macario,Matt Dwyer,2015-02-22,1,0,2,-2,2.25,3,12.7,-12.7,0,0,2.539993,-2.539993,3,0,13,12,1,-1,-0.75,0.75,0,0,1,0,0,0,1,-1,141,0,141,-141
Wes Combs,Wilson Gouveia,Wilson Gouveia,2006-08-26,0,1,6,-6,3.333333,1.75,2.540009,-2.540009,20,-20,-2.039993,2.039993,0,71,26,22,4,-4,1.58333325386047,-1.58333325386047,0,0,0,0,0,0,0,0,63,0,63,-63
Alan Belcher,Wilson Gouveia,Alan Belcher,2009-12-12,1,0,-6,6,2.25,1.75,2.540009,-2.540009,0,0,-2.539993,2.539993,4,0,26,22,4,-4,0.5,-0.5,2,1,1,0,1,-1,1,-1,329,1204,-875,875
Ivan Menjivar,Wilson Reis,Wilson Reis,2013-09-21,0,1,3,-3,2.083333,2.3,5.080002,-5.080002,20,-20,-2.540009,2.540009,0,423,37,33,4,-4,-0.216666698455811,0.216666698455811,2,0,0,0,2,-2,0,0,777,0,777,-777
Iuri Alcantara,Wilson Reis,Iuri Alcantara,2014-02-15,1,0,4,-4,3.5,2.3,12.7,-12.7,10,-10,15.23999,-15.23999,222,406,45,33,12,-12,1.20000004768372,-1.20000004768372,0,1,0,0,-1,1,0,0,182,147,35,-35
Scott Jorgensen,Wilson Reis,Wilson Reis,2014-10-25,0,1,3,-3,1.25,2.3,2.540009,-2.540009,10,-10,2.539993,-2.539993,18,34,27,33,-6,6,-1.04999995231628,1.04999995231628,1,0,1,0,1,-1,1,-1,140,252,-112,112
Jussier Formiga,Wilson Reis,Jussier Formiga,2015-05-30,1,0,0,0,2.875,2.3,2.540009,-2.540009,0,0,5.079987,-5.079987,91,293,31,33,-2,2,0.575000047683716,-0.575000047683716,2,1,0,0,1,-1,0,0,287,217,70,-70
Dustin Ortiz,Wilson Reis,Wilson Reis,2016-01-30,0,1,-4,4,2.375,2.3,2.540009,-2.540009,0,0,0,0,15,411,27,33,-6,6,7.50000476837158e-02,-7.50000476837158e-02,1,0,0,0,1,-1,0,0,573,245,328,-328
Demetrious Johnson,Wilson Reis,Demetrious Johnson,2017-04-15,1,0,-2,2,9,2.3,-2.539993,2.539993,0,0,2.539993,-2.539993,139,1,30,33,-3,3,6.70000004768372,-6.70000004768372,4,1,0,0,3,-3,0,0,1358,441,917,-917
Henry Cejudo,Wilson Reis,Henry Cejudo,2017-09-09,1,0,-2,2,5.333333,2.3,0,0,10,-10,-2.540009,2.540009,45,0,19,33,-14,14,3.03333353996277,-3.03333353996277,0,0,1,0,0,0,1,-1,504,147,357,-357
John Moraga,Wilson Reis,John Moraga,2018-04-14,1,0,1,-1,2.714286,2.3,5.080002,-5.080002,0,0,2.539993,-2.539993,42,463,26,33,-7,7,0.414285659790039,-0.414285659790039,0,0,0,1,0,0,-1,1,454,217,237,-237
Ben Nguyen,Wilson Reis,Wilson Reis,2018-12-01,0,1,-3,3,2,2.3,2.540009,-2.540009,0,0,0,0,25,357,24,33,-9,9,-0.299999952316284,0.299999952316284,0,0,1,1,0,0,0,0,871,231,640,-640
Alexandre Pantoja,Wilson Reis,Alexandre Pantoja,2019-04-13,1,0,-6,6,5.2,2.3,2.540009,-2.540009,0,0,5.079987,-5.079987,14,46,31,33,-2,2,2.89999985694885,-2.89999985694885,3,1,0,1,2,-2,-1,1,147,133,14,-14
Gina Mazany,Wu Yanan,Gina Mazany,2017-11-25,1,0,8,-8,1.166667,2.166667,-5.080002,5.080002,-10,10,5.080002,-5.080002,492,238,13,19,-6,6,-1.00000011920929,1.00000011920929,0,0,0,0,0,0,0,0,279,0,279,-279
Lauren Mueller,Wu Yanan,Wu Yanan,2018-11-24,0,1,5,-5,1.666667,2.166667,-7.619995,7.619995,-10,10,2.539993,-2.539993,30,73,8,19,-11,11,-0.50000011920929,0.50000011920929,0,0,0,0,0,0,0,0,0,364,-364,364
Joselyne Edwards,Wu Yanan,Joselyne Edwards,2021-01-16,1,0,1,-1,2.6,2.166667,0,0,0,0,10.16,-10.16,69,229,18,19,-1,1,0.433333158493042,-0.433333158493042,0,1,0,0,-1,1,0,0,0,784,-784,784
Mayra Bueno Silva,Wu Yanan,Mayra Bueno Silva,2022-04-16,1,0,5,-5,5.5,2.166667,-5.080002,5.080002,0,0,0,0,49,135,13,19,-6,6,3.33333325386047,-3.33333325386047,0,0,0,0,0,0,0,0,182,455,-273,273
Lucie Pudilova,Wu Yanan,Lucie Pudilova,2022-08-20,1,0,2,-2,1.75,2.166667,0,0,0,0,2.539993,-2.539993,293,4,22,19,3,-3,-0.416666746139526,0.416666746139526,0,0,0,0,0,0,0,0,1113,126,987,-987
Leonardo Morales,Yair Rodriguez,Yair Rodriguez,2014-11-15,0,1,-1,1,3,4,-7.619995,7.619995,-10,10,-15.34,15.34,137,236,8,20,-12,12,-1,1,0,0,0,0,0,0,0,0,0,0,0,0
Dan Hooker,Yair Rodriguez,Yair Rodriguez,2015-10-03,0,1,3,-3,1.916667,4,2.540009,-2.540009,10,-10,10.16,-10.16,361,30,35,20,15,-15,-2.08333337306976,2.08333337306976,0,1,0,0,-1,1,0,0,0,322,-322,322
Andre Fili,Yair Rodriguez,Yair Rodriguez,2016-04-23,0,1,2,-2,2.2,4,0,0,0,0,7.62001,-7.62001,7,234,32,20,12,-12,-1.79999995231628,1.79999995231628,0,2,0,0,-2,2,0,0,399,203,196,-196
Alex Caceres,Yair Rodriguez,Yair Rodriguez,2016-08-06,0,1,5,-5,1.5,4,-2.539993,2.539993,0,0,5.080002,-5.080002,99,31,35,20,15,-15,-2.5,2.5,2,3,1,0,-1,1,1,-1,63,105,-42,42
BJ Penn,Yair Rodriguez,Yair Rodriguez,2017-01-15,0,1,14,-14,1.142857,4,-5.080002,5.080002,10,-10,-2.539993,2.539993,22,19,30,20,10,-10,-2.85714280605316,2.85714280605316,1,4,1,0,-3,3,1,-1,2591,162,2429,-2429
Frankie Edgar,Yair Rodriguez,Frankie Edgar,2017-05-13,1,0,11,-11,2.090909,4,-12.7,12.7,-10,10,-7.619995,7.619995,506,0,34,20,14,-14,-1.90909099578857,1.90909099578857,6,5,0,0,1,-1,0,0,182,118,64,-64
Max Holloway,Yair Rodriguez,Max Holloway,2021-11-13,1,0,0,0,3.571429,4,0,0,0,0,-5.080002,5.080002,409,80,32,20,12,-12,-0.428571462631226,0.428571462631226,1,0,0,1,1,-1,-1,1,301,1645,-1344,1344
Brian Ortega,Yair Rodriguez,Yair Rodriguez,2022-07-16,0,1,2,-2,5,4,-7.619995,7.619995,0,0,-5.080002,5.080002,144,0,18,20,-2,2,1,-1,0,0,0,1,0,0,-1,1,294,245,49,-49
Josh Emmett,Yair Rodriguez,Yair Rodriguez,2023-02-11,0,1,7,-7,4.5,4,-12.7,12.7,0,0,-2.539993,2.539993,181,0,22,20,2,-2,0.5,-0.5,3,1,1,1,2,-2,0,0,238,210,28,-28
Kailin Curran,Yan Xiaonan,Yan Xiaonan,2017-11-25,0,1,-2,2,0.8,5.666667,-2.540009,2.540009,0,0,5.080002,-5.080002,463,3,9,20,-11,11,-4.86666649580002,4.86666649580002,0,0,1,0,0,0,1,-1,357,0,357,-357
Viviane Pereira,Yan Xiaonan,Yan Xiaonan,2018-06-23,0,1,-5,5,6.5,5.666667,-10.16,10.16,0,0,0,0,0,0,15,20,-5,5,0.833333492279053,-0.833333492279053,0,1,0,0,-1,1,0,0,224,210,14,-14
Syuri Kondo,Yan Xiaonan,Yan Xiaonan,2018-11-24,0,1,0,0,2,5.666667,-2.540009,2.540009,0,0,7.619995,-7.619995,0,0,9,20,-11,11,-3.66666650772095,3.66666650772095,0,2,0,0,-2,2,0,0,0,154,-154,154
Angela Hill,Yan Xiaonan,Yan Xiaonan,2019-06-08,0,1,5,-5,1.153846,5.666667,-5.080002,5.080002,0,0,2.539993,-2.539993,55,111,28,20,8,-8,-4.51282036304474,4.51282036304474,0,3,0,0,-3,3,0,0,77,196,-119,119
Karolina Kowalkiewicz,Yan Xiaonan,Yan Xiaonan,2020-02-22,0,1,4,-4,2.142857,5.666667,-5.080002,5.080002,0,0,2.539993,-2.539993,104,307,22,20,2,-2,-3.5238094329834,3.5238094329834,0,4,0,0,-4,4,0,0,329,259,70,-70
Claudia Gadelha,Yan Xiaonan,Yan Xiaonan,2020-11-07,0,1,0,0,3.6,5.666667,-2.540009,2.540009,0,0,0,0,406,19,23,20,3,-3,-2.06666660308838,2.06666660308838,2,5,0,0,-3,3,0,0,175,259,-84,84
Carla Esparza,Yan Xiaonan,Carla Esparza,2021-05-22,1,0,2,-2,2.857143,5.666667,-10.16,10.16,0,0,0,0,438,0,27,20,7,-7,-2.8095235824585,2.8095235824585,4,6,2,0,-2,2,2,-2,301,196,105,-105
Marina Rodriguez,Yan Xiaonan,Marina Rodriguez,2022-03-05,1,0,2,-2,5.666667,5.666667,2.539993,-2.539993,0,0,5.080002,-5.080002,41,93,20,20,0,0,0,0,2,0,0,1,2,-2,-1,1,301,287,14,-14
Mackenzie Dern,Yan Xiaonan,Yan Xiaonan,2022-10-01,0,1,-4,4,4.333333,5.666667,-2.540009,2.540009,0,0,0,0,559,251,16,20,-4,4,-1.33333301544189,1.33333301544189,1,0,0,1,1,-1,-1,1,175,210,-35,35
Jessica Andrade,Yan Xiaonan,Yan Xiaonan,2023-05-06,0,1,-2,2,2,5.666667,-10.16,10.16,0,0,-2.540009,2.540009,0,2,36,20,16,-16,-3.66666650772095,3.66666650772095,0,1,3,1,-1,1,2,-2,77,217,-140,140
Cristiane Justino,Yana Santos,Cristiane Justino,2018-03-03,1,0,4,-4,10.5,1.75,5.080002,-5.080002,10,-10,0,0,21,141,23,22,1,-1,8.75,-8.75,2,0,0,0,2,-2,0,0,525,0,525,-525
Lina Lansberg,Yana Santos,Yana Santos,2018-10-06,0,1,8,-8,1.25,1.75,2.539993,-2.539993,0,0,-7.619995,7.619995,18,593,18,22,-4,4,-0.5,0.5,2,0,0,1,2,-2,-1,1,132,217,-85,85
Marion Reneau,Yana Santos,Yana Santos,2019-03-09,0,1,12,-12,1.125,1.75,0,0,0,0,0,0,20,171,17,22,-5,5,-0.625,0.625,0,1,0,1,-1,1,-1,1,238,154,84,-84
Aspen Ladd,Yana Santos,Aspen Ladd,2019-12-07,1,0,-6,6,3,1.75,0,0,0,0,-5.080002,5.080002,247,232,12,22,-10,10,1.25,-1.25,1,2,0,1,-1,1,-1,1,777,273,504,-504
Irene Aldana,Yana Santos,Irene Aldana,2021-07-10,1,0,2,-2,2,1.75,7.619995,-7.619995,0,0,0,0,84,11,21,22,-1,1,0.25,-0.25,0,0,0,2,0,0,-2,2,280,581,-301,301
Holly Holm,Yana Santos,Holly Holm,2023-03-25,1,0,8,-8,2.142857,1.75,5.080002,-5.080002,0,0,2.539993,-2.539993,589,79,22,22,0,0,0.392857074737549,-0.392857074737549,0,0,1,3,0,0,-2,2,308,623,-315,315
Karol Rosa,Yana Santos,Karol Rosa,2023-07-01,1,0,-5,5,3.4,1.75,-2.539993,2.539993,10,-10,-2.540009,2.540009,41,233,22,22,0,0,1.65000009536743,-1.65000009536743,0,0,0,3,0,0,-3,3,0,98,-98,98
Rustam Khabilov,Yancy Medeiros,Rustam Khabilov,2013-04-27,1,0,1,-1,6,1.875,-5.080002,5.080002,0,0,-5.080002,5.080002,17,0,28,23,5,-5,4.125,-4.125,1,0,0,0,1,-1,0,0,133,0,133,-133
Damon Jackson,Yancy Medeiros,Yancy Medeiros,2014-08-30,0,1,0,0,3.666667,1.875,2.539993,-2.539993,-10,10,-10.16,10.16,139,39,28,23,5,-5,1.79166674613953,-1.79166674613953,0,0,0,1,0,0,-1,1,0,490,-490,490
John Makdessi,Yancy Medeiros,Yancy Medeiros,2015-12-12,0,1,2,-2,2,1.875,-5.080002,5.080002,0,0,-17.78,17.78,0,14,27,23,4,-4,0.125,-0.125,0,1,0,1,-1,1,-1,1,679,469,210,-210
Donald Cerrone,Yancy Medeiros,Donald Cerrone,2018-02-18,1,0,4,-4,2.117647,1.875,7.619995,-7.619995,0,0,-5.080002,5.080002,21,17,53,23,30,-30,0.242647171020508,-0.242647171020508,0,2,4,1,-2,2,3,-3,120,799,-679,679
Gregor Gillespie,Yancy Medeiros,Gregor Gillespie,2019-01-19,1,0,1,-1,14,1.875,-7.62001,7.62001,0,0,-10.16,10.16,528,7,15,23,-8,8,12.125,-12.125,4,0,0,2,4,-4,-2,2,232,335,-103,103
Damir Hadzovic,Yancy Medeiros,Damir Hadzovic,2021-06-26,1,0,1,-1,2,1.875,-2.540009,2.540009,0,0,-12.7,12.7,114,219,21,23,-2,2,0.125,-0.125,0,0,1,3,0,0,-2,2,469,889,-420,420
Royston Wee,Yao Zhikui,Royston Wee,2014-08-23,1,0,4,-4,4,0.5,5.079987,-5.079987,10,-10,7.619995,-7.619995,469,237,5,6,-1,1,3.5,-3.5,0,0,0,0,0,0,0,0,0,0,0,0
Nolan Ticman,Yao Zhikui,Yao Zhikui,2015-05-16,0,1,2,-2,1.333333,0.5,2.539993,-2.539993,0,0,7.440002,-7.440002,98,39,7,6,1,-1,0.833333373069763,-0.833333373069763,0,0,0,0,0,0,0,0,0,266,-266,266
Fredy Serrano,Yao Zhikui,Fredy Serrano,2015-11-28,1,0,12,-12,1.5,0.5,-5.080002,5.080002,0,0,2.540009,-2.540009,4,2,5,6,-1,1,1,-1,1,1,0,0,0,0,0,0,252,196,56,-56
Jenel Lausa,Yao Zhikui,Jenel Lausa,2016-11-26,1,0,3,-3,1.4,0.5,0,0,0,0,10.16,-10.16,51,115,12,6,6,-6,0.899999976158142,-0.899999976158142,0,0,0,1,0,0,-1,1,0,364,-364,364
Chad Mendes,Yaotzin Meza,Chad Mendes,2012-12-14,1,0,-4,4,3.6,1.909091,-7.619995,7.619995,0,0,-12.7,12.7,2,0,23,32,-9,9,1.69090902805328,-1.69090902805328,2,0,0,0,2,-2,0,0,496,0,496,-496
John Albert,Yaotzin Meza,Yaotzin Meza,2013-07-27,0,1,-6,6,1.2,1.909091,-2.539993,2.539993,-10,10,-7.619995,7.619995,82,341,11,32,-21,21,-0.709090828895569,0.709090828895569,0,0,0,1,0,0,-1,1,231,225,6,-6
Arnold Allen,Yaotzin Meza,Arnold Allen,2016-02-27,1,0,-13,13,9.5,1.909091,-2.539993,2.539993,0,0,-2.539993,2.539993,252,122,21,32,-11,11,7.59090912342072,-7.59090912342072,1,1,0,1,0,0,-1,1,252,945,-693,693
Joseph Benavidez,Yasuhiro Urushitani,Joseph Benavidez,2012-03-02,1,0,-8,8,3.5,2.625,-2.540009,2.540009,0,0,5.100006,-5.100006,171,0,36,29,7,-7,0.875,-0.875,2,0,0,0,2,-2,0,0,201,0,201,-201
John Lineker,Yasuhiro Urushitani,John Lineker,2012-11-10,1,0,-14,14,3.444444,2.625,-5.080002,5.080002,10,-10,10.17999,-10.17999,28,0,40,29,11,-11,0.819444417953491,-0.819444417953491,0,0,0,1,0,0,-1,1,0,253,-253,253
Denise Gomes,Yazmin Jauregui,Denise Gomes,2023-07-08,1,0,-1,1,4,10,-2.540009,2.540009,0,0,-2.539993,2.539993,10,0,10,11,-1,1,-6,6,0,0,0,0,0,0,0,0,294,0,294,-294
Ronny Markes,Yoel Romero,Yoel Romero,2013-11-06,0,1,-11,11,3.4,2.6,2.539993,-2.539993,0,0,5.080002,-5.080002,48,49,22,18,4,-4,0.800000190734863,-0.800000190734863,2,0,0,0,2,-2,0,0,630,0,630,-630
Derek Brunson,Yoel Romero,Yoel Romero,2014-01-15,0,1,-6,6,2.555556,2.6,2.539993,-2.539993,0,0,10.16,-10.16,176,53,32,18,14,-14,-4.44443225860596e-02,4.44443225860596e-02,2,1,0,0,1,-1,0,0,70,70,0,0
Tim Kennedy,Yoel Romero,Yoel Romero,2014-09-27,0,1,-2,2,3,2.6,-2.540009,2.540009,0,0,2.540009,-2.540009,1,126,24,18,6,-6,0.400000095367432,-0.400000095367432,1,2,0,0,-1,1,0,0,325,255,70,-70
Lyoto Machida,Yoel Romero,Yoel Romero,2015-06-27,0,1,-1,1,3,2.6,2.539993,-2.539993,0,0,2.540009,-2.540009,0,5,32,18,14,-14,0.400000095367432,-0.400000095367432,0,3,1,0,-3,3,1,-1,70,273,-203,203
Luke Rockhold,Yoel Romero,Yoel Romero,2018-02-10,0,1,-7,7,2.666667,2.6,7.619995,-7.619995,0,0,10.16,-10.16,0,8,22,18,4,-4,6.6666841506958e-02,-6.6666841506958e-02,1,4,0,0,-3,3,0,0,791,959,-168,168
Paulo Costa,Yoel Romero,Paulo Costa,2019-08-17,1,0,-14,14,7,2.6,2.539993,-2.539993,0,0,-2.539993,2.539993,6,13,16,18,-2,2,4.40000009536743,-4.40000009536743,3,5,0,0,-2,2,0,0,406,553,-147,147
Israel Adesanya,Yoel Romero,Israel Adesanya,2020-03-07,1,0,-12,12,8,2.6,10.15999,-10.15999,0,0,17.78,-17.78,0,0,27,18,9,-9,5.40000009536743,-5.40000009536743,7,0,0,0,7,-7,0,0,154,203,-49,49
Gabe Green,Yohan Lainesse,Gabe Green,2022-04-30,1,0,-1,1,2.2,4.5,-7.619995,7.619995,0,0,-7.619995,7.619995,41,97,16,11,5,-5,-2.29999995231628,2.29999995231628,1,0,0,0,1,-1,0,0,441,0,441,-441
David Abbott,Yoji Anjo,David Abbott,1997-12-21,1,0,,,0.6666667,0,2.540009,-2.540009,60,-60,-1.449997,1.449997,0,0,25,5,20,-20,0.666666686534882,-0.666666686534882,0,0,1,0,0,0,1,-1,65,0,65,-65
Jarjis Danho,Yorgan De Castro,Jarjis Danho,2021-04-10,1,0,3,-3,7,2,7.619995,-7.619995,15,-15,0,0,40,8,8,9,-1,1,5,-5,0,0,0,0,0,0,0,0,1869,0,1869,-1869
Wallid Ismail,Yoshiki Takahashi,Yoshiki Takahashi,1997-02-07,0,1,1,-1,3,1.111111,-10.16,10.16,6,-6,-3,3,0,0,12,57,-45,45,1.88888883590698,-1.88888883590698,0,0,0,0,0,0,0,0,0,0,0,0
Hakeem Dawodu,Yoshinori Horie,Hakeem Dawodu,2019-07-27,1,0,4,-4,3.25,4,0,0,0,0,7.619995,-7.619995,79,2,17,10,7,-7,-0.75,0.75,0,0,0,0,0,0,0,0,497,0,497,-497
War Machine,Yoshiyuki Yoshida,Yoshiyuki Yoshida,2008-05-24,0,1,-8,8,2.8,2,0,0,0,0,5.199997,-5.199997,0,38,19,27,-8,8,0.799999952316284,-0.799999952316284,1,0,0,0,1,-1,0,0,168,0,168,-168
Josh Koscheck,Yoshiyuki Yoshida,Josh Koscheck,2008-12-10,1,0,-3,3,1.545455,2,-2.539993,2.539993,0,0,7.619995,-7.619995,0,0,28,27,1,-1,-0.454545497894287,0.454545497894287,1,1,0,0,0,0,0,0,158,200,-42,42
Brandon Wolff,Yoshiyuki Yoshida,Yoshiyuki Yoshida,2009-05-23,0,1,-2,2,1.4,2,-5.080002,5.080002,0,0,0.1999969,-0.1999969,32,67,12,27,-15,15,-0.600000023841858,0.600000023841858,0,0,0,1,0,0,-1,1,0,164,-164,164
Anthony Johnson,Yoshiyuki Yoshida,Anthony Johnson,2009-10-24,1,0,-10,10,3.666667,2,7.62001,-7.62001,35,-35,20.31999,-20.31999,0,0,28,27,1,-1,1.66666674613953,-1.66666674613953,2,1,0,1,1,-1,-1,1,570,154,416,-416
Mike Guymon,Yoshiyuki Yoshida,Mike Guymon,2010-05-08,1,0,0,0,2.5,2,2.540009,-2.540009,0,0,10.16,-10.16,439,301,21,27,-6,6,0.5,-0.5,0,0,0,2,0,0,-2,2,117,196,-79,79
Austin Lingo,Youssef Zalal,Youssef Zalal,2020-02-08,0,1,2,-2,3,2,0,0,10,-10,-5.080002,5.080002,85,398,12,15,-3,3,1,-1,0,0,0,0,0,0,0,0,0,0,0,0
Jordan Griffin,Youssef Zalal,Youssef Zalal,2020-06-27,0,1,7,-7,2,2,0,0,10,-10,2.539993,-2.539993,334,263,27,15,12,-12,0,0,0,1,0,0,-1,1,0,0,287,140,147,-147
Peter Barrett,Youssef Zalal,Youssef Zalal,2020-08-08,0,1,10,-10,2.2,2,0,0,10,-10,2.539993,-2.539993,94,414,16,15,1,-1,0.200000047683716,-0.200000047683716,0,2,0,0,-2,2,0,0,0,42,-42,42
Ilia Topuria,Youssef Zalal,Ilia Topuria,2020-10-10,1,0,-1,1,14,2,-7.62001,7.62001,10,-10,-7.62001,7.62001,482,171,14,15,-1,1,12,-12,0,3,0,0,-3,3,0,0,0,63,-63,63
SeungWoo Choi,Youssef Zalal,SeungWoo Choi,2021-02-06,1,0,4,-4,1.833333,2,5.080002,-5.080002,10,-10,5.080002,-5.080002,219,269,17,15,2,-2,-0.166666626930237,0.166666626930237,1,0,0,0,1,-1,0,0,413,119,294,-294
Sean Woodson,Youssef Zalal,Sean Woodson,2021-06-05,1,0,4,-4,10,2,10.16,-10.16,10,-10,15.23999,-15.23999,63,381,11,15,-4,4,8,-8,0,0,0,0,0,0,0,0,0,119,-119,119
Alexandre Dantas,Yuki Kondo,Yuki Kondo,2000-09-22,0,1,-4,4,0,1.818182,7.62001,-7.62001,55,-55,9,-9,387,258,3,93,-90,90,-1.81818187236786,1.81818187236786,0,0,0,0,0,0,0,0,0,0,0,0
Dean Lister,Yuki Sasaki,Dean Lister,2006-08-17,1,0,1,-1,1.857143,1.136364,-2.540009,2.540009,0,0,-0.5,0.5,348,277,20,47,-27,27,0.720779180526733,-0.720779180526733,1,0,0,0,1,-1,0,0,82,0,82,-82
Joe Moreira,Yuri Vaulin,Joe Moreira,1997-07-27,1,0,,,1,0,-12.7,12.7,-2,2,-13,13,0,0,4,1,3,-3,1,-1,0,0,0,0,0,0,0,0,527,0,527,-527
Nah-Shon Burrell,Yuri Villefort,Nah-Shon Burrell,2013-02-23,1,0,2,-2,2.142857,2,-2.540009,2.540009,0,0,-2.419998,2.419998,139,171,22,15,7,-7,0.142857074737549,-0.142857074737549,0,0,0,0,0,0,0,0,0,0,0,0
Sean Spencer,Yuri Villefort,Sean Spencer,2013-09-04,1,0,4,-4,2,2,-5.080002,5.080002,0,0,2.540009,-2.540009,0,37,18,15,3,-3,0,0,0,0,0,0,0,0,0,0,0,193,-193,193
Adam Fugitt,Yusaku Kinoshita,Adam Fugitt,2023-02-04,1,0,12,-12,2.25,2,2.539993,-2.539993,0,0,15.24001,-15.24001,173,1,13,9,4,-4,0.25,-0.25,0,0,1,0,0,0,1,-1,189,0,189,-189
Billy Goff,Yusaku Kinoshita,Billy Goff,2023-08-26,1,0,2,-2,4.5,2,-5.080002,5.080002,0,0,2.540009,-2.540009,5,0,11,9,2,-2,2.5,-2.5,0,0,0,1,0,0,-1,1,0,203,-203,203
Alan Belcher,Yushin Okami,Yushin Okami,2006-08-26,0,1,-3,3,2.25,2.833333,0,0,15,-15,0,0,100,385,26,46,-20,20,-0.583333253860474,0.583333253860474,0,0,0,0,0,0,0,0,0,0,0,0
Rich Franklin,Yushin Okami,Rich Franklin,2007-06-16,1,0,7,-7,4.142857,2.833333,-2.540009,2.540009,15,-15,2.539993,-2.539993,178,117,36,46,-10,10,1.30952382087708,-1.30952382087708,1,1,1,0,0,0,1,-1,105,294,-189,189
Jason MacDonald,Yushin Okami,Yushin Okami,2007-10-20,0,1,6,-6,1.5625,2.833333,2.539993,-2.539993,15,-15,12.7,-12.7,133,532,41,46,-5,5,-1.27083325386047,1.27083325386047,1,0,0,0,1,-1,0,0,126,126,0,0
Dean Lister,Yushin Okami,Yushin Okami,2008-12-27,0,1,5,-5,1.857143,2.833333,-2.540009,2.540009,15,-15,0,0,15,536,20,46,-26,26,-0.976190447807312,0.976190447807312,1,1,0,0,0,0,0,0,364,434,-70,70
Lucio Linhares,Yushin Okami,Yushin Okami,2010-03-31,0,1,8,-8,2.375,2.833333,0,0,15,-15,-2.5,2.5,0,151,27,46,-19,19,-0.458333253860474,0.458333253860474,0,2,0,0,-2,2,0,0,109,459,-350,350
Mark Munoz,Yushin Okami,Yushin Okami,2010-08-01,0,1,3,-3,2.333333,2.833333,-5.080002,5.080002,15,-15,-10.16,10.16,88,302,20,46,-26,26,-0.5,0.5,0,3,0,0,-3,3,0,0,0,123,-123,123
Nate Marquardt,Yushin Okami,Yushin Okami,2010-11-13,0,1,2,-2,1.842105,2.833333,-5.080002,5.080002,15,-15,-2.539993,2.539993,172,249,54,46,8,-8,-0.991227984428406,0.991227984428406,1,4,1,0,-3,3,1,-1,59,104,-45,45
Tim Boetsch,Yushin Okami,Tim Boetsch,2012-02-25,1,0,1,-1,1.615385,2.833333,-5.080002,5.080002,15,-15,-2.539993,2.539993,7,241,34,46,-12,12,-1.21794867515564,1.21794867515564,2,5,1,0,-3,3,1,-1,154,469,-315,315
Alan Belcher,Yushin Okami,Yushin Okami,2012-12-29,0,1,-3,3,2.25,2.833333,0,0,15,-15,0,0,203,481,26,46,-20,20,-0.583333253860474,0.583333253860474,6,0,1,1,6,-6,0,0,238,308,-70,70
Hector Lombard,Yushin Okami,Yushin Okami,2013-03-02,0,1,4,-4,3.4,2.833333,-12.70001,12.70001,15,-15,-10.16,10.16,230,261,44,46,-2,2,0.566666841506958,-0.566666841506958,1,1,0,1,0,0,-1,1,78,63,15,-15
Dhiego Lima,Yushin Okami,Yushin Okami,2018-04-14,0,1,-7,7,1.888889,2.833333,0,0,0,0,0,0,5,750,26,46,-20,20,-0.944444417953491,0.944444417953491,0,2,1,1,-2,2,0,0,281,1869,-1588,1588
Aleksei Kunchenko,Yushin Okami,Aleksei Kunchenko,2018-12-01,1,0,-3,3,10,2.833333,-15.24001,15.24001,0,0,-12.7,12.7,78,166,22,46,-24,24,7.16666674613953,-7.16666674613953,0,3,0,1,-3,3,-1,1,0,231,-231,231
Nick Hein,Yusuke Kasuya,Nick Hein,2015-09-26,1,0,6,-6,2.8,3,-2.539993,2.539993,0,0,-5.360001,5.360001,2,3,19,12,7,-7,-0.200000047683716,0.200000047683716,1,0,0,0,1,-1,0,0,98,0,98,-98
Roland Delorme,Yuta Sasaki,Yuta Sasaki,2014-08-23,0,1,6,-6,1.8,3.5,-2.540009,2.540009,10,-10,0,0,0,32,14,27,-13,13,-1.70000004768372,1.70000004768372,0,0,0,0,0,0,0,0,70,0,70,-70
Leandro Issa,Yuta Sasaki,Leandro Issa,2014-12-20,1,0,6,-6,2.166667,3.5,-7.62001,7.62001,10,-10,-5.080002,5.080002,412,35,19,27,-8,8,-1.33333325386047,1.33333325386047,1,1,0,0,0,0,0,0,167,119,48,-48
Taylor Lapilus,Yuta Sasaki,Taylor Lapilus,2015-06-20,1,0,-2,2,6.333333,3.5,-10.16,10.16,10,-10,5.080002,-5.080002,140,52,22,27,-5,5,2.83333349227905,-2.83333349227905,1,0,0,0,1,-1,0,0,70,182,-112,112
Willie Gates,Yuta Sasaki,Yuta Sasaki,2016-05-08,0,1,3,-3,1.714286,3.5,-5.080002,5.080002,0,0,2.540009,-2.540009,362,45,19,27,-8,8,-1.78571426868439,1.78571426868439,0,0,1,1,0,0,0,0,274,323,-49,49
Wilson Reis,Yuta Sasaki,Wilson Reis,2017-02-11,1,0,5,-5,2.3,3.5,-15.24001,15.24001,0,0,-15.23999,15.23999,526,68,33,27,6,-6,-1.20000004768372,1.20000004768372,2,1,0,1,1,-1,-1,1,196,279,-83,83
Jussier Formiga,Yuta Sasaki,Jussier Formiga,2017-09-22,1,0,5,-5,2.875,3.5,-12.7,12.7,0,0,-10.16,10.16,93,0,31,27,4,-4,-0.625,0.625,4,0,0,1,4,-4,-1,1,363,223,140,-140
Jenel Lausa,Yuta Sasaki,Yuta Sasaki,2018-06-23,0,1,1,-1,1.4,3.5,-12.7,12.7,0,0,-7.619995,7.619995,12,411,12,27,-15,15,-2.10000002384186,2.10000002384186,0,0,0,1,0,0,-1,1,217,274,-57,57
Alexandre Pantoja,Yuta Sasaki,Alexandre Pantoja,2018-11-17,1,0,-1,1,5.2,3.5,-12.7,12.7,0,0,-10.16,10.16,38,84,31,27,4,-4,1.69999980926514,-1.69999980926514,2,1,0,1,1,-1,-1,1,489,147,342,-342
Rich Clementi,Yves Edwards,Yves Edwards,2003-02-28,0,1,0,0,1.956522,1.909091,0,0,0,0,-2.539993,2.539993,207,212,68,64,4,-4,4.74308729171753e-02,-4.74308729171753e-02,0,0,0,0,0,0,0,0,0,0,0,0
Nick Agallar,Yves Edwards,Yves Edwards,2003-11-21,0,1,-3,3,4,1.909091,-2.539993,2.539993,0,0,-9.699997,9.699997,67,11,30,64,-34,34,2.09090912342072,-2.09090912342072,0,1,0,0,-1,1,0,0,0,266,-266,266
Daron Cruickshank,Yves Edwards,Daron Cruickshank,2013-07-27,1,0,-8,8,1.8,1.909091,-2.539993,2.539993,0,0,-2.539993,2.539993,0,0,28,64,-36,36,-0.109090924263,0.109090924263,0,2,0,0,-2,2,0,0,133,3536,-3403,3403
Akbarh Arreola,Yves Edwards,Akbarh Arreola,2014-11-22,1,0,-7,7,2.090909,1.909091,2.540009,-2.540009,0,0,-5.080002,5.080002,45,0,34,64,-30,30,0.181818127632141,-0.181818127632141,0,0,0,0,0,0,0,0,0,483,-483,483
Pablo Garza,Yves Jabouin,Pablo Garza,2011-04-30,1,0,-4,4,3,1.818182,15.24001,-15.24001,10,-10,12.7,-12.7,26,40,16,31,-15,15,1.18181812763214,-1.18181812763214,1,0,0,0,1,-1,0,0,147,0,147,-147
Jeff Hougland,Yves Jabouin,Yves Jabouin,2012-05-15,0,1,1,-1,1.666667,1.818182,0,0,0,0,0,0,11,301,16,31,-15,15,-0.151515245437622,0.151515245437622,1,0,0,0,1,-1,0,0,318,381,-63,63
Mike Easton,Yves Jabouin,Yves Jabouin,2014-06-14,0,1,-5,5,2.166667,1.818182,-2.539993,2.539993,0,0,5.080002,-5.080002,175,411,19,31,-12,12,0.348484873771667,-0.348484873771667,0,1,0,0,-1,1,0,0,434,760,-326,326
Thomas Almeida,Yves Jabouin,Thomas Almeida,2015-04-25,1,0,-12,12,4.4,1.818182,0,0,10,-10,5.080002,-5.080002,0,23,27,31,-4,4,2.58181822299957,-2.58181822299957,1,2,0,0,-1,1,0,0,168,315,-147,147
Felipe Arantes,Yves Jabouin,Felipe Arantes,2015-08-23,1,0,-9,9,1.8,1.818182,2.540009,-2.540009,0,0,12.7,-12.7,15,218,28,31,-3,3,-1.81819200515747e-02,1.81819200515747e-02,0,0,0,1,0,0,-1,1,302,120,182,-182
Kyle Bochniak,Zabit Magomedsharipov,Zabit Magomedsharipov,2018-04-07,0,1,4,-4,1.6,18,-15.24001,15.24001,0,0,-7.619995,7.619995,40,228,13,19,-6,6,-16.3999999761581,16.3999999761581,1,0,0,0,1,-1,0,0,77,0,77,-77
Brandon Davis,Zabit Magomedsharipov,Zabit Magomedsharipov,2018-09-08,0,1,1,-1,1.4,18,-7.619995,7.619995,-10,10,-2.539993,2.539993,0,240,24,19,5,-5,-16.6000000238419,16.6000000238419,1,1,0,0,0,0,0,0,202,154,48,-48
Calvin Kattar,Zabit Magomedsharipov,Zabit Magomedsharipov,2019-11-09,0,1,3,-3,3.285714,18,-5.080002,5.080002,0,0,-2.539993,2.539993,0,52,30,19,11,-11,-14.7142856121063,14.7142856121063,1,2,0,0,-1,1,0,0,154,427,-273,273
Modestas Bukauskas,Zac Pauga,Modestas Bukauskas,2023-06-17,1,0,-6,6,3,3.5,2.539993,-2.539993,0,0,5.080002,-5.080002,80,137,20,9,11,-11,-0.5,0.5,1,0,2,0,1,-1,2,-2,126,0,126,-126
Scott Jorgensen,Zach Makovsky,Zach Makovsky,2013-12-14,0,1,1,-1,1.25,2.5,2.540009,-2.540009,10,-10,5.080002,-5.080002,255,159,27,28,-1,1,-1.25,1.25,0,0,1,0,0,0,1,-1,554,0,554,-554
Jussier Formiga,Zach Makovsky,Jussier Formiga,2014-08-16,1,0,-2,2,2.875,2.5,2.540009,-2.540009,0,0,7.619995,-7.619995,282,247,31,28,3,-3,0.375,-0.375,1,1,0,0,0,0,0,0,146,245,-99,99
Tim Elliott,Zach Makovsky,Zach Makovsky,2015-02-14,0,1,-3,3,1.666667,2.5,7.619995,-7.619995,0,0,5.080002,-5.080002,75,599,32,28,4,-4,-0.833333373069763,0.833333373069763,2,0,0,0,2,-2,0,0,532,182,350,-350
John Dodson,Zach Makovsky,John Dodson,2015-05-23,1,0,-2,2,1.833333,2.5,-2.539993,2.539993,10,-10,5.080002,-5.080002,38,9,34,28,6,-6,-0.666666626930237,0.666666626930237,2,1,0,0,1,-1,0,0,350,98,252,-252
Joseph Benavidez,Zach Makovsky,Joseph Benavidez,2016-02-06,1,0,-1,1,3.5,2.5,0,0,0,0,2.540009,-2.540009,35,79,36,28,8,-8,1,-1,3,0,1,0,3,-3,1,-1,259,259,0,0
Ben Alloway,Zak Cummings,Zak Cummings,2013-08-28,0,1,3,-3,2.25,3.571429,-2.540009,2.540009,-35,35,2.539993,-2.539993,0,180,26,32,-6,6,-1.32142853736877,1.32142853736877,0,0,0,0,0,0,0,0,144,0,144,-144
Yan Cabral,Zak Cummings,Zak Cummings,2014-05-10,0,1,1,-1,4.333333,3.571429,-2.540009,2.540009,-50,50,-5.080002,5.080002,247,393,16,32,-16,16,0.761904954910278,-0.761904954910278,1,1,0,0,0,0,0,0,213,255,-42,42
Nathan Coy,Zak Cummings,Zak Cummings,2017-04-15,0,1,6,-6,2.142857,3.571429,-5.080002,5.080002,-35,35,-15.24001,15.24001,5,11,22,32,-10,10,-1.42857146263123,1.42857146263123,1,2,0,0,-1,1,0,0,419,1071,-652,652
Omari Akhmedov,Zak Cummings,Omari Akhmedov,2019-09-07,1,0,-4,4,3.5,3.571429,0,0,-20,20,-5.080002,5.080002,219,0,27,32,-5,5,-7.14285373687744e-02,7.14285373687744e-02,3,3,2,0,0,0,2,-2,182,875,-693,693
Joshua Burkman,Zak Ottow,Zak Ottow,2016-10-01,0,1,7,-7,1.75,2.428571,-2.539993,2.539993,0,0,0,0,76,9,44,24,20,-20,-0.678571462631226,0.678571462631226,0,0,1,0,0,0,1,-1,125,0,125,-125
Sergio Moraes,Zak Ottow,Sergio Moraes,2016-11-19,1,0,5,-5,2.333333,2.428571,2.540009,-2.540009,0,0,0,0,244,0,20,24,-4,4,-9.5238208770752e-02,9.5238208770752e-02,0,1,0,0,-1,1,0,0,0,49,-49,49
Kiichi Kunimoto,Zak Ottow,Zak Ottow,2017-06-10,0,1,6,-6,2.571429,2.428571,-2.539993,2.539993,0,0,-2.540009,2.540009,420,142,25,24,1,-1,0.142857074737549,-0.142857074737549,0,0,0,0,0,0,0,0,847,203,644,-644
Li Jingliang,Zak Ottow,Li Jingliang,2017-11-25,1,0,-1,1,2.375,2.428571,2.540009,-2.540009,0,0,-2.540009,2.540009,13,0,27,24,3,-3,-5.35714626312256e-02,5.35714626312256e-02,2,1,0,0,1,-1,0,0,301,168,133,-133
Sage Northcutt,Zak Ottow,Sage Northcutt,2018-07-14,1,0,-9,9,5.5,2.428571,2.540009,-2.540009,0,0,-2.540009,2.540009,93,316,13,24,-11,11,3.07142853736877,-3.07142853736877,3,0,0,1,3,-3,-1,1,245,231,14,-14
Dwight Grant,Zak Ottow,Zak Ottow,2018-12-15,0,1,3,-3,1.833333,2.428571,5.080002,-5.080002,15,-15,10.15999,-10.15999,20,174,17,24,-7,7,-0.595238089561462,0.595238089561462,0,0,0,2,0,0,-2,2,0,154,-154,154
Alex Morono,Zak Ottow,Alex Morono,2019-03-09,1,0,-4,4,2.875,2.428571,0,0,0,0,0,0,31,6,31,24,7,-7,0.446428537368774,-0.446428537368774,0,1,0,2,-1,1,-2,2,533,84,449,-449
Megan Anderson,Zarah Fairn,Megan Anderson,2019-10-05,1,0,-6,6,2.2,1,10.16,-10.16,10,-10,0,0,203,23,16,12,4,-4,1.20000004768372,-1.20000004768372,0,0,0,0,0,0,0,0,140,0,140,-140
Jacqueline Cavalcanti,Zarah Fairn,Jacqueline Cavalcanti,2023-09-02,1,0,-13,13,6,1,0,0,0,0,-5.080002,5.080002,8,4,7,12,-5,5,5,-5,0,0,0,0,0,0,0,0,0,1428,-1428,1428
Max Griffin,Zelim Imadaev,Max Griffin,2019-04-13,1,0,9,-9,1.9,2.666667,-2.540009,2.540009,0,0,0,0,297,206,29,11,18,-18,-0.766666769981384,0.766666769981384,0,0,0,0,0,0,0,0,280,0,280,-280
Raulian Paiva,Zhalgas Zhumagulov,Raulian Paiva,2020-07-11,1,0,-7,7,4.2,1.555556,10.16,-10.16,10,-10,7.619995,-7.619995,43,29,26,23,3,-3,2.64444422721863,-2.64444422721863,0,0,0,0,0,0,0,0,0,0,0,0
Amir Albazi,Zhalgas Zhumagulov,Amir Albazi,2021-01-23,1,0,-5,5,17,1.555556,2.540009,-2.540009,0,0,5.080002,-5.080002,218,27,18,23,-5,5,15.4444444179535,-15.4444444179535,1,0,0,0,1,-1,0,0,189,196,-7,7
Jerome Rivera,Zhalgas Zhumagulov,Zhalgas Zhumagulov,2021-07-10,0,1,-6,6,1.666667,1.555556,15.24001,-15.24001,0,0,15.24001,-15.24001,0,12,16,23,-7,7,0.111111044883728,-0.111111044883728,0,0,0,0,0,0,0,0,0,168,-168,168
Manel Kape,Zhalgas Zhumagulov,Manel Kape,2021-12-04,1,0,-5,5,3.166667,1.555556,2.540009,-2.540009,0,0,5.080002,-5.080002,3,0,25,23,2,-2,1.61111116409302,-1.61111116409302,1,1,0,0,0,0,0,0,119,147,-28,28
Jeff Molina,Zhalgas Zhumagulov,Jeff Molina,2022-06-04,1,0,-9,9,5.5,1.555556,5.080002,-5.080002,0,0,7.619995,-7.619995,14,332,13,23,-10,10,3.94444441795349,-3.94444441795349,0,0,0,1,0,0,-1,1,0,182,-182,182
Charles Johnson,Zhalgas Zhumagulov,Charles Johnson,2022-11-19,1,0,-3,3,2.6,1.555556,12.7,-12.7,0,0,10.16,-10.16,57,63,18,23,-5,5,1.04444432258606,-1.04444432258606,0,0,0,1,0,0,-1,1,119,168,-49,49
Joshua Van,Zhalgas Zhumagulov,Joshua Van,2023-06-24,1,0,-13,13,8,1.555556,2.540009,-2.540009,0,0,-2.539993,2.539993,1,70,9,23,-14,14,6.44444441795349,-6.44444441795349,0,0,0,1,0,0,-1,1,0,217,-217,217
Kajan Johnson,Zhang Lipeng,Kajan Johnson,2015-05-16,1,0,6,-6,1.769231,2.555556,0,0,0,0,10.16,-10.16,385,151,36,32,4,-4,-0.786324858665466,0.786324858665466,0,0,0,0,0,0,0,0,0,0,0,0
Jason Reinhardt,Zhang Tiequan,Zhang Tiequan,2011-02-26,0,1,9,-9,6.666667,3.75,-5.080002,5.080002,-20,20,-5.259995,5.259995,9,0,23,19,4,-4,2.91666650772095,-2.91666650772095,0,0,0,0,0,0,0,0,0,0,0,0
Darren Elkins,Zhang Tiequan,Darren Elkins,2011-10-08,1,0,-6,6,2.454545,3.75,5.080002,-5.080002,-10,10,5.080002,-5.080002,789,45,38,19,19,-19,-1.29545450210571,1.29545450210571,1,1,0,0,0,0,0,0,119,224,-105,105
Issei Tamura,Zhang Tiequan,Issei Tamura,2012-02-25,1,0,-6,6,1.25,3.75,-7.619995,7.619995,-20,20,-15.23999,15.23999,251,1,18,19,-1,1,-2.5,2.5,0,0,0,0,0,0,0,0,0,140,-140,140
Danielle Taylor,Zhang Weili,Zhang Weili,2018-08-04,0,1,0,0,2.25,8,-10.16,10.16,0,0,-7.62001,7.62001,0,48,13,27,-14,14,-5.75,5.75,0,0,0,0,0,0,0,0,0,0,0,0
Jessica Aguilar,Zhang Weili,Zhang Weili,2018-11-24,0,1,7,-7,2.5,8,-2.539993,2.539993,0,0,0,0,47,150,28,27,1,-1,-5.5,5.5,1,1,0,0,0,0,0,0,133,112,21,-21
Tecia Torres,Zhang Weili,Zhang Weili,2019-03-02,0,1,0,0,2.166667,8,-7.619995,7.619995,0,0,-7.62001,7.62001,68,280,19,27,-8,8,-5.83333325386047,5.83333325386047,1,2,0,0,-1,1,0,0,455,98,357,-357
Jessica Andrade,Zhang Weili,Zhang Weili,2019-08-31,0,1,-3,3,2,8,-7.619995,7.619995,0,0,-2.540009,2.540009,5,1,36,27,9,-9,-6,6,4,3,1,0,1,-1,1,-1,112,182,-70,70
Joanna Jedrzejczyk,Zhang Weili,Zhang Weili,2020-03-07,0,1,2,-2,3.2,8,5.080002,-5.080002,0,0,5.080002,-5.080002,60,74,21,27,-6,6,-4.79999995231628,4.79999995231628,1,4,1,0,-3,3,1,-1,147,189,-42,42
Rose Namajunas,Zhang Weili,Rose Namajunas,2021-04-24,1,0,-3,3,2,8,2.540009,-2.540009,10,-10,5.080002,-5.080002,3,0,18,27,-9,9,-6,6,3,5,0,0,-2,2,0,0,1470,413,1057,-1057
Rose Namajunas,Zhang Weili,Rose Namajunas,2021-11-06,1,0,-3,3,2,8,2.540009,-2.540009,10,-10,5.080002,-5.080002,420,217,18,27,-9,9,-6,6,4,0,0,1,4,-4,-1,1,196,196,0,0
Joanna Jedrzejczyk,Zhang Weili,Zhang Weili,2022-06-11,0,1,2,-2,3.2,8,5.080002,-5.080002,0,0,5.080002,-5.080002,0,169,21,27,-6,6,-4.79999995231628,4.79999995231628,0,0,1,1,0,0,0,0,826,217,609,-609
Carla Esparza,Zhang Weili,Zhang Weili,2022-11-12,0,1,2,-2,2.857143,8,-7.619995,7.619995,0,0,0,0,55,90,27,27,0,0,-5.14285707473755,5.14285707473755,6,1,2,1,5,-5,1,-1,189,154,35,-35
Amanda Lemos,Zhang Weili,Zhang Weili,2023-08-19,0,1,2,-2,4.333333,8,0,0,0,0,5.080002,-5.080002,34,967,16,27,-11,11,-3.66666650772095,3.66666650772095,3,2,1,1,1,-1,0,0,287,280,7,-7
Douglas Silva de Andrade,Zubaira Tukhugov,Zubaira Tukhugov,2014-02-15,0,1,5,-5,5.8,3.333333,-2.540009,2.540009,-20,20,0,0,0,43,34,26,8,-8,2.46666693687439,-2.46666693687439,0,0,0,0,0,0,0,0,0,0,0,0
Ernest Chavez,Zubaira Tukhugov,Zubaira Tukhugov,2014-10-04,0,1,8,-8,5,3.333333,0,0,-10,10,5.080002,-5.080002,0,7,12,26,-14,14,1.66666674613953,-1.66666674613953,0,1,0,0,-1,1,0,0,126,231,-105,105
Phillipe Nover,Zubaira Tukhugov,Zubaira Tukhugov,2015-12-10,0,1,7,-7,1.375,3.333333,2.539993,-2.539993,-10,10,10.16,-10.16,21,38,19,26,-7,7,-1.95833325386047,1.95833325386047,0,2,0,0,-2,2,0,0,0,432,-432,432
Renato Moicano,Zubaira Tukhugov,Renato Moicano,2016-05-14,1,0,1,-1,3.4,3.333333,7.619995,-7.619995,0,0,10.16,-10.16,5,114,22,26,-4,4,6.6666841506958e-02,-6.6666841506958e-02,1,3,0,0,-2,2,0,0,511,156,355,-355
Kevin Aguilar,Zubaira Tukhugov,Zubaira Tukhugov,2020-02-22,0,1,2,-2,3.4,3.333333,-2.540009,2.540009,0,0,12.7,-12.7,0,9,22,26,-4,4,6.6666841506958e-02,-6.6666841506958e-02,0,0,0,0,0,0,0,0,245,1379,-1134,1134
Hakeem Dawodu,Zubaira Tukhugov,Hakeem Dawodu,2020-09-26,1,0,0,0,3.25,3.333333,0,0,-10,10,12.7,-12.7,0,123,17,26,-9,9,-8.33332538604736e-02,8.33332538604736e-02,1,1,0,0,0,0,0,0,427,217,210,-210
Ricardo Ramos,Zubaira Tukhugov,Zubaira Tukhugov,2021-10-30,0,1,-4,4,3.2,3.333333,2.539993,-2.539993,-10,10,10.16,-10.16,0,55,21,26,-5,5,-0.133333206176758,0.133333206176758,2,0,0,0,2,-2,0,0,1456,399,1057,-1057
Elves Brener,Zubaira Tukhugov,Elves Brener,2023-02-11,1,0,-7,7,5,3.333333,5.080002,-5.080002,0,0,10.16,-10.16,0,131,18,26,-8,8,1.66666674613953,-1.66666674613953,0,1,0,0,-1,1,0,0,0,469,-469,469
